,Domain,Verdict,Entropy,Vowel,Consonant,Length,VN,VowelConsRatio,EntropyLength,ngram2ScoreLegit,ngram3ScoreLegit,ngram4ScoreLegit,ngram5ScoreLegit,ngramTotalScoreLegit,ngram2ScoreDGA,ngram3ScoreDGA,ngram4ScoreDGA,ngram5ScoreDGA,ngramTotalScoreDGA
3006,s.update.adsrvr.org,legit,3.43162,5,11,19,0,0.45455,0.18061,7,0,0,0,7,2,1,0,0,3
4993,canvaz.scdn.co,legit,3.03915,3,9,14,0,0.33333,0.21708,2,1,0,0,3,3,0,0,0,3
6351,oyvn1zgbzkhbpwrlg1.ru,dga,3.91613,2,16,21,1,0.125,0.18648,0,0,0,0,0,0,0,0,0,0
9854,jaqdmcstpauymgqmj.com,dga,3.63041,4,16,21,1,0.25,0.17288,1,0,0,0,1,1,0,0,0,1
1984,jill.fc.yahoo.com,legit,3.29277,5,9,17,0,0.55556,0.19369,1,0,0,1,2,0,0,0,0,0
520,hbopenbid.pubmatic.com,legit,3.69785,7,13,22,0,0.53846,0.16808,6,0,0,0,6,5,1,0,0,6
4848,com.ssl.d1.sc.omtrdc.net,legit,3.37165,3,15,24,0,0.2,0.14049,2,2,1,0,5,3,1,0,0,4
1807,as-sec.casalemedia.com,legit,3.26558,9,10,22,0,0.9,0.14844,4,0,0,0,4,7,0,0,0,7
8547,aawmceseksauuuuc.org,dga,3.38418,10,9,20,1,1.11111,0.16921,3,0,0,0,3,3,0,0,0,3
8077,hofxepthysqhk.co.uk,dga,3.68188,4,13,19,1,0.30769,0.19378,3,1,0,0,4,1,1,0,0,2
3574,thawte.com,legit,3.12193,3,6,10,0,0.5,0.31219,1,0,0,0,1,1,0,0,0,1
8398,kv1j74u2oj1dsxa6m2m.ddns.net,dga,4.13754,4,15,28,1,0.26667,0.14777,3,1,0,0,4,4,3,2,2,11
2810,ssl.ak.dynamic.tiles.virtualearth.net,legit,3.8411,11,21,37,0,0.52381,0.10381,11,3,0,0,14,9,2,1,0,12
3335,us-east-1-web-oao.ssp.yahoo.com,legit,3.69228,11,12,31,0,0.91667,0.11911,5,1,0,1,7,3,0,0,0,3
1829,mail.me.com.akadns.net,legit,3.48171,7,11,22,0,0.63636,0.15826,8,6,7,8,29,5,3,1,0,9
7108,ghssbyznt.com,dga,3.54659,1,11,13,1,0.09091,0.27281,1,0,0,0,1,0,0,0,0,0
2893,byteoversea.com,legit,3.45656,6,8,15,0,0.75,0.23044,4,0,0,0,4,5,3,0,0,8
1838,infra.webex.com,legit,3.64022,5,8,15,0,0.625,0.24268,2,0,0,0,2,3,1,0,0,4
5156,0y4yweo28agq.org,dga,3.625,4,7,16,1,0.57143,0.22656,0,0,0,0,0,0,0,0,0,0
7340,ybtfdxwtknbcys.in,dga,3.61687,1,15,17,1,0.06667,0.21276,0,0,0,0,0,0,0,0,0,0
4058,zscaler.com,legit,3.27761,3,7,11,0,0.42857,0.29796,2,0,0,0,2,3,0,0,0,3
3265,weixin.qq.com,legit,3.2389,4,7,13,0,0.57143,0.24915,1,0,0,0,1,1,0,0,0,1
3185,array504.prod.do.dsp.mp.microsoft.com,legit,3.71259,8,20,37,0,0.4,0.10034,12,12,10,9,43,5,2,0,0,7
5776,4zlph8g36nag4r846o.cn,dga,3.78494,2,10,21,1,0.2,0.18024,0,0,0,0,0,0,0,0,0,0
2216,38-courier.push.apple.com,legit,3.86347,8,11,25,0,0.72727,0.15454,9,4,3,2,18,4,0,0,0,4
7052,ulfeduaci.ddns.net,dga,3.46132,6,10,18,1,0.6,0.1923,3,1,0,0,4,6,4,3,2,15
2919,amplitude.life360.com,legit,3.91613,7,9,21,0,0.77778,0.18648,4,0,0,0,4,3,0,0,0,3
8378,hhighkqqoxiagnpqnrg.com,dga,3.64249,5,17,23,1,0.29412,0.15837,0,0,0,0,0,0,0,0,0,0
2251,23-courier.push.apple.com,legit,3.86347,8,11,25,0,0.72727,0.15454,9,4,3,2,18,4,0,0,0,4
9843,glm2uwilqkkg13qhdw.net,dga,4.00489,3,15,22,1,0.2,0.18204,0,0,0,0,0,0,0,0,0,0
5014,pxayfojidfskmlaqo.net,dga,4.1066,6,14,21,1,0.42857,0.19555,0,0,0,0,0,1,0,0,0,1
1027,pull-cmaf-f77-gcp01.tiktokcdn.com,legit,4.11243,5,19,33,0,0.26316,0.12462,5,6,9,9,29,3,0,0,0,3
8815,an7254a4qjmhu0afgdex3p1.ddns.net,dga,4.36673,6,16,32,1,0.375,0.13646,2,1,0,0,3,6,3,2,1,12
8079,vydnttgqvj.com,dga,3.52164,1,12,14,1,0.08333,0.25155,2,0,0,0,2,1,0,0,0,1
4018,msftauthimages.net,legit,3.46132,6,11,18,0,0.54545,0.1923,4,1,0,0,5,4,0,0,0,4
6252,qvcdgjuvw45doxa.ddns.net,dga,4.00163,4,16,24,1,0.25,0.16673,3,1,0,0,4,4,4,3,2,13
5882,travellerjoyce.xyz,dga,3.57243,5,12,18,1,0.41667,0.19847,4,0,0,0,4,6,1,0,0,7
4816,track2.securedvisit.com,legit,3.79509,7,13,23,0,0.53846,0.165,4,0,0,0,4,9,1,0,0,10
2965,configsvc1.live.com.akadns.net,legit,3.92323,8,17,30,0,0.47059,0.13077,8,7,7,8,30,6,4,1,0,11
4590,az700632.vo.msecnd.net,legit,3.97057,4,9,22,0,0.44444,0.18048,2,0,0,0,2,3,0,0,0,3
5584,uamrriunjiao.biz,dga,3.32782,8,7,16,1,1.14286,0.20799,1,0,0,0,1,2,0,0,0,2
1419,pixel.advertising.com,legit,3.97542,7,12,21,0,0.58333,0.18931,6,0,0,0,6,7,2,0,0,9
1194,intercom.io,legit,3.0958,5,5,11,0,1.0,0.28144,5,1,0,0,6,5,2,1,0,8
9266,pupylol.com,dga,2.91398,3,7,11,1,0.42857,0.26491,1,0,0,0,1,0,0,0,0,0
7475,8as20asew6ci.org,dga,3.75,5,6,16,1,0.83333,0.23438,1,0,0,0,1,2,0,0,0,2
1327,sc-gw.com,legit,2.9477,1,6,9,0,0.16667,0.32752,0,0,0,0,0,0,0,0,0,0
9228,weygbqyxfw.com,dga,3.52164,2,11,14,1,0.18182,0.25155,0,0,0,0,0,0,0,0,0,0
130,app-measurement.com,legit,3.53689,7,10,19,0,0.7,0.18615,6,2,0,0,8,6,1,0,0,7
4940,csync-global.smartadserver.com,legit,3.93957,7,20,30,0,0.35,0.13132,7,1,1,0,9,6,3,1,0,10
6537,scaleconcertrepairhangluck.com,dga,3.84441,10,19,30,1,0.52632,0.12815,6,1,0,0,7,9,2,0,2,13
9201,0642gicawuki.org,dga,3.75,5,6,16,1,0.83333,0.23438,1,0,0,0,1,2,0,0,0,2
561,people-pa.clients6.google.com,legit,3.67644,10,14,29,0,0.71429,0.12677,7,7,4,3,21,2,1,0,0,3
9178,ehehubujwhnrgvwtp.me,dga,3.64644,5,14,20,1,0.35714,0.18232,0,0,0,0,0,0,0,0,0,0
9106,28awqkm46ku8.net,dga,3.75,3,7,16,1,0.42857,0.23438,0,0,0,0,0,0,0,0,0,0
5213,yghannmivgrifylp.eu,dga,3.82687,5,13,19,1,0.38462,0.20141,1,0,0,0,1,3,0,0,0,3
1058,pull-cmaf-f77-sg01.tiktokcdn.com,legit,4.20282,5,18,32,0,0.27778,0.13134,5,6,9,9,29,3,0,0,0,3
9190,regarddenver.by,dga,3.13957,4,10,15,1,0.4,0.2093,3,0,0,0,3,7,1,0,0,8
8865,velquisdeicharitasverbum.com,dga,3.96772,11,16,28,1,0.6875,0.1417,3,0,0,0,3,11,3,1,0,15
8482,utrqqyrnvjys.com,dga,3.625,2,13,16,1,0.15385,0.22656,0,0,0,0,0,0,0,0,0,0
1674,jivox.com,legit,2.9477,3,5,9,0,0.6,0.32752,0,0,0,0,0,0,0,0,0,0
9280,usukigkgsakicume.org,dga,3.40869,8,11,20,1,0.72727,0.17043,2,0,0,0,2,2,0,0,0,2
1309,skype.com.trafficmanager.net,legit,3.86933,8,17,28,0,0.47059,0.13819,9,6,3,5,23,8,3,1,0,12
4322,static.ess.apple.com,legit,3.34644,6,11,20,0,0.54545,0.16732,12,4,3,2,21,7,2,0,0,9
7274,iidpuauvc.com,dga,3.2389,6,6,13,1,1.0,0.24915,0,0,0,0,0,0,0,0,0,0
9142,capitalmistakespiteleague.com,dga,3.63351,13,15,29,1,0.86667,0.12529,9,1,0,0,10,11,2,0,0,13
1458,crashlyticsreports-pa.googleapis.com,legit,3.86383,11,22,36,0,0.5,0.10733,10,6,4,4,24,9,0,0,0,9
7987,giwm0aoac6kq.org,dga,3.625,5,8,16,1,0.625,0.22656,0,0,0,0,0,1,0,0,0,1
3187,store.office.com,legit,3.20282,6,8,16,0,0.75,0.20018,6,4,4,3,17,5,0,0,0,5
9153,restoration-nasty.hn,dga,3.44644,6,12,20,1,0.5,0.17232,7,1,0,0,8,9,5,2,1,17
3363,e.reddit.com,legit,3.08496,4,6,12,0,0.66667,0.25708,3,0,0,0,3,4,0,0,0,4
1020,api.apple-cloudkit.com,legit,3.69785,8,11,22,0,0.72727,0.16808,8,8,6,3,25,2,0,0,0,2
689,sync.srv.stackadapt.com,legit,3.60967,4,16,23,0,0.25,0.15694,4,0,0,0,4,3,0,0,0,3
226,dns.umbrella.com,legit,3.625,4,10,16,0,0.4,0.22656,3,1,0,0,4,5,1,0,0,6
8953,myyqyvgipy.com,dga,3.09307,2,11,14,1,0.18182,0.22093,0,0,0,0,0,0,0,0,0,0
8213,wfichenansnan.org,dga,3.49923,5,11,17,1,0.45455,0.20584,2,1,0,0,3,4,2,4,3,13
8425,awy8ioak20m8.net,dga,3.75,5,6,16,1,0.83333,0.23438,0,0,0,0,0,0,0,0,0,0
2811,accuweather.com,legit,3.32323,6,8,15,0,0.75,0.22155,3,0,0,0,3,4,1,1,1,7
4457,dms-mcdn-report.wc.yahoodns.net,legit,3.88905,6,20,31,0,0.3,0.12545,4,2,0,1,7,4,1,0,0,5
4095,pingdom.net,legit,3.27761,3,7,11,0,0.42857,0.29796,2,0,0,0,2,2,1,0,0,3
9860,oprukoxageo.ddns.net,dga,3.68418,7,11,20,1,0.63636,0.18421,4,2,0,0,6,5,4,3,2,14
8249,hrlxtwsvweznqjr.com,dga,4.0374,2,16,19,1,0.125,0.21249,0,0,0,0,0,0,0,0,0,0
7218,bcuawcpxicvvvvo.com,dga,3.30056,5,13,19,1,0.38462,0.17371,1,0,0,0,1,1,0,0,0,1
1972,crt.sectigo.com,legit,3.1899,4,9,15,0,0.44444,0.21266,3,0,0,0,3,3,0,0,0,3
251,ocsp2-lb.apple.com.akadns.net,legit,3.8404,7,16,29,0,0.4375,0.13243,10,10,10,10,40,5,3,1,0,9
6818,skwamogwgcqccggc.org,dga,3.14145,3,16,20,1,0.1875,0.15707,1,0,0,0,1,1,0,0,0,1
1880,cdn.fbsbx.com,legit,3.2389,1,10,13,0,0.1,0.24915,2,2,1,0,5,1,0,0,0,1
2090,1276298696.rsc.cdn77.org,legit,3.65727,1,8,24,0,0.125,0.15239,3,1,0,0,4,1,0,0,0,1
5699,ermintrudeernestine.net,dga,3.00097,9,13,23,1,0.69231,0.13048,7,0,0,0,7,8,2,0,0,10
3387,cdn.attn.tv,legit,2.66353,1,8,11,0,0.125,0.24214,4,2,1,0,7,2,0,0,0,2
7776,wbhnmdtlyshdtyrnv.net,dga,3.65376,1,19,21,1,0.05263,0.17399,0,0,0,0,0,0,0,0,0,0
9501,facitindlocintroitum.com,dga,3.4906,9,14,24,1,0.64286,0.14544,5,0,0,0,5,5,0,0,0,5
7671,xinteriormutanda.com,dga,3.62193,8,11,20,1,0.72727,0.1811,5,0,0,0,5,8,3,1,0,12
8183,aeukmiuokqqumism.org,dga,3.44644,9,10,20,1,0.9,0.17232,1,0,0,0,1,2,0,0,0,2
5684,nvgafmzbnx.com,dga,3.52164,2,11,14,1,0.18182,0.25155,0,0,0,0,0,0,0,0,0,0
1246,tpsc-ue1.doubleverify.com,legit,4.13366,8,13,25,0,0.61538,0.16535,4,0,0,0,4,5,2,0,0,7
2895,dsp.nrich.ai,legit,3.25163,3,7,12,0,0.42857,0.27097,3,0,0,0,3,2,0,0,0,2
7860,ccriganansnan.cc,dga,2.70282,4,11,16,1,0.36364,0.16893,1,0,0,0,1,3,2,4,3,12
3320,esp-us2.aptrinsic.com,legit,3.78494,6,11,21,0,0.54545,0.18024,6,1,0,0,7,6,1,0,0,7
6803,aislirb.in,dga,2.84644,4,5,10,1,0.8,0.28464,1,0,0,0,1,1,0,0,0,1
5559,wuilqaevx.ddns.net,dga,3.72548,5,11,18,1,0.45455,0.20697,2,1,0,0,3,4,3,2,1,10
938,pull-f5-tt01.tiktokcdn.com,legit,3.93121,4,15,26,0,0.26667,0.1512,4,6,9,9,28,2,0,0,0,2
3066,msa.msidentity.com,legit,3.46132,5,11,18,0,0.45455,0.1923,4,1,0,0,5,5,1,0,0,6
190,amazon-adsystem.com,legit,3.53689,6,11,19,0,0.54545,0.18615,7,1,3,2,13,6,0,0,0,6
5992,imcpmqqotyy.com,dga,3.05656,3,11,15,1,0.27273,0.20377,0,0,0,0,0,0,0,0,0,0
1233,dl.google.com,legit,2.87314,4,7,13,0,0.57143,0.22101,2,5,4,3,14,1,0,0,0,1
9305,iyrukkhmrs.com,dga,3.37878,3,10,14,1,0.3,0.24134,0,0,0,0,0,0,0,0,0,0
6156,uvfrlpvnx.cc,dga,3.25163,1,10,12,1,0.1,0.27097,0,0,0,0,0,0,0,0,0,0
4699,rtbsystem.com,legit,3.2389,2,10,13,0,0.2,0.24915,2,0,0,0,2,3,0,0,0,3
3526,cpx.to,legit,2.58496,1,4,6,0,0.25,0.43083,0,0,0,0,0,0,0,0,0,0
7038,kimberlyngeorgeson.net,dga,3.60694,7,14,22,1,0.5,0.16395,4,0,0,0,4,6,0,0,0,6
3415,list-manage.com,legit,3.64022,5,8,15,0,0.625,0.24268,4,1,0,2,7,5,1,0,0,6
521,fe2cr.update.microsoft.com,legit,3.76718,8,14,26,0,0.57143,0.14489,9,8,7,6,30,4,1,0,0,5
1689,pull-f5-gcp01.fcdn.us.tiktokv.com,legit,4.17303,5,19,33,0,0.26316,0.12646,6,7,7,4,24,2,0,0,0,2
3658,v16m.tiktokcdn.com,legit,3.50326,3,11,18,0,0.27273,0.19463,4,6,7,6,23,2,0,0,0,2
3550,atlassian.com,legit,3.18083,5,7,13,0,0.71429,0.24468,1,0,0,0,1,5,1,0,0,6
3030,cdn.syndication.twimg.com,legit,3.56307,6,16,25,0,0.375,0.14252,7,2,1,0,10,7,3,2,1,13
506,fastlane.rubiconproject.com,legit,3.95823,9,16,27,0,0.5625,0.1466,7,3,0,0,10,9,2,0,0,11
6184,ujaho8cxctmf3xi.ddns.net,dga,4.08496,5,15,24,1,0.33333,0.17021,2,1,0,0,3,4,4,3,2,13
104,ichnaea.netflix.com,legit,3.61635,7,10,19,0,0.7,0.19033,3,0,0,0,3,4,0,0,0,4
1126,mediavine.com,legit,3.2389,6,6,13,0,1.0,0.24915,2,0,0,0,2,3,1,0,0,4
6376,rugkokxi.ru,dga,2.91398,4,6,11,1,0.66667,0.26491,0,0,0,0,0,0,0,0,0,0
4729,finance.yahoo.com,legit,3.33718,7,8,17,0,0.875,0.1963,4,0,0,1,5,3,2,1,0,6
7105,puzepi.info,dga,3.0958,5,5,11,1,1.0,0.28144,1,0,0,0,1,0,0,0,0,0
6040,bcfmlndbbbeonmlf.cc,dga,3.15557,2,16,19,1,0.125,0.16608,1,0,0,0,1,3,0,0,0,3
421,media.net,legit,2.9477,4,4,9,0,1.0,0.32752,1,0,0,0,1,1,0,0,0,1
6508,naiofgwwfcz.net,dga,3.50689,4,10,15,1,0.4,0.23379,1,0,0,0,1,0,0,0,0,0
6530,ujleldothbgytj.ir,dga,3.73452,4,12,17,1,0.33333,0.21968,1,0,0,0,1,2,0,0,0,2
6432,mdfbfolandmmccec.website,dga,3.7406,6,17,24,1,0.35294,0.15586,1,0,0,0,1,5,1,0,0,6
4787,6-c-0003.c-msedge.net,legit,3.52257,3,8,21,0,0.375,0.16774,4,2,1,0,7,3,0,0,0,3
6592,journeypaint.net,dga,3.45282,6,9,16,1,0.66667,0.2158,3,0,0,0,3,2,0,0,0,2
5748,qajadwfb.com,dga,3.4183,3,8,12,1,0.375,0.28486,1,0,0,0,1,0,0,0,0,0
7363,milkboat.net,dga,3.4183,4,7,12,1,0.57143,0.28486,2,0,0,0,2,2,0,0,0,2
8008,ariderimdusoe.ddns.net,dga,3.42512,8,12,22,1,0.66667,0.15569,5,1,0,0,6,8,5,3,2,18
5578,xcbgsdolc.ch,dga,3.18872,1,10,12,1,0.1,0.26573,0,0,0,0,0,0,0,0,0,0
5049,journeyvalley.net,dga,3.45482,6,10,17,1,0.6,0.20322,2,0,0,0,2,2,0,0,0,2
8099,ux7hh5kch7jkgqfahc.com,dga,3.69785,3,15,22,1,0.2,0.16808,0,0,0,0,0,0,0,0,0,0
5354,bcfddbdddfbbnacb.com,dga,2.82322,2,17,20,1,0.11765,0.14116,0,0,0,0,0,2,0,0,0,2
5505,udlafonn.com,dga,3.25163,4,7,12,1,0.57143,0.27097,1,0,0,0,1,2,0,0,0,2
5618,ekcspeiq.net,dga,3.18872,4,7,12,1,0.57143,0.26573,0,0,0,0,0,0,0,0,0,0
4847,affirm.com,legit,2.92193,3,6,10,0,0.5,0.29219,0,1,0,0,1,0,0,0,0,0
2019,api-iam.intercom.io,legit,3.40582,9,7,19,0,1.28571,0.17925,8,2,0,0,10,6,2,1,0,9
4306,alt2-mtalk.google.com,legit,3.46328,6,11,21,0,0.54545,0.16492,3,5,4,3,15,2,0,0,0,2
8255,gehisdofaw.com,dga,3.6645,5,8,14,1,0.625,0.26175,2,0,0,0,2,2,0,0,0,2
1878,slack-edge.com,legit,3.52164,4,8,14,0,0.5,0.25155,2,2,1,0,5,4,0,0,0,4
7558,answerabove.net,dga,3.32323,6,8,15,1,0.75,0.22155,2,0,0,0,2,5,2,0,0,7
4005,server.events.data.microsoft.com,legit,3.65564,10,18,32,0,0.55556,0.11424,14,10,8,6,38,9,4,1,0,14
3720,ipds.adrta.com,legit,3.37878,4,8,14,0,0.5,0.24134,5,0,0,0,5,1,0,0,0,1
7851,gsrpghlgfghk.com,dga,3.375,1,14,16,1,0.07143,0.21094,0,0,0,0,0,0,0,0,0,0
9779,subsectioninstructors.az,dga,3.55351,8,15,24,1,0.53333,0.14806,5,0,0,0,5,10,2,1,1,14
7370,824uki8qoygu.org,dga,3.5,5,6,16,1,0.83333,0.21875,0,0,0,0,0,0,0,0,0,0
7138,meaxugur.ru,dga,2.84535,5,5,11,1,1.0,0.25867,1,0,0,0,1,1,0,0,0,1
1164,msh.amazon.com,legit,3.03915,4,8,14,0,0.5,0.21708,4,1,3,3,11,3,0,0,0,3
6628,gbi6wp1410wpcvwh5lu6m4w.ddns.net,dga,4.3125,3,19,32,1,0.15789,0.13477,2,1,0,0,3,4,3,3,2,12
9662,wrjnwjhb.yi.org,dga,3.37356,2,11,15,1,0.18182,0.2249,0,0,0,0,0,0,0,0,0,0
1215,fastclick.net,legit,3.39275,3,9,13,0,0.33333,0.26098,3,1,0,0,4,3,0,0,0,3
8448,ofsjid58anet76ojmro6mri.ddns.net,dga,3.99173,8,17,32,1,0.47059,0.12474,4,1,0,0,5,8,4,3,2,17
6757,k2qhidq8ax16wb36ila8ah7.ddns.net,dga,4.26532,6,16,32,1,0.375,0.13329,2,1,0,0,3,5,3,3,2,13
5916,02cqsm0u4usy.net,dga,3.625,3,8,16,1,0.375,0.22656,1,0,0,0,1,0,0,0,0,0
1519,p19-sign.tiktokcdn-us.com,legit,3.92386,5,14,25,0,0.35714,0.15695,5,6,7,6,24,3,0,0,0,3
4470,js.usemessages.com,legit,3.03856,6,10,18,0,0.6,0.16881,5,1,0,0,6,4,1,0,0,5
7659,tewwrqure.tv,dga,2.9183,3,8,12,1,0.375,0.24319,2,0,0,0,2,2,0,0,0,2
9631,wpwinzpups.com,dga,3.32486,3,10,14,1,0.3,0.23749,1,0,0,0,1,1,0,0,0,1
2342,aws-proxy-gcp.api.sc-gw.com,legit,3.68009,5,16,27,0,0.3125,0.1363,6,3,1,0,10,0,1,0,0,1
3225,pull-f5-gcp01.ttlivecdn.com.c.worldfcdn.com,legit,4.10931,6,27,43,0,0.22222,0.09557,6,5,5,2,18,6,2,1,0,9
3504,windowsupdate.com.c.footprint.net,legit,3.8094,10,19,33,0,0.52632,0.11544,9,3,2,2,16,8,4,1,0,13
263,cloudapp.azure.com,legit,3.50326,7,9,18,0,0.77778,0.19463,7,4,2,3,16,1,0,0,0,1
8575,5rsf3ji856crkx3ja0g.ddns.net,dga,4.23593,3,16,28,1,0.1875,0.15128,3,1,0,0,4,4,3,3,2,12
7321,kfajenhssdwbj.biz,dga,3.73452,3,13,17,1,0.23077,0.21968,1,0,0,0,1,1,0,0,0,1
733,snap.licdn.com,legit,3.37878,3,9,14,0,0.33333,0.24134,6,1,0,0,7,2,0,0,0,2
7803,wboistyy.mooo.com,dga,3.0516,6,9,17,1,0.66667,0.17951,3,0,0,0,3,2,2,2,1,7
9104,superfluisqupax.com,dga,3.78714,7,11,19,1,0.63636,0.19932,1,0,0,0,1,3,0,0,0,3
5693,uhitwiel.ddns.net,dga,3.38158,5,10,17,1,0.5,0.19892,2,1,0,0,3,6,3,2,1,12
8452,i0125dwlat7b5ta0i2c.ddns.net,dga,3.96772,5,13,28,1,0.38462,0.1417,4,1,0,0,5,7,3,2,2,14
4797,ssl.d1.sc.omtrdc.net,legit,3.38418,2,13,20,0,0.15385,0.16921,1,0,0,0,1,2,0,0,0,2
3603,pull-flv-f1-sg01.tiktokcdn.com,legit,4.12323,4,18,30,0,0.22222,0.13744,4,6,9,9,28,2,0,0,0,2
5080,cmfukycjtz.com,dga,3.32486,2,11,14,1,0.18182,0.23749,0,0,0,0,0,0,0,0,0,0
1632,vimeo.com,legit,2.72548,4,4,9,0,1.0,0.30283,0,0,0,0,0,0,0,0,0,0
9862,titaniumerrors.yt,dga,3.41042,6,10,17,1,0.6,0.20061,4,0,0,0,4,7,1,0,0,8
8226,unifiedfrozen.name,dga,3.41938,8,9,18,1,0.88889,0.18997,3,0,0,0,3,3,0,0,0,3
3130,lciapi.ninthdecimal.com,legit,3.53422,8,13,23,0,0.61538,0.15366,5,1,1,0,7,5,0,0,0,5
7333,hifs.com.pe,dga,3.27761,3,6,11,1,0.5,0.29796,3,2,1,0,6,2,2,1,0,5
8511,fuivinrotev.ddns.net,dga,3.48418,6,12,20,1,0.5,0.17421,5,1,0,0,6,6,3,2,1,12
3242,odb.outbrain.com,legit,3.45282,6,8,16,0,0.75,0.2158,3,0,0,0,3,2,0,0,0,2
6370,vemo2kuquabj7b8mrn.net,dga,4.00489,6,12,22,1,0.5,0.18204,0,0,0,0,0,2,0,0,0,2
9825,ilcgcsdsholapet.com,dga,3.68188,5,13,19,1,0.38462,0.19378,2,0,0,0,2,2,0,5,5,12
853,global.fastly.net,legit,3.45482,4,11,17,0,0.36364,0.20322,2,1,0,0,3,2,0,0,0,2
8336,spokecome.net,dga,3.18083,5,7,13,1,0.71429,0.24468,1,1,0,0,2,3,1,0,0,4
9980,qjswqelqwgrqkia.com,dga,3.72161,4,14,19,1,0.28571,0.19587,0,0,0,0,0,1,0,0,0,1
1576,diagnostics.office.com,legit,3.53831,8,12,22,0,0.66667,0.16083,6,4,4,3,17,4,0,0,0,4
2631,github.com,legit,3.32193,3,6,10,0,0.5,0.33219,0,0,0,0,0,1,0,0,0,1
8855,moodicvzhw.com,dga,3.18201,4,9,14,1,0.44444,0.22729,2,0,0,0,2,1,0,0,0,1
8144,edlifegneci.com,dga,3.32323,6,8,15,1,0.75,0.22155,2,0,0,0,2,3,0,0,0,3
776,p.rfihub.com,legit,3.4183,3,7,12,0,0.42857,0.28486,1,0,0,0,1,0,0,0,0,0
6480,crassioresnequaquam.com,dga,3.5014,10,12,23,1,0.83333,0.15223,5,0,0,0,5,8,2,0,0,10
701,ci5.googleusercontent.com,legit,3.62347,9,13,25,0,0.69231,0.14494,10,8,4,3,25,7,3,0,0,10
5160,uwcoqhnuoxhlaq.co.uk,dga,3.44644,7,11,20,1,0.63636,0.17232,2,1,0,0,3,2,1,0,0,3
1783,pghub.io,legit,3.0,3,4,8,0,0.75,0.375,0,0,0,0,0,0,0,0,0,0
3621,cc-noam-skype.trafficmanager.net,legit,3.92923,9,19,32,0,0.47368,0.12279,8,3,1,3,15,7,1,0,0,8
8534,ddxyyqhghomf.pw,dga,3.50689,1,13,15,1,0.07692,0.23379,0,0,0,0,0,2,0,0,0,2
8869,asmwqsu8mwys.top,dga,3.45282,3,11,16,1,0.27273,0.2158,0,0,0,0,0,2,0,0,0,2
7116,xoognpnlet.com,dga,3.32486,4,9,14,1,0.44444,0.23749,2,1,0,0,3,2,0,0,0,2
4877,heytapdl.com,legit,3.58496,3,8,12,0,0.375,0.29875,2,0,0,0,2,1,0,0,0,1
1697,ts.cdn.office.net,legit,3.21953,4,10,17,0,0.4,0.18938,7,6,5,3,21,3,0,0,0,3
8956,pbyghxpltwmyp.kz,dga,3.57782,0,15,16,1,0.0,0.22361,1,0,0,0,1,0,0,0,0,0
8016,mrinlnpnpvmvfqo.com,dga,3.43162,3,15,19,1,0.2,0.18061,1,0,0,0,1,2,1,0,0,3
1962,arcticwolf.net,legit,3.52164,4,9,14,0,0.44444,0.25155,2,0,0,0,2,3,0,0,0,3
8706,dormieddebcrucisulla.com,dga,3.60539,9,14,24,1,0.64286,0.15022,3,0,0,0,3,8,0,0,0,8
758,mb.moatads.com,legit,3.03915,4,8,14,0,0.5,0.21708,5,0,0,0,5,2,0,0,0,2
6305,kgywrjkkhh.com,dga,3.32486,1,12,14,1,0.08333,0.23749,0,0,0,0,0,0,0,0,0,0
4662,api.livechatinc.com,legit,3.53689,7,10,19,0,0.7,0.18615,6,1,1,0,8,5,2,0,0,7
5217,ewwnoqqmmjpkilkm.biz,dga,3.68418,4,15,20,1,0.26667,0.18421,0,0,0,0,0,0,0,0,0,0
4013,cdn.globalsign.com,legit,3.50326,4,12,18,0,0.33333,0.19463,3,2,1,0,6,2,0,0,0,2
2007,content-signature-chains.prod.webservices.mozgcp.net,legit,4.13536,15,31,52,0,0.48387,0.07953,18,8,4,3,33,14,7,1,0,22
7044,niecfeidfaalt.ddns.net,dga,3.35649,7,13,22,1,0.53846,0.15257,2,1,0,0,3,6,3,2,1,12
8648,bsg43kye21jtb38g33bun60dyi55p22a57dxkvlx.ru,dga,4.62941,5,21,43,1,0.2381,0.10766,0,0,0,0,0,0,0,0,0,0
8916,cmiqhuemi.com.ua,dga,3.20282,7,7,16,1,1.0,0.20018,3,2,1,0,6,4,2,1,0,7
5893,wesifanansnan.com,dga,3.21953,6,10,17,1,0.6,0.18938,1,0,0,0,1,4,2,4,3,13
5615,bncyuq.tv,dga,3.16993,1,7,9,1,0.14286,0.35221,0,0,0,0,0,0,0,0,0,0
8776,xpqqpnfwwfiviuajyag.com,dga,4.00182,6,16,23,1,0.375,0.17399,0,0,0,0,0,0,0,0,0,0
7444,fkdgrypa.am,dga,3.27761,2,8,11,1,0.25,0.29796,0,0,0,0,0,0,0,0,0,0
8030,dkljypnolmjf.com,dga,3.5,2,13,16,1,0.15385,0.21875,0,0,0,0,0,0,0,0,0,0
8861,xghufkunnf.dynserv.com,dga,3.97057,4,16,22,1,0.25,0.18048,3,1,1,0,5,4,5,5,4,18
1653,is2-ssl.mzstatic.com,legit,3.42193,4,12,20,0,0.33333,0.1711,6,0,0,0,6,6,1,0,0,7
3481,www.outlook.com,legit,2.92323,5,8,15,0,0.625,0.19488,3,0,0,0,3,0,0,0,0,0
8052,aesekwsoeaickqmm.org,dga,3.58418,8,11,20,1,0.72727,0.17921,4,0,0,0,4,4,0,0,0,4
7682,xgohqbmovcmljrkdfiljmrqkzbubm.info,dga,4.1607,6,27,34,1,0.22222,0.12237,0,0,0,0,0,0,0,0,0,0
8149,gmjeetwwwjlo.com,dga,3.20282,4,11,16,1,0.36364,0.20018,1,0,0,0,1,1,0,0,0,1
2602,ssacdn.com,legit,2.92193,2,7,10,0,0.28571,0.29219,2,1,0,0,3,2,0,0,0,2
9371,mlwtmefkkejj.biz,dga,3.5,3,12,16,1,0.25,0.21875,0,0,0,0,0,0,0,0,0,0
9731,iusxcodsholapet.com,dga,3.78714,7,11,19,1,0.63636,0.19932,4,0,0,0,4,3,0,5,5,13
27,googleusercontent.com,legit,3.40399,8,12,21,0,0.66667,0.16209,10,7,3,2,22,7,3,0,0,10
6687,edirgit.com,dga,3.27761,4,6,11,1,0.66667,0.29796,1,0,0,0,1,2,0,0,0,2
2043,secure-ds.serving-sys.com,legit,3.66928,6,15,25,0,0.4,0.14677,6,1,1,1,9,5,3,1,0,9
7020,ilcbi6qfovw8mliholyxuhc.ddns.net,dga,4.32782,7,21,32,1,0.33333,0.13524,3,1,0,0,4,4,3,2,2,11
8770,cnmmtxpusgcxwdctx.tw,dga,3.40869,1,18,20,1,0.05556,0.17043,1,0,0,0,1,0,0,0,0,0
6674,listnamesailcupreasonhelp.com,dga,3.78834,11,17,29,1,0.64706,0.13063,8,0,0,0,8,9,1,0,0,10
192,www.googletagservices.com,legit,3.64307,8,15,25,0,0.53333,0.14572,8,7,5,4,24,8,2,1,0,11
1706,sophosupd.com,legit,3.02699,4,8,13,0,0.5,0.23285,0,0,0,0,0,1,0,0,0,1
8341,aaegooqmymsyiuam.org,dga,3.40869,9,10,20,1,0.9,0.17043,2,1,0,0,3,1,0,0,0,1
6951,ldanknmdiqtrot.com,dga,3.61437,4,13,18,1,0.30769,0.2008,1,0,0,0,1,1,0,0,0,1
6587,lngmtceqccaqwqcllrhazlvggenr.ru,dga,3.78437,5,25,31,1,0.2,0.12208,3,0,0,0,3,4,0,0,0,4
865,apps.identrust.com,legit,3.72548,5,11,18,0,0.45455,0.20697,7,2,0,0,9,3,1,0,0,4
1311,edge.skype.com.trafficmanager.net,legit,3.88183,10,19,33,0,0.52632,0.11763,10,8,4,5,27,9,3,1,0,13
6161,radiorewardwaroccasionjoke.com,dga,3.56141,13,16,30,1,0.8125,0.11871,5,0,0,0,5,8,1,0,0,9
2213,45-courier.push.apple.com,legit,3.86347,8,11,25,0,0.72727,0.15454,9,4,3,2,18,4,0,0,0,4
6827,cloudhelp.net,dga,3.39275,4,8,13,1,0.5,0.26098,2,3,2,1,8,1,0,0,0,1
7665,uponmoon.net,dga,2.79248,5,6,12,1,0.83333,0.23271,2,0,0,0,2,1,0,0,0,1
6793,pqnnupofbloo.net,dga,3.28064,5,10,16,1,0.5,0.20504,3,0,0,0,3,0,0,0,0,0
1299,dscapi9.akamai.net,legit,3.50326,7,8,18,0,0.875,0.19463,6,4,4,3,17,3,0,0,0,3
8597,dtpdhtufiowg.pw,dga,3.37356,3,11,15,1,0.27273,0.2249,0,0,0,0,0,0,0,0,0,0
2668,activemetering.com,legit,3.46132,7,10,18,0,0.7,0.1923,4,0,0,0,4,9,4,0,0,13
158,connect.facebook.net,legit,3.17095,7,11,20,0,0.63636,0.15855,4,1,0,0,5,6,1,0,0,7
1279,m.stripe.com,legit,3.25163,3,7,12,0,0.42857,0.27097,1,0,0,0,1,2,0,0,0,2
4203,visualwebsiteoptimizer.com,legit,3.90217,11,14,26,0,0.78571,0.15008,4,0,0,0,4,8,0,0,0,8
8071,caflotea.ru,dga,3.27761,5,5,11,1,1.0,0.29796,3,0,0,0,3,3,0,0,0,3
1072,live.com.akadns.net,legit,3.68188,6,10,19,0,0.6,0.19378,7,6,7,8,28,5,3,1,0,9
630,trafficshaping.dsp.mp.microsoft.com,legit,3.77831,8,23,35,0,0.34783,0.10795,13,11,8,7,39,5,2,0,0,7
8297,skmzayrmvnvesxrkhofybmca.biz,dga,4.06611,5,22,28,1,0.22727,0.14522,2,0,0,0,2,3,0,0,0,3
3963,redirector.gvt1.com,legit,3.47135,5,11,19,0,0.45455,0.1827,2,0,0,0,2,4,0,0,0,4
2635,cootlogix.com,legit,2.93121,5,7,13,0,0.71429,0.22548,3,0,0,0,3,1,0,0,0,1
851,tt.omtrdc.net,legit,2.93121,2,9,13,0,0.22222,0.22548,0,0,0,0,0,1,0,0,0,1
7696,uouoiiomkkmceasu.org,dga,3.38418,11,8,20,1,1.375,0.16921,3,0,0,0,3,5,0,0,0,5
9917,substitutejennifer.yt,dga,3.40399,7,13,21,1,0.53846,0.16209,5,0,0,0,5,8,0,0,0,8
4980,s2.symcb.com,legit,2.9183,1,8,12,0,0.125,0.24319,0,0,0,0,0,0,0,0,0,0
8898,mcsgaaukgkiyossc.org,dga,3.44644,6,13,20,1,0.46154,0.17232,0,0,0,0,0,0,0,0,0,0
6542,bwoonfrvwzk.com,dga,3.45656,3,11,15,1,0.27273,0.23044,2,0,0,0,2,1,0,0,0,1
1384,1-courier.sandbox.push.apple.com,legit,4.07782,10,16,32,0,0.625,0.12743,9,4,3,2,18,6,1,0,0,7
7004,yplwastahmpjvtxfq.pw,dga,3.78418,2,17,20,1,0.11765,0.18921,3,1,0,0,4,3,0,0,0,3
806,notify.adobe.io,legit,3.32323,7,6,15,0,1.16667,0.22155,3,0,0,0,3,2,0,0,0,2
2413,img-getpocket.cdn.mozilla.net,legit,3.88334,8,17,29,0,0.47059,0.13391,5,2,1,0,8,4,0,0,0,4
1186,disqus.com,legit,3.12193,3,6,10,0,0.5,0.31219,1,0,0,0,1,1,0,0,0,1
4554,viber.com,legit,3.16993,3,5,9,0,0.6,0.35221,1,0,0,0,1,2,0,0,0,2
6430,rinatdargo.com,dga,3.37878,5,8,14,1,0.625,0.24134,2,0,0,0,2,4,1,0,0,5
1329,comodoca.com,legit,2.35539,5,6,12,0,0.83333,0.19628,1,1,0,0,2,3,1,0,0,4
7717,doctororderly.net,dga,3.17512,5,11,17,1,0.45455,0.18677,2,0,0,0,2,3,0,0,0,3
1859,bsync.us.tiktokv.com,legit,3.58418,4,13,20,0,0.30769,0.17921,4,5,4,3,16,1,0,0,0,1
8270,nntufkn.com,dga,3.02717,2,8,11,1,0.25,0.2752,1,0,0,0,1,0,0,0,0,0
9618,vuzarsn.org,dga,3.27761,3,7,11,1,0.42857,0.29796,0,0,0,0,0,1,0,0,0,1
193,beacons.gcp.gvt2.com,legit,3.64644,4,12,20,0,0.33333,0.18232,5,1,0,0,6,6,1,0,0,7
4215,e15316.dsca.akamaiedge.net,legit,3.74833,9,9,26,0,1.0,0.14417,7,5,5,3,20,6,0,0,0,6
3645,cdn3.forter.com,legit,3.37356,3,9,15,0,0.33333,0.2249,4,1,0,0,5,4,1,0,0,5
9064,18gbodil7h3hwty.ddns.net,dga,4.05351,3,15,24,1,0.2,0.1689,2,1,0,0,3,4,3,2,2,11
8665,lvhqmpojvdufbtdl.eu,dga,3.82687,4,14,19,1,0.28571,0.20141,0,0,0,0,0,0,0,0,0,0
4236,aam.a47b.com,legit,2.85539,4,4,12,0,1.0,0.23795,2,0,0,0,2,1,0,0,0,1
2161,rootsoc.com,legit,2.55034,4,6,11,0,0.66667,0.23185,2,0,0,0,2,0,0,0,0,0
1540,2.tlu.dl.delivery.mp.microsoft.com,legit,3.8588,8,19,34,0,0.42105,0.11349,11,8,7,7,33,7,1,0,0,8
783,onetag-sys.com,legit,3.52164,4,8,14,0,0.5,0.25155,2,0,0,0,2,4,1,0,0,5
1624,api.apple-cloudkit.fe.apple-dns.net,legit,3.78301,11,18,35,0,0.61111,0.10809,10,9,6,3,28,4,1,0,0,5
6778,myswaekmkieceuqm.org,dga,3.74644,7,12,20,1,0.58333,0.18732,1,0,0,0,1,2,0,0,0,2
9390,3vpgf6hp47jb3i41bd.net,dga,4.0958,2,12,22,1,0.16667,0.18617,0,0,0,0,0,0,0,0,0,0
9032,nydognyjcofxnxaf.com,dga,3.44644,4,15,20,1,0.26667,0.17232,2,0,0,0,2,1,0,0,0,1
9471,cunufserne.com,dga,3.23593,5,8,14,1,0.625,0.23114,2,1,0,0,3,3,1,0,0,4
9198,somawnohudd.com,dga,3.32323,5,9,15,1,0.55556,0.22155,1,0,0,0,1,3,0,0,0,3
5257,summarynotified.id,dga,3.68354,7,10,18,1,0.7,0.20464,3,0,0,0,3,5,0,0,0,5
4983,dropbox-dns.com,legit,3.45656,3,10,15,0,0.3,0.23044,2,1,0,0,3,2,1,0,0,3
7820,pcrcjgtmyujwftyq.eu,dga,3.72161,3,15,19,1,0.2,0.19587,1,0,0,0,1,0,0,0,0,0
4318,us-east-tlx.3lift.com,legit,3.78494,5,11,21,0,0.45455,0.18024,4,1,0,0,5,3,0,0,0,3
481,cdn.doubleverify.com,legit,3.82193,6,12,20,0,0.5,0.1911,6,2,1,0,9,6,2,0,0,8
1611,com-c-3.edgekey.net,legit,3.51109,5,9,19,0,0.55556,0.18479,3,3,1,0,7,4,1,0,0,5
1803,array503.prod.do.dsp.mp.microsoft.com,legit,3.71259,8,20,37,0,0.4,0.10034,12,12,10,9,43,5,2,0,0,7
1322,fd.api.iris.microsoft.com,legit,3.41366,8,13,25,0,0.61538,0.13655,11,10,8,6,35,4,1,0,0,5
4583,prod.criteo.net,legit,3.24022,5,8,15,0,0.625,0.21601,6,3,2,1,12,3,1,0,0,4
5311,saosihiobgxcxmui.eu,dga,3.57662,9,9,19,1,1.0,0.18824,0,0,0,0,0,1,0,0,0,1
6208,tj5r6c67mxz5fnpw8w.ru,dga,4.01137,1,13,21,1,0.07692,0.19102,0,0,0,0,0,0,0,0,0,0
8987,mjxvqwbylllwgjvqcqwbeauxjr.com,dga,3.93957,4,25,30,1,0.16,0.13132,1,0,0,0,1,2,0,0,0,2
9663,gqocasiouyuowcqu.org,dga,3.38418,9,10,20,1,0.9,0.16921,1,0,0,0,1,3,0,0,0,3
483,creativecdn.com,legit,3.45656,5,9,15,0,0.55556,0.23044,7,1,0,0,8,7,1,0,0,8
8891,tgternlkys.com,dga,3.6645,2,11,14,1,0.18182,0.26175,2,0,0,0,2,2,1,0,0,3
6862,sgvsvrchsxntuixp.eu,dga,3.68188,4,14,19,1,0.28571,0.19378,1,0,0,0,1,0,0,0,0,0
5649,eggocesdumi.com,dga,3.24022,6,8,15,1,0.75,0.21601,3,0,0,0,3,3,0,0,0,3
2659,static.klaviyo.com,legit,3.50326,6,10,18,0,0.6,0.19463,5,0,0,0,5,6,1,0,0,7
1487,nexus-websocket-a.intercom.io,legit,3.9354,11,14,29,0,0.78571,0.1357,6,1,0,0,7,7,2,1,0,10
5029,skxxerflmw.com,dga,3.52164,2,11,14,1,0.18182,0.25155,1,0,0,0,1,1,0,0,0,1
2881,tsdtocl.com,legit,2.91398,2,8,11,0,0.25,0.26491,0,0,0,0,0,0,0,0,0,0
881,cdn.taboola.com,legit,3.1899,5,8,15,0,0.625,0.21266,5,2,1,0,8,3,0,0,0,3
8799,ilerwef.com,dga,3.27761,4,6,11,1,0.66667,0.29796,2,0,0,0,2,2,0,0,0,2
7887,qjahxwc.cc,dga,2.84644,1,8,10,1,0.125,0.28464,0,0,0,0,0,0,0,0,0,0
5468,tryadsfox.cc,dga,3.4183,2,9,12,1,0.22222,0.28486,2,0,0,0,2,0,0,0,0,0
159,clients2.google.com,legit,3.47135,6,10,19,0,0.6,0.1827,5,6,4,3,18,2,1,0,0,3
6852,fodbkfadncoccafe.co.uk,dga,3.2999,7,13,22,1,0.53846,0.15,5,1,0,0,6,3,1,0,0,4
2352,dropboxapi.com,legit,3.32486,5,8,14,0,0.625,0.23749,3,1,0,0,4,0,0,0,0,0
1162,adkernel.com,legit,3.4183,4,7,12,0,0.57143,0.28486,2,0,0,0,2,3,0,0,0,3
9452,girmupqi.ru,dga,2.91398,4,6,11,1,0.66667,0.26491,0,0,0,0,0,0,0,0,0,0
2545,analytics.query.yahoo.com,legit,3.80307,9,13,25,0,0.69231,0.15212,5,0,0,1,6,4,0,0,0,4
8880,wesomoql.ru,dga,3.27761,4,6,11,1,0.66667,0.29796,1,0,0,0,1,2,0,0,0,2
6151,eospenitentiam.com,dga,3.35021,8,9,18,1,0.88889,0.18612,5,1,0,0,6,6,1,0,0,7
2110,calendar-a.wbx2.com,legit,3.78714,5,10,19,0,0.5,0.19932,2,0,0,0,2,5,0,0,0,5
3793,dcs-edge-va6-802167536.us-east-1.elb.amazonaws.com,legit,4.40437,12,18,50,0,0.66667,0.08809,9,4,4,3,20,9,0,0,0,9
9644,cfbmiebqissyorgrx.com,dga,3.72565,5,15,21,1,0.33333,0.17741,1,0,0,0,1,3,0,0,0,3
453,c.msn.com,legit,2.50326,1,6,9,0,0.16667,0.27814,1,0,0,0,1,0,0,0,0,0
7045,lpkrmcbirpdy.biz,dga,3.5,2,13,16,1,0.15385,0.21875,0,0,0,0,0,0,0,0,0,0
7929,pyhrnjoxeirreqdg.com,dga,3.88418,5,14,20,1,0.35714,0.19421,1,0,0,0,1,1,0,0,0,1
3624,nrb.ybp.yahoo.com,legit,3.29277,4,10,17,0,0.4,0.19369,2,0,0,1,3,0,0,0,0,0
7740,o23lxfa5sbhjmbkuht.ru,dga,4.1066,4,13,21,1,0.30769,0.19555,0,0,0,0,0,0,0,0,0,0
6277,ilfittadansindulgentias.com,dga,3.70805,10,16,27,1,0.625,0.13734,7,1,0,0,8,11,2,0,0,13
3811,bg.apr-52dd2-0503.edgecastdns.net,legit,3.96834,5,16,33,0,0.3125,0.12025,7,5,1,0,13,9,1,0,0,10
6058,adverterenummusfitibidem.com,dga,3.78039,11,16,28,1,0.6875,0.13501,7,0,0,0,7,9,3,0,0,12
3361,opinsights.azure.com,legit,3.92193,7,11,20,0,0.63636,0.1961,5,0,0,2,7,4,0,0,0,4
1712,f.c2r.ts.cdn.office.net,legit,3.34446,4,13,23,0,0.30769,0.14541,8,6,5,3,22,3,0,0,0,3
2588,1drv.com,legit,3.0,1,5,8,0,0.2,0.375,0,0,0,0,0,0,0,0,0,0
4433,worldaz.relay.teams.trafficmanager.net,legit,3.87254,12,22,38,0,0.54545,0.10191,11,3,1,3,18,13,1,0,0,14
4370,gslb.pinterest.net,legit,3.30827,4,12,18,0,0.33333,0.18379,8,0,0,0,8,6,4,1,0,11
6294,iuyceuwssyskcsek.org,dga,3.42193,6,13,20,1,0.46154,0.1711,2,0,0,0,2,2,0,0,0,2
6950,e41j26fuavhrjwg23gwkykzmwi35mwivkvet.ru,dga,4.3749,7,23,39,1,0.30435,0.11218,0,0,0,0,0,2,0,0,0,2
9161,aclcqsuiwcymao.biz,dga,3.68354,6,11,18,1,0.54545,0.20464,1,0,0,0,1,3,0,5,4,12
3957,rms.na.aadrm.com,legit,2.98346,4,9,16,0,0.44444,0.18647,3,0,0,0,3,0,0,0,0,0
5051,unmmhvnklfdombjhb.com,dga,3.63041,3,17,21,1,0.17647,0.17288,0,0,0,0,0,1,0,0,0,1
9839,masawumesuv.eu,dga,2.89629,7,6,14,1,1.16667,0.20688,2,0,0,0,2,4,0,0,0,4
4546,indexww.com.cdn.cloudflare.net,legit,3.80624,8,18,30,0,0.44444,0.12687,8,8,6,3,25,9,2,1,0,12
4743,us02web.zoom.us,legit,3.37356,5,6,15,0,0.83333,0.2249,2,0,0,0,2,1,0,0,0,1
6023,kvpvinwheyfeeajfmthdo.com,dga,4.05366,7,17,25,1,0.41176,0.16215,2,0,0,0,2,2,0,0,0,2
9292,cklphsuiwcymao.info,dga,3.93214,6,12,19,1,0.5,0.20695,1,0,0,0,1,2,0,5,4,11
6299,7jsbdulwa2ujhloeci.biz,dga,4.00489,7,12,22,1,0.58333,0.18204,1,0,0,0,1,1,0,0,0,1
9655,rmvtqnqxszfvqsfq.com,dga,3.52193,1,18,20,1,0.05556,0.1761,0,0,0,0,0,0,0,0,0,0
8394,enfscxuhxnyanolqh.su,dga,3.68418,5,14,20,1,0.35714,0.18421,1,0,0,0,1,2,0,0,0,2
7294,idiraybttibdingq.eu,dga,3.51109,7,11,19,1,0.63636,0.18479,3,0,0,0,3,3,1,0,0,4
3217,prod.odcsm1.live.com.akadns.net,legit,3.88583,8,17,31,0,0.47059,0.12535,10,9,9,9,37,5,4,1,0,10
856,yahoodns.net,legit,3.25163,4,7,12,0,0.57143,0.27097,2,1,0,1,4,2,1,0,0,3
7535,arythqqgtmjkjauhqa.com,dga,3.66353,5,16,22,1,0.3125,0.16652,0,0,0,0,0,1,0,0,0,1
876,iad-01.braze.com,legit,3.75,5,6,16,0,0.83333,0.23438,2,0,0,0,2,1,0,0,0,1
8014,vofubimipeg.eu,dga,3.37878,7,6,14,1,1.16667,0.24134,2,0,0,0,2,1,0,0,0,1
2117,global.ib-ibi.com,legit,3.17512,6,8,17,0,0.75,0.18677,1,0,0,0,1,0,0,0,0,0
959,msecnd.net,legit,2.92193,2,7,10,0,0.28571,0.29219,1,0,0,0,1,3,0,0,0,3
5977,ehhkfvdsspcw.com,dga,3.625,2,13,16,1,0.15385,0.22656,1,0,0,0,1,0,0,0,0,0
4860,server.agent-cluster1.prod.us001-prod.arcticwolf.net,legit,4.18133,13,28,52,0,0.46429,0.08041,14,7,4,2,27,10,6,1,0,17
6465,ncjstcwqtg.info,dga,3.50689,2,12,15,1,0.16667,0.23379,1,0,0,0,1,1,0,0,0,1
1547,dsp.adfarm1.adition.com,legit,3.64249,7,12,23,0,0.58333,0.15837,6,0,0,0,6,4,2,1,0,7
3503,avct.cloud,legit,3.12193,3,6,10,0,0.5,0.31219,0,0,0,0,0,0,0,0,0,0
2292,pro-market.net,legit,3.37878,4,8,14,0,0.5,0.24134,3,1,0,0,4,3,1,0,0,4
7017,bvquuajash.com,dga,3.52164,5,8,14,1,0.625,0.25155,0,0,0,0,0,1,0,0,0,1
991,intentiq.com,legit,3.08496,4,7,12,0,0.57143,0.25708,5,1,0,0,6,4,1,1,0,6
4400,ftp.hp.com,legit,2.92193,1,7,10,0,0.14286,0.29219,1,0,0,0,1,0,0,0,0,0
2433,hadronid.net,legit,3.25163,4,7,12,0,0.57143,0.27097,3,0,0,0,3,2,0,0,0,2
2416,mmx-ds.cdn.whatsapp.net,legit,3.70813,3,16,23,0,0.1875,0.16122,8,3,1,0,12,2,0,0,0,2
308,fastly.net,legit,3.12193,2,7,10,0,0.28571,0.31219,1,1,0,0,2,2,0,0,0,2
5287,sections-outcomes.nu,dga,3.34644,8,10,20,1,0.8,0.16732,6,1,0,0,7,8,3,1,1,13
9657,ifuvbodtrwbbvuakamo.com,dga,3.76227,8,14,23,1,0.57143,0.16358,1,1,1,0,3,1,0,0,0,1
8564,qjxqlbqjughpsbxx.eu,dga,3.43162,3,15,19,1,0.2,0.18061,0,0,0,0,0,0,0,0,0,0
7501,rejectinitial.it,dga,3.07782,7,8,16,1,0.875,0.19236,3,0,0,0,3,6,0,0,0,6
2103,p-n.io,legit,2.58496,2,2,6,0,1.0,0.43083,0,0,0,0,0,0,0,0,0,0
8939,olef16e2wpabi0a01v58q4i.ddns.net,dga,4.41391,8,13,32,1,0.61538,0.13793,3,1,0,0,4,5,4,3,2,14
9083,ezwkzulkna.com,dga,3.52164,4,9,14,1,0.44444,0.25155,0,0,0,0,0,0,0,0,0,0
1765,noam.presence.teams.microsoft.com,legit,3.5441,11,18,33,0,0.61111,0.1074,18,9,7,6,40,10,2,1,0,13
9169,fbfbdlamdnddffed.net,dga,3.04145,3,16,20,1,0.1875,0.15207,3,0,0,0,3,6,0,0,0,6
7128,rkumxtnoufdooxenwtj.com,dga,3.74095,7,15,23,1,0.46667,0.16265,3,0,0,0,3,1,0,0,0,1
9077,epowwy.mn,dga,2.9477,2,6,9,1,0.33333,0.32752,0,0,0,0,0,0,0,0,0,0
2108,events-ssc.33across.com,legit,3.46423,5,13,23,0,0.38462,0.15062,4,3,1,0,8,3,1,0,0,4
2608,teams-events-data.trafficmanager.net,legit,3.6287,12,20,36,0,0.6,0.1008,13,4,1,3,21,13,2,0,0,15
4992,dropboxstatic.com,legit,3.57247,5,11,17,0,0.45455,0.21015,6,0,0,0,6,5,1,0,0,6
2721,myvisualiq.net,legit,3.6645,5,8,14,0,0.625,0.26175,1,0,0,0,1,2,0,0,0,2
4127,chase.com,legit,2.9477,3,5,9,0,0.6,0.32752,1,0,0,0,1,2,1,0,0,3
5774,motherloadneedvarybonesteal.com,dga,3.78115,12,18,31,1,0.66667,0.12197,10,0,0,0,10,10,3,1,0,14
7984,rgvorkn.com,dga,3.0958,2,8,11,1,0.25,0.28144,0,0,0,0,0,1,0,0,0,1
7163,heatriskachievegroundevidence.com,dga,3.86198,14,18,33,1,0.77778,0.11703,6,0,0,0,6,10,2,1,0,13
5018,balladoptwelladdinfluence.com,dga,3.75887,10,18,29,1,0.55556,0.12962,4,0,0,0,4,6,1,1,0,8
4340,edgecast-cf-prod.yahoo.net,legit,3.87314,8,14,26,0,0.57143,0.14897,7,6,3,2,18,6,1,0,0,7
2487,pptsgs.officeapps.live.com,legit,3.64237,7,16,26,0,0.4375,0.14009,8,5,4,3,20,4,0,0,0,4
6401,jlpzeyctvt.com,dga,3.52164,2,11,14,1,0.18182,0.25155,0,0,0,0,0,0,0,0,0,0
7312,wwqnvmujo2uzxk1iix.com,dga,3.91398,6,13,22,1,0.46154,0.17791,0,0,0,0,0,0,0,0,0,0
1438,configuration.apple.com.akadns.net,legit,3.94761,12,18,34,0,0.66667,0.11611,14,11,10,10,45,9,7,3,1,20
1208,app-site-association.cdn-apple.com,legit,3.68233,12,17,34,0,0.70588,0.1083,11,4,2,1,18,9,4,2,1,16
1338,autopush.prod.mozaws.net,legit,3.77206,8,13,24,0,0.61538,0.15717,5,4,3,2,14,0,1,0,0,1
1393,pubsub.googleapis.com,legit,3.59447,8,11,21,0,0.72727,0.17117,5,6,4,4,19,4,0,0,0,4
9766,hmihslrqbgxs.biz,dga,3.5,2,13,16,1,0.15385,0.21875,1,0,0,0,1,1,0,0,0,1
4947,storage.endpoint.ingress.rapid7.com,legit,3.79987,11,19,35,0,0.57895,0.10857,12,2,0,0,14,9,3,0,0,12
6699,phonenoninestimabile.com,dga,3.57393,10,13,24,1,0.76923,0.14891,8,0,0,0,8,10,3,0,0,13
4061,powerpointonline.nelsdf.measure.office.net,legit,3.80253,16,22,42,0,0.72727,0.09054,12,4,4,3,23,11,1,0,0,12
4614,api.github.com,legit,3.52164,5,7,14,0,0.71429,0.25155,2,1,1,0,4,1,0,0,0,1
3727,da.us.criteo.com,legit,3.45282,6,7,16,0,0.85714,0.2158,5,0,0,0,5,3,0,0,0,3
9026,cifucghvx.ug,dga,3.08496,3,8,12,1,0.375,0.25708,0,0,0,0,0,0,0,0,0,0
4558,b1-nydc1.zemanta.com,legit,3.72193,4,11,20,0,0.36364,0.1861,3,0,0,0,3,4,0,0,0,4
6086,jclmwrdwrimlmm.biz,dga,3.28104,2,15,18,1,0.13333,0.18228,0,0,0,0,0,1,0,0,0,1
2949,app-site-association.g.aaplimg.com,legit,3.65719,13,16,34,0,0.8125,0.10756,9,1,0,0,10,7,4,2,1,14
9592,ctwvcl5da8i4gp3xiteti4a.ddns.net,dga,4.07782,7,18,32,1,0.38889,0.12743,4,1,0,0,5,8,4,3,2,17
1599,dmp.brand-display.com,legit,3.78494,4,14,21,0,0.28571,0.18024,3,0,0,0,3,5,1,0,0,6
2656,ontology.health.apple.com,legit,3.54347,8,14,25,0,0.57143,0.14174,9,4,3,2,18,3,0,0,0,3
4415,radio-activity.itunes.apple.com,legit,3.97792,12,15,31,0,0.8,0.12832,10,4,3,2,19,7,0,0,0,7
5611,ccmfadfdncckcdaa.com,dga,2.87095,4,15,20,1,0.26667,0.14355,3,0,0,0,3,1,0,0,0,1
111,pipe.aria.microsoft.com,legit,3.46858,9,11,23,0,0.81818,0.15081,9,8,7,6,30,4,0,0,0,4
1952,ring.com,legit,3.0,2,5,8,0,0.4,0.375,1,0,0,0,1,2,2,0,0,4
8657,obsplhzppj.com,dga,3.32486,2,11,14,1,0.18182,0.23749,2,0,0,0,2,0,0,0,0,0
9268,mhxuqtlhbg.com,dga,3.52164,2,11,14,1,0.18182,0.25155,0,0,0,0,0,0,0,0,0,0
1165,chartbeat.net,legit,3.02699,4,8,13,0,0.5,0.23285,2,0,0,0,2,4,1,1,0,6
2812,google.co.uk,legit,2.85539,5,5,12,0,1.0,0.23795,5,5,3,2,15,2,1,0,0,3
1528,s-ring.msedge.net,legit,3.33718,4,10,17,0,0.4,0.1963,5,2,1,0,8,5,2,0,0,7
6482,i4aw2cykmc60.top,dga,3.875,3,8,16,1,0.375,0.24219,0,0,0,0,0,0,0,0,0,0
2507,gspe21-ssl.ls.apple.com,legit,3.46858,4,13,23,0,0.30769,0.15081,6,4,3,2,15,1,0,0,0,1
9135,7rcnkni01jmbwdclmpy.ddns.net,dga,4.13754,2,21,28,1,0.09524,0.14777,2,1,0,0,3,5,3,2,2,12
8625,hermanntribueretmachi.com,dga,3.59327,9,15,25,1,0.6,0.14373,4,0,0,0,4,7,2,0,0,9
9507,xlzahikcak.com,dga,3.37878,4,9,14,1,0.44444,0.24134,0,0,0,0,0,1,0,0,0,1
3511,e40491.dscg.akamaiedge.net,legit,3.79622,8,10,26,0,0.8,0.14601,7,5,5,3,20,5,0,0,0,5
3108,www.tm.prd.ags.trafficmanager.net,legit,3.71487,7,21,33,0,0.33333,0.11257,10,4,1,3,18,6,1,0,0,7
3568,e4518.dscx.akamaiedge.net,legit,3.86347,8,10,25,0,0.8,0.15454,7,5,5,3,20,5,0,0,0,5
8735,nnbbsqyoscskqea.org,dga,3.57662,4,14,19,1,0.28571,0.18824,1,0,0,0,1,1,0,0,0,1
6688,bhbhieqhqs.com,dga,3.18201,3,10,14,1,0.3,0.22729,0,0,0,0,0,0,0,0,0,0
5042,workshop-park.re,dga,3.32782,4,10,16,1,0.4,0.20799,0,0,0,0,0,2,0,0,0,2
8544,jsqutvuoho.com,dga,3.32486,5,8,14,1,0.625,0.23749,0,0,0,0,0,0,0,0,0,0
389,r.bing.com,legit,3.12193,2,6,10,0,0.33333,0.31219,1,0,0,0,1,1,1,0,0,2
2641,b.videoamp.com,legit,3.37878,5,7,14,0,0.71429,0.24134,1,0,0,0,1,2,0,0,0,2
5668,axbabuivaxipudt.ddns.net,dga,3.60539,8,14,24,1,0.57143,0.15022,2,1,0,0,3,4,3,2,1,10
2726,array613.prod.do.dsp.mp.microsoft.com,legit,3.71259,8,20,37,0,0.4,0.10034,12,12,10,9,43,5,2,0,0,7
8688,gmououkq4u02.org,dga,3.28064,6,6,16,1,1.0,0.20504,1,0,0,0,1,0,0,0,0,0
7731,chcreelwtlcw.pw,dga,3.00624,2,12,15,1,0.16667,0.20042,2,0,0,0,2,2,0,0,0,2
6488,packliftreserveassociate.com,dga,3.72647,11,16,28,1,0.6875,0.13309,8,1,1,0,10,10,5,1,0,16
178,googlevideo.com,legit,3.10689,7,7,15,0,1.0,0.20713,2,4,3,2,11,2,0,0,0,2
188,itunes-apple.com.akadns.net,legit,3.82824,9,14,27,0,0.64286,0.14179,11,9,9,9,38,8,3,1,0,12
429,content.office.net,legit,2.933,6,10,18,0,0.6,0.16294,8,6,4,3,21,6,2,0,0,8
403,pancake.apple.com,legit,3.17512,6,9,17,0,0.66667,0.18677,6,4,3,2,15,3,0,0,0,3
1450,sync.bfmio.com,legit,3.23593,3,9,14,0,0.33333,0.23114,1,0,0,0,1,1,0,0,0,1
343,pixel.rubiconproject.com,legit,3.77206,8,14,24,0,0.57143,0.15717,6,2,0,0,8,5,2,0,0,7
4125,rcp.c.appier.net,legit,3.03064,4,9,16,0,0.44444,0.18942,7,2,1,0,10,1,0,0,0,1
9070,wpdvdtysvux.com,dga,3.64022,2,12,15,1,0.16667,0.24268,0,0,0,0,0,0,0,0,0,0
7779,vqoihqfgbphaaa.com,dga,3.57243,6,11,18,1,0.54545,0.19847,0,0,0,0,0,0,0,0,0,0
8774,pwytolmronmg.com,dga,3.40564,3,12,16,1,0.25,0.21285,2,0,0,0,2,1,0,0,0,1
7718,difficultnothing.net,dga,3.50869,6,13,20,1,0.46154,0.17543,2,2,1,0,5,2,1,0,0,3
2813,l.doubleclick.net,legit,3.45482,5,10,17,0,0.5,0.20322,5,0,0,0,5,4,0,0,0,4
1000,pull-cmaf-f16-tt02.fcdn.us.tiktokv.com,legit,4.18833,6,21,38,0,0.28571,0.11022,7,7,7,4,25,3,0,0,0,3
1496,d9.flashtalking.com,legit,3.93214,4,12,19,0,0.33333,0.20695,2,0,0,0,2,4,1,0,0,5
877,a-mo.net,legit,3.0,3,3,8,0,1.0,0.375,0,0,0,0,0,0,0,0,0,0
3326,www.adtilt.com,legit,3.18201,3,9,14,0,0.33333,0.22729,3,0,0,0,3,1,0,0,0,1
5715,hyvpgtlpkmkf.com,dga,3.625,1,14,16,1,0.07143,0.22656,0,0,0,0,0,0,0,0,0,0
418,engagement.office.com,legit,3.3447,8,11,21,0,0.72727,0.15927,6,6,4,3,19,5,1,0,0,6
7241,ezrmiqtcvq.com,dga,3.37878,3,10,14,1,0.3,0.24134,1,0,0,0,1,1,0,0,0,1
8728,daucoyjnbthrpivtkhj.mu,dga,4.0958,5,16,22,1,0.3125,0.18617,2,0,0,0,2,1,0,0,0,1
4024,getpublica.com,legit,3.6645,5,8,14,0,0.625,0.26175,3,0,0,0,3,4,0,0,0,4
949,cm.everesttech.net,legit,3.03856,5,11,18,0,0.45455,0.16881,5,0,0,0,5,7,4,0,0,11
4067,grs.platform.dbankcloud.ru,legit,3.95006,6,17,26,0,0.35294,0.15193,6,3,2,1,12,5,0,0,0,5
3011,odcsm1.live.com.akadns.net,legit,3.77736,7,14,26,0,0.5,0.14528,7,6,7,8,28,5,3,1,0,9
7534,cloudchartcrewmovelaughexist.com,dga,4.01532,11,20,32,1,0.55,0.12548,5,3,2,1,11,7,3,1,0,11
3350,static-tracking.klaviyo.com,legit,3.82824,8,16,27,0,0.5,0.14179,7,0,0,0,7,9,3,0,0,12
9569,gmqoogosgmkossms.org,dga,2.7037,5,14,20,1,0.35714,0.13518,1,1,0,0,2,0,0,0,0,0
1847,yandex.ru,legit,3.16993,3,5,9,0,0.6,0.35221,0,0,0,0,0,3,1,0,0,4
322,entrust.net,legit,2.66353,3,7,11,0,0.42857,0.24214,4,1,0,0,5,2,1,0,0,3
186,gcp.gvt2.com,legit,3.08496,1,8,12,0,0.125,0.25708,1,0,0,0,1,0,0,0,0,0
7264,yppdatbremfbbdhn.eu,dga,3.68188,4,14,19,1,0.28571,0.19378,3,0,0,0,3,3,0,0,0,3
3292,api.apptentive.com,legit,3.35021,7,9,18,0,0.77778,0.18612,8,4,2,0,14,4,1,0,0,5
4303,yieldlab.net,legit,3.25163,4,7,12,0,0.57143,0.27097,0,0,0,0,0,2,0,0,0,2
6875,qxasnpdie.yi.org,dga,3.75,5,9,16,1,0.55556,0.23438,1,0,0,0,1,1,0,0,0,1
1726,maps.google.com,legit,3.1899,5,8,15,0,0.625,0.21266,5,5,4,3,17,2,0,0,0,2
7813,igeqfvywfendpuv.biz,dga,3.82687,5,13,19,1,0.38462,0.20141,2,0,0,0,2,3,0,0,0,3
5432,otbeipweda.ddns.net,dga,3.43162,6,11,19,1,0.54545,0.18061,3,1,0,0,4,6,4,3,2,15
9473,siriteb.info,dga,3.18872,5,6,12,1,0.83333,0.26573,1,0,0,0,1,4,0,0,0,4
1521,prg.smartadserver.com,legit,3.53517,5,14,21,0,0.35714,0.16834,7,1,1,0,9,6,3,1,0,10
2632,t.teads.tv,legit,2.64644,2,6,10,0,0.33333,0.26464,5,0,0,0,5,2,0,0,0,2
8633,nuressumaww.com,dga,3.37356,5,9,15,1,0.55556,0.2249,3,0,0,0,3,4,2,0,0,6
2808,ak.dynamic.tiles.virtualearth.net,legit,3.84713,11,18,33,0,0.61111,0.11658,10,2,0,0,12,9,2,1,0,12
6313,sh5hydmvq6khc2w2a65f3p5.ddns.net,dga,4.24173,2,20,32,1,0.1,0.13255,2,1,0,0,3,4,3,2,2,11
3113,elb.us-east-2.amazonaws.com,legit,3.81008,9,12,27,0,0.75,0.14111,7,2,3,3,15,7,0,0,0,7
3152,s-microsoft.com,legit,3.1899,4,9,15,0,0.44444,0.21266,5,7,6,5,23,2,0,0,0,2
283,bam.nr-data.net,legit,3.1899,4,8,15,0,0.5,0.21266,3,0,0,0,3,3,0,0,0,3
5252,iwiqedomnn.cc,dga,3.2389,4,8,13,1,0.5,0.24915,1,0,0,0,1,2,0,0,0,2
9911,gqjyacuiwcymao.net,dga,3.83659,6,11,18,1,0.54545,0.21314,1,0,0,0,1,2,0,5,4,11
6454,pelupigunigivud.ddns.net,dga,3.45915,8,14,24,1,0.57143,0.14413,4,1,0,0,5,6,3,2,1,12
2702,aws.api.sc-gw.com,legit,3.33718,4,9,17,0,0.44444,0.1963,4,2,1,0,7,0,0,0,0,0
6893,jejider.info,dga,3.08496,5,6,12,1,0.83333,0.25708,1,0,0,0,1,2,0,0,0,2
6186,vncitydblhyq.net,dga,3.625,2,13,16,1,0.15385,0.22656,0,0,0,0,0,1,0,0,0,1
9345,cq4isqoekmwa.net,dga,3.75,5,9,16,1,0.55556,0.23438,0,0,0,0,0,1,0,0,0,1
6561,fettlijyycee.net,dga,3.07782,5,10,16,1,0.5,0.19236,2,0,0,0,2,2,0,0,0,2
2804,northcentralus.cloudapp.azure.com,legit,3.87684,11,19,33,0,0.57895,0.11748,14,5,3,4,26,5,2,0,0,7
4679,sgsnssdk.com,legit,2.9183,1,10,12,0,0.1,0.24319,0,0,0,0,0,1,0,0,0,1
5940,iymaaiiugkeq.info,dga,3.49923,9,7,17,1,1.28571,0.20584,1,0,0,0,1,1,0,3,2,6
3567,www.amazon.fr,legit,3.02699,3,8,13,0,0.375,0.23285,4,1,3,3,11,3,0,0,0,3
2180,netcts.cdn-apple.com,legit,3.58418,4,13,20,0,0.30769,0.17921,8,4,2,1,15,4,0,0,0,4
3238,c.contentsquare.net,legit,3.28663,6,11,19,0,0.54545,0.17298,7,3,0,0,10,6,3,0,0,9
6134,ewduarujle.yi.org,dga,3.61687,7,8,17,1,0.875,0.21276,2,0,0,0,2,2,0,0,0,2
7688,ew2w2k2c2gis.net,dga,3.25,3,8,16,1,0.375,0.20312,0,0,0,0,0,1,0,0,0,1
9312,uvaxluufeqcuxi.ddns.net,dga,3.74095,8,13,23,1,0.61538,0.16265,2,1,0,0,3,4,4,3,2,13
2676,onedscolprdwus08.westus.cloudapp.azure.com,legit,3.98709,13,23,42,0,0.56522,0.09493,17,4,3,4,28,7,2,0,0,9
4851,c.aaxads.com,legit,2.85539,4,6,12,0,0.66667,0.23795,3,0,0,0,3,0,0,0,0,0
460,sharethrough.com,legit,3.45282,5,10,16,0,0.5,0.2158,3,0,0,0,3,3,0,0,0,3
6260,mujuxnei.ru,dga,3.02717,5,5,11,1,1.0,0.2752,0,0,0,0,0,1,0,0,0,1
7574,panicicereplybelongpendemand.com,dga,3.71502,11,20,32,1,0.55,0.11609,9,1,0,0,10,14,2,0,0,16
3459,init.push-apple.com.akadns.net,legit,3.89807,9,16,30,0,0.5625,0.12994,12,9,9,9,39,8,3,1,0,12
5430,ninolmngffkk.com,dga,3.20282,3,12,16,1,0.25,0.20018,1,0,0,0,1,2,0,0,0,2
3341,s2s.aniview.com,legit,3.50689,5,7,15,0,0.71429,0.23379,2,0,0,0,2,2,0,0,0,2
3775,mgr.consensu.org,legit,3.25,4,10,16,0,0.4,0.20312,5,2,0,0,7,6,3,0,0,9
6447,tibegotatani.ddns.net,dga,3.30875,7,12,21,1,0.58333,0.15756,5,1,0,0,6,10,4,3,2,19
7889,rqo7i87u4ifqnwpizf.cn,dga,3.78494,5,11,21,1,0.45455,0.18024,1,0,0,0,1,0,0,0,0,0
3246,client-upgrade-a.wbx2.com,legit,4.24386,7,13,25,0,0.53846,0.16975,5,1,0,0,6,3,1,0,0,4
7067,habetpecuucelum.com,dga,3.39189,8,10,19,1,0.8,0.17852,1,0,0,0,1,5,0,0,0,5
4460,pus2-collabhubrtc.officeapps.live.com,legit,4.10082,11,21,37,0,0.52381,0.11083,10,5,4,3,22,6,0,0,0,6
165,gvt2.com,legit,3.0,1,5,8,0,0.2,0.375,0,0,0,0,0,0,0,0,0,0
1692,is5-ssl.mzstatic.com,legit,3.42193,4,12,20,0,0.33333,0.1711,6,0,0,0,6,6,1,0,0,7
1224,aadcdn.msftauth.net,legit,3.43162,5,12,19,0,0.41667,0.18061,5,2,1,0,8,2,0,0,0,2
3958,secure-gg.imrworldwide.com,legit,3.71929,8,15,26,0,0.53333,0.14305,2,0,0,0,2,5,0,0,0,5
830,redirector.googlevideo.com,legit,3.37873,11,13,26,0,0.84615,0.12995,4,5,4,3,16,6,0,0,0,6
4785,keyvalueservice.fe.apple-dns.net,legit,3.8623,11,17,32,0,0.64706,0.1207,12,7,4,3,26,8,3,1,0,12
4782,use.byoip.nt.meraki.com,legit,3.82791,8,11,23,0,0.72727,0.16643,8,0,0,0,8,3,0,0,0,3
189,amazontrust.com,legit,3.37356,5,9,15,0,0.55556,0.2249,6,1,3,2,12,4,0,0,0,4
3966,e.serverbid.com,legit,3.32323,5,8,15,0,0.625,0.22155,3,1,1,0,5,3,3,1,0,7
4490,et-eus.w.inmobi.com,legit,3.57662,7,8,19,0,0.875,0.18824,3,0,0,0,3,2,0,0,0,2
4307,pix.spot.im,legit,2.91398,3,6,11,0,0.5,0.26491,1,0,0,0,1,0,0,0,0,0
6758,signupinsects.ch,dga,3.32782,4,11,16,1,0.36364,0.20799,3,0,0,0,3,5,1,0,0,6
194,v20.events.data.microsoft.com,legit,3.8404,8,15,29,0,0.53333,0.13243,12,9,7,6,34,7,1,0,0,8
1621,yt3.googleusercontent.com,legit,3.62347,8,14,25,0,0.57143,0.14494,10,8,4,3,25,7,3,0,0,10
5623,pdqiownrijmhls.info,dga,3.78714,5,13,19,1,0.38462,0.19932,0,0,0,0,0,1,0,0,0,1
8125,mycwcmyyqqmwycsc.org,dga,3.08418,1,18,20,1,0.05556,0.15421,0,0,0,0,0,0,0,0,0,0
16,office.com,legit,2.72193,4,5,10,0,0.8,0.27219,3,4,3,2,12,2,0,0,0,2
7439,pxfuknixmmdw.us,dga,3.50689,3,11,15,1,0.27273,0.23379,0,0,0,0,0,1,0,0,0,1
291,autodiscover-s.outlook.com,legit,3.71929,11,12,26,0,0.91667,0.14305,6,0,0,0,6,4,2,0,0,6
3849,f-log-win-extension.grammarly.io,legit,3.96814,10,17,32,0,0.58824,0.124,8,0,0,0,8,10,1,0,0,11
1603,static.chartbeat.com,legit,3.34644,6,12,20,0,0.5,0.16732,7,0,0,0,7,8,2,1,0,11
2169,get-bx.g.aaplimg.com,legit,3.64644,5,11,20,0,0.45455,0.18232,5,0,0,0,5,2,0,0,0,2
1722,shopify.com,legit,3.27761,3,7,11,0,0.42857,0.29796,1,0,0,0,1,0,0,0,0,0
4819,prod.do.dsp.trafficmanager.net,legit,3.76474,8,18,30,0,0.44444,0.12549,12,6,3,4,25,7,3,0,0,10
6314,aswgjokkq.sc,dga,3.25163,2,9,12,1,0.22222,0.27097,0,0,0,0,0,1,0,0,0,1
6142,kqwa4m4awy42.org,dga,3.45282,3,8,16,1,0.375,0.2158,0,0,0,0,0,0,0,0,0,0
4550,config-edge-skype.l-0007.l-msedge.net,legit,3.97231,8,18,37,0,0.44444,0.10736,6,3,1,0,10,5,1,0,0,6
4276,dev.visualwebsiteoptimizer.com,legit,3.97356,12,16,30,0,0.75,0.13245,4,0,0,0,4,9,0,0,0,9
8794,yetsqsdsholapet.org,dga,3.68188,5,13,19,1,0.38462,0.19378,2,0,0,0,2,2,0,5,5,12
2432,dns.apple.com,legit,3.39275,3,8,13,0,0.375,0.26098,7,5,3,2,17,3,1,0,0,4
7972,koosracu.ddns.net,dga,3.49923,5,10,17,1,0.5,0.20584,4,1,0,0,5,6,3,3,2,14
2589,c.worldfcdn2.com,legit,3.32782,2,11,16,0,0.18182,0.20799,2,1,0,0,3,2,0,0,0,2
2277,lexicon.33across.com,legit,3.54644,6,10,20,0,0.6,0.17732,6,3,1,0,10,5,1,0,0,6
2671,matching.ivitrack.com,legit,3.55852,6,13,21,0,0.46154,0.16945,4,0,0,0,4,6,2,0,0,8
7361,towelturnhandleadmirebelieve.com,dga,3.86673,13,18,32,1,0.72222,0.12084,6,0,0,0,6,9,2,0,0,11
5004,rjyuosmhfnaedlyg.eu,dga,3.93214,6,12,19,1,0.5,0.20695,1,0,0,0,1,1,0,0,0,1
7552,tunikyv.info,dga,3.25163,4,7,12,1,0.57143,0.27097,0,0,0,0,0,1,0,0,0,1
8406,melohguf.com,dga,3.25163,4,7,12,1,0.57143,0.27097,1,0,0,0,1,1,0,0,0,1
7888,dndqwejzab.com,dga,3.6645,3,10,14,1,0.3,0.26175,1,0,0,0,1,2,0,0,0,2
8530,institutarobertmartino.com,dga,3.4745,10,15,26,1,0.66667,0.13363,7,0,0,0,7,10,0,0,0,10
4886,etsy.com,legit,3.0,2,5,8,0,0.4,0.375,0,0,0,0,0,1,0,0,0,1
4339,akamai.steamstatic.com,legit,3.13582,9,11,22,0,0.81818,0.14254,9,2,3,2,16,9,1,0,0,10
4619,2-01-37d2-0018.cdx.cedexis.net,legit,3.84774,4,10,30,0,0.4,0.12826,4,0,0,0,4,4,0,0,0,4
9298,pacebeofficercakefunction.com,dga,3.64697,12,16,29,1,0.75,0.12576,6,4,3,2,15,8,2,1,1,12
5148,cumoqlux.ru,dga,3.02717,4,6,11,1,0.66667,0.2752,0,0,0,0,0,0,0,0,0,0
2854,apple.com.edgesuite.net,legit,3.63815,9,11,23,0,0.81818,0.15818,11,8,5,3,27,9,2,1,0,12
7609,hbeqlzo.co.nz,dga,3.2389,3,8,13,1,0.375,0.24915,2,1,0,0,3,2,1,0,0,3
3718,capi.samsungcloud.com,legit,3.59447,7,12,21,0,0.58333,0.17117,5,4,3,1,13,3,0,0,0,3
7139,xfmltsomijbiu.com,dga,3.57247,5,11,17,1,0.45455,0.21015,1,0,0,0,1,2,0,0,0,2
6716,zpgydfrj.co.vi,dga,3.6645,2,10,14,1,0.2,0.26175,2,1,0,0,3,1,1,0,0,2
7042,hctwwwmhoncj.biz,dga,3.45282,2,13,16,1,0.15385,0.2158,1,0,0,0,1,1,0,0,0,1
4016,hybrid.ai,legit,2.9477,3,5,9,0,0.6,0.32752,0,0,0,0,0,1,0,0,0,1
627,turn.com,legit,3.0,2,5,8,0,0.4,0.375,0,0,0,0,0,0,1,0,0,1
838,onedrive.live.com,legit,3.33718,7,8,17,0,0.875,0.1963,4,0,0,0,4,5,1,0,0,6
4047,t-msedge.net,legit,3.02206,3,7,12,0,0.42857,0.25184,3,2,1,0,6,3,0,0,0,3
7567,acwuxyrasn.com,dga,3.52164,4,9,14,1,0.44444,0.25155,1,0,0,0,1,3,0,0,0,3
5477,tgakiudztg.com,dga,3.52164,4,9,14,1,0.44444,0.25155,0,0,0,0,0,0,0,0,0,0
9659,erzrwnsqyz.com,dga,3.52164,2,11,14,1,0.18182,0.25155,1,0,0,0,1,2,0,0,0,2
2262,39-courier.push.apple.com,legit,3.86347,8,11,25,0,0.72727,0.15454,9,4,3,2,18,4,0,0,0,4
3505,download.windowsupdate.com.c.footprint.net,legit,3.82388,13,24,42,0,0.54167,0.09104,12,3,2,2,19,8,4,1,0,13
7914,zechariahburgundy.net,dga,3.82089,7,13,21,1,0.53846,0.18195,0,0,0,0,0,4,1,1,0,6
5959,glgsefaroembmgti.eu,dga,3.64215,7,11,19,1,0.63636,0.19169,3,0,0,0,3,4,0,0,0,4
8090,snsnfliebxtlhmevki.eu,dga,3.78494,6,14,21,1,0.42857,0.18024,1,0,0,0,1,1,0,0,0,1
8194,modohwotd.com,dga,2.77736,4,8,13,1,0.5,0.21364,0,0,0,0,0,0,0,0,0,0
3594,brightcove.com,legit,3.52164,4,9,14,0,0.44444,0.25155,1,0,0,0,1,3,1,0,0,4
8320,oefcakqedj.com,dga,3.37878,5,8,14,1,0.625,0.24134,1,0,0,0,1,2,0,0,0,2
7756,ouaawswfqxkm.ug,dga,3.50689,5,9,15,1,0.55556,0.23379,1,0,0,0,1,0,0,0,0,0
7356,thoughttradereplyspecify.com,dga,4.03915,8,19,28,1,0.42105,0.14426,6,0,0,0,6,5,2,0,0,7
5734,quammeritoveritatem.com,dga,3.41444,10,12,23,1,0.83333,0.14845,5,0,0,0,5,9,5,0,0,14
7531,cwfpc6shfrv24e3gpg.biz,dga,4.0958,2,15,22,1,0.13333,0.18617,0,0,0,0,0,0,0,0,0,0
8578,lhzdtmwkijcexg.com,dga,3.9477,3,14,18,1,0.21429,0.21932,1,0,0,0,1,1,0,0,0,1
2685,track.activemetering.com,legit,3.57393,8,14,24,0,0.57143,0.14891,6,0,0,0,6,10,5,0,0,15
2192,pull-flv-l10-gcp01.tiktokcdn.com.rocket-cdn.com,legit,4.08609,7,28,47,0,0.25,0.08694,7,10,12,10,39,5,2,1,0,8
6737,lypdhedj.su,dga,3.27761,2,8,11,1,0.25,0.29796,1,0,0,0,1,1,0,0,0,1
6330,gugm4mkqkusy.net,dga,3.5,3,11,16,1,0.27273,0.21875,1,0,0,0,1,0,0,0,0,0
6245,hikz.ps,dga,2.80735,1,5,7,1,0.2,0.40105,0,0,0,0,0,0,0,0,0,0
3367,cbg-app.huawei.com,legit,3.72548,6,9,18,0,0.66667,0.20697,3,1,0,0,4,0,0,0,0,0
3537,cs.roku.com,legit,2.91398,3,6,11,0,0.5,0.26491,2,0,0,0,2,0,0,0,0,0
3740,gsp57-ssl-background.ls.apple.com,legit,4.06668,6,20,33,0,0.3,0.12323,9,4,3,2,18,3,0,0,0,3
6638,jssfunavmgmys.com,dga,3.52806,3,13,17,1,0.23077,0.20753,0,0,0,0,0,0,0,0,0,0
1703,zdassets.com,legit,3.18872,3,8,12,0,0.375,0.26573,1,0,0,0,1,3,1,0,0,4
1561,geoedge.be,legit,2.32193,5,4,10,0,1.25,0.23219,2,2,1,0,5,2,0,0,0,2
2124,1447723502.rsc.cdn77.org,legit,3.72018,1,8,24,0,0.125,0.15501,3,1,0,0,4,1,0,0,0,1
9426,hunkxtilshdg.ru,dga,3.64022,3,11,15,1,0.27273,0.24268,1,0,0,0,1,1,0,0,0,1
7350,nrsdjum.dyndns.org,dga,3.30827,2,14,18,1,0.14286,0.18379,2,1,0,0,3,4,3,4,3,14
7389,yfhbhmvxdvjxgne.com,dga,3.82687,2,16,19,1,0.125,0.20141,0,0,0,0,0,1,0,0,0,1
9358,nodiaylmrcyyubhx.eu,dga,3.89241,6,12,19,1,0.5,0.20486,0,0,0,0,0,0,0,0,0,0
7508,showsfire.la,dga,3.4183,4,7,12,1,0.57143,0.28486,1,0,0,0,1,1,0,0,0,1
696,ms-acdc.office.com,legit,3.28104,5,10,18,0,0.5,0.18228,4,4,4,3,15,3,0,0,0,3
4334,ct.sendgrid.net,legit,3.24022,3,10,15,0,0.3,0.21601,2,0,0,0,2,4,0,0,0,4
9050,casfjcttvcorfff.com,dga,3.1953,3,15,19,1,0.2,0.16817,1,0,0,0,1,4,0,0,0,4
544,c.go-mpulse.net,legit,3.64022,4,8,15,0,0.5,0.24268,1,1,0,0,2,1,0,0,0,1
5526,yyvasoonkw.com,dga,3.32486,4,9,14,1,0.44444,0.23749,2,0,0,0,2,2,0,0,0,2
3606,conn-service-us-05.allawnos.com,legit,3.92921,9,15,31,0,0.6,0.12675,8,3,1,1,13,7,3,1,0,11
8412,usweksiekocaowcg.org,dga,3.48418,8,11,20,1,0.72727,0.17421,1,0,0,0,1,2,0,0,0,2
7623,eyanxlqarebqgpgea.com,dga,3.74899,7,13,21,1,0.53846,0.17852,3,0,0,0,3,5,0,0,0,5
6067,fvewcsrj.tv,dga,3.27761,1,9,11,1,0.11111,0.29796,0,0,0,0,0,1,0,0,0,1
5779,fpzgzgn.com,dga,3.0958,1,9,11,1,0.11111,0.28144,0,0,0,0,0,0,0,0,0,0
112,fp.measure.office.com,legit,3.42733,8,10,21,0,0.8,0.16321,8,4,4,3,19,6,0,0,0,6
4833,epc.geo.mnc260.mcc310.pub.3gppnetwork.org,legit,3.9972,7,21,41,0,0.33333,0.09749,3,0,0,0,3,4,0,0,0,4
2568,courier-sandbox-push-apple.com.akadns.net,legit,4.1555,13,22,41,0,0.59091,0.10135,13,9,9,9,40,9,4,1,0,14
1097,metadata.templates.cdn.office.net,legit,3.5529,11,18,33,0,0.61111,0.10766,14,6,5,3,28,10,1,0,0,11
176,manage.microsoft.com,legit,3.54644,7,11,20,0,0.63636,0.17732,9,9,7,8,33,5,0,0,0,5
8759,btewlkmsmjpoiot.info,dga,3.78418,6,13,20,1,0.46154,0.18921,1,0,0,0,1,1,0,0,0,1
2728,v.liveperson.net,legit,3.32782,5,9,16,0,0.55556,0.20799,3,0,0,0,3,3,1,0,0,4
1171,pn.ybp.yahoo.com,legit,3.15564,4,9,16,0,0.44444,0.19723,2,0,0,1,3,0,0,0,0,0
3827,rc.rlcdn.com,legit,2.85539,1,9,12,0,0.11111,0.23795,2,1,0,0,3,1,0,0,0,1
7586,8igecigu4awa.org,dga,3.45282,7,6,16,1,1.16667,0.2158,1,0,0,0,1,2,0,0,0,2
8309,ganykuw.com,dga,3.45943,3,7,11,1,0.42857,0.31449,0,0,0,0,0,1,0,0,0,1
7244,cassandracaulfield.net,dga,3.55034,8,13,22,1,0.61538,0.16138,1,0,0,0,1,7,2,0,0,9
4836,sjc.zoom.us,legit,2.91398,3,6,11,0,0.5,0.26491,1,0,0,0,1,1,0,0,0,1
8580,ynciepryamqrjti.biz,dga,3.78714,5,13,19,1,0.38462,0.19932,3,0,0,0,3,2,0,0,0,2
9255,brrerchiz.com,dga,3.18083,3,9,13,1,0.33333,0.24468,2,0,0,0,2,2,0,0,0,2
9768,lxauaffjmslgasgkx.su,dga,3.34644,5,14,20,1,0.35714,0.16732,0,0,0,0,0,1,0,0,0,1
2860,v25.tiktokcdn-us.com,legit,3.82193,4,11,20,0,0.36364,0.1911,5,6,7,6,24,2,0,0,0,2
3598,ha-teams.office.com,legit,3.51109,7,9,19,0,0.77778,0.18479,7,4,4,3,18,5,0,0,0,5
5832,lvnbxxltmfcc.biz,dga,3.5,1,14,16,1,0.07143,0.21875,0,0,0,0,0,0,0,0,0,0
2023,secure.flashtalking.com,legit,4.00182,7,14,23,0,0.5,0.17399,5,0,0,0,5,7,1,0,0,8
375,www.apple.com,legit,3.02699,3,8,13,0,0.375,0.23285,5,4,3,2,14,1,0,0,0,1
3015,emea.ng.msg.teams.microsoft.com,legit,3.48697,9,17,31,0,0.52941,0.11248,11,8,7,6,32,6,0,0,0,6
1337,cdn77.org,legit,2.9477,1,5,9,0,0.2,0.32752,2,1,0,0,3,1,0,0,0,1
8678,mty0eradi03ncba0ud7.ddns.net,dga,3.89629,6,15,28,1,0.4,0.13915,5,1,0,0,6,6,3,3,2,14
7766,cdjmbkkbtgfj.co.in,dga,3.61437,2,14,18,1,0.14286,0.2008,3,1,0,0,4,1,1,0,0,2
9401,mnebirgifvlbuare.com,dga,3.82193,7,12,20,1,0.58333,0.1911,1,0,0,0,1,3,0,0,0,3
636,skydrive.wns.windows.com,legit,3.65727,5,16,24,0,0.3125,0.15239,3,0,0,0,3,5,0,0,0,5
8503,pqptmriooh.com,dga,3.18201,4,9,14,1,0.44444,0.22729,1,0,0,0,1,1,0,0,0,1
8205,eacnzjqda.dyndns.org,dga,3.64644,4,14,20,1,0.28571,0.18232,3,1,0,0,4,6,4,4,3,17
346,dns.msftncsi.com,legit,3.20282,2,12,16,0,0.16667,0.20018,3,1,0,0,4,3,1,0,0,4
936,mask-h2.icloud.com,legit,3.72548,5,9,18,0,0.55556,0.20697,4,3,2,1,10,3,0,0,0,3
3230,dellsupportcenter.com,legit,3.59447,6,14,21,0,0.42857,0.17117,6,1,0,0,7,8,2,0,0,10
2350,privacyportal.onetrust.com,legit,3.84411,8,16,26,0,0.5,0.14785,5,0,0,0,5,8,1,0,0,9
2727,t.wayfair.com,legit,3.39275,4,7,13,0,0.57143,0.26098,0,0,0,0,0,0,0,0,0,0
1119,push.services.mozilla.com,legit,3.78347,8,14,25,0,0.57143,0.15134,8,2,1,1,12,6,2,1,0,9
9674,utcyerveoyrm.us,dga,3.37356,5,9,15,1,0.55556,0.2249,1,0,0,0,1,2,1,0,0,3
687,pixel.adsafeprotected.com,legit,3.76386,9,14,25,0,0.64286,0.15055,8,1,0,0,9,4,1,0,0,5
7538,heavyindeed.net,dga,3.10689,6,8,15,1,0.75,0.20713,3,0,0,0,3,5,0,0,0,5
6470,fasuurokow.ddns.net,dga,3.61635,6,11,19,1,0.54545,0.19033,3,1,0,0,4,6,3,3,2,14
9327,k45v1bm0qv54cb36e6sr1fy.ddns.net,dga,4.3125,2,18,32,1,0.11111,0.13477,2,1,0,0,3,4,3,2,2,11
7927,evdxwh.tw,dga,2.9477,1,7,9,1,0.14286,0.32752,0,0,0,0,0,0,0,0,0,0
1577,sstats.adobe.com,legit,3.20282,5,9,16,0,0.55556,0.20018,6,0,0,0,6,4,0,0,0,4
5943,aooalkdofdkeofbc.eu,dga,3.30056,9,9,19,1,1.0,0.17371,2,0,0,0,2,0,0,0,0,0
4272,tagger.opecloud.com,legit,3.57662,7,10,19,0,0.7,0.18824,5,3,2,1,11,4,0,0,0,4
9554,rqucswhnjyfmybbcuvaix.ki,dga,4.1683,5,18,24,1,0.27778,0.17368,0,0,0,0,0,0,0,0,0,0
9488,aeymkeoioagsqccs.org,dga,3.58418,8,11,20,1,0.72727,0.17921,0,0,0,0,0,0,0,0,0,0
261,safebrowsing.google.com,legit,3.70813,8,13,23,0,0.61538,0.16122,4,5,4,3,16,3,1,0,0,4
2137,sync.ad.cpe.dotomi.com,legit,3.48171,6,12,22,0,0.5,0.15826,7,0,0,0,7,3,1,0,0,4
2749,mail.g03.yahoodns.net,legit,3.88018,6,10,21,0,0.6,0.18477,3,1,0,1,5,3,1,0,0,4
4463,www.samsung.com,legit,3.1899,3,10,15,0,0.3,0.21266,1,0,0,0,1,2,0,0,0,2
4842,api-js.datadome.co,legit,3.57243,7,8,18,0,0.875,0.19847,7,1,0,0,8,4,0,0,0,4
6979,sufgik.net,dga,3.32193,3,6,10,1,0.5,0.33219,0,0,0,0,0,1,0,0,0,1
6052,oqezeujtb18axk67nun60b18o51a27h24a37cvlr.biz,dga,4.66353,10,17,44,1,0.58824,0.10599,0,0,0,0,0,0,0,0,0,0
4548,dvgtm.akadns.net,legit,3.375,3,11,16,0,0.27273,0.21094,3,3,4,4,14,2,1,0,0,3
9647,ududemgebrzpbqtug.com,dga,3.6897,6,14,21,1,0.42857,0.1757,1,0,0,0,1,3,0,0,0,3
2692,pandora.com,legit,3.0958,4,6,11,0,0.66667,0.28144,1,0,0,0,1,4,1,0,0,5
319,mask.icloud.com,legit,3.37356,5,8,15,0,0.625,0.2249,4,3,2,1,10,3,0,0,0,3
6187,disixos.info,dga,2.85539,5,6,12,1,0.83333,0.23795,0,0,0,0,0,2,0,0,0,2
3224,pull-f5-va01.ttlivecdn.com.c.worldfcdn.com,legit,4.13686,7,25,42,0,0.28,0.0985,6,5,5,2,18,6,2,1,0,9
6597,brpbzxgi.com,dga,3.4183,2,9,12,1,0.22222,0.28486,0,0,0,0,0,0,0,0,0,0
8459,ctkqegubiswvteyvtk.com,dga,3.87966,5,16,22,1,0.3125,0.17635,1,0,0,0,1,2,0,0,0,2
1516,gsp10-ssl.ls.apple.com,legit,3.4474,3,13,22,0,0.23077,0.1567,6,4,3,2,15,1,0,0,0,1
2374,worldaz.tr.teams.microsoft.com,legit,3.69807,8,18,30,0,0.44444,0.12327,11,8,7,6,32,6,0,0,0,6
5636,tccstidedtrkctxi.com,dga,3.32193,4,15,20,1,0.26667,0.1661,3,0,0,0,3,4,0,0,0,4
4300,insops.net,legit,2.92193,3,6,10,0,0.5,0.29219,1,0,0,0,1,2,0,0,0,2
5962,mfovexsawitgdwafwtzh.com,dga,3.97018,6,17,24,1,0.35294,0.16542,0,0,0,0,0,2,1,0,0,3
9041,hphvnqpsssrm.com,dga,3.32782,1,14,16,1,0.07143,0.20799,0,0,0,0,0,0,0,0,0,0
1491,gtq.sct.sc-prod.net,legit,3.53689,2,13,19,0,0.15385,0.18615,2,2,1,0,5,0,1,0,0,1
2200,vidazoo.com,legit,3.02717,5,5,11,0,1.0,0.2752,1,0,0,0,1,0,0,0,0,0
9979,mdoqihhgij.com,dga,3.23593,4,9,14,1,0.44444,0.23114,0,0,0,0,0,0,0,0,0,0
5973,ocesgcqoumygiyge.org,dga,3.38418,7,12,20,1,0.58333,0.16921,4,0,0,0,4,3,0,0,0,3
2339,sequoia.cdn-apple.com,legit,3.82089,8,10,21,0,0.8,0.18195,8,4,2,1,15,3,0,0,0,3
2877,ng.msg.teams-msgapi.trafficmanager.net,legit,3.65242,10,23,38,0,0.43478,0.09612,12,4,2,3,21,9,1,0,0,10
3677,edgecastcdn.net,legit,3.05656,4,10,15,0,0.4,0.20377,5,4,1,0,10,7,0,0,0,7
7839,oxixwjjuccvn.space,dga,3.68354,5,12,18,1,0.41667,0.20464,0,0,0,0,0,0,0,0,0,0
8383,xkdjicftgojvqr.com,dga,3.83659,3,14,18,1,0.21429,0.21314,1,0,0,0,1,1,0,0,0,1
940,cdn.branch.io,legit,3.2389,3,8,13,0,0.375,0.24915,3,2,1,0,6,3,0,0,0,3
2325,data.mail.yahoo.com,legit,3.2211,8,8,19,0,1.0,0.16953,5,0,0,1,6,3,0,0,0,3
7306,collegefortieth.net,dga,3.36609,7,11,19,1,0.63636,0.17716,4,0,0,0,4,6,0,0,0,6
3521,ads.stickyadstv.com.akadns.net,legit,3.5899,7,19,30,0,0.36842,0.11966,10,6,7,7,30,7,3,1,0,11
4384,quantcast.mgr.consensu.org,legit,3.61334,7,16,26,0,0.4375,0.13897,8,3,0,0,11,10,3,0,0,13
5401,gmmciakuqiwiuygk.org,dga,3.54644,7,12,20,1,0.58333,0.17732,0,0,0,0,0,0,0,0,0,0
6784,relating-identify.yt,dga,3.54644,6,12,20,1,0.5,0.17732,6,1,0,0,7,8,3,0,0,11
3722,aibixby.com,legit,3.0958,4,6,11,0,0.66667,0.28144,0,0,0,0,0,0,0,0,0,0
1259,gravatar.com,legit,3.02206,4,7,12,0,0.57143,0.25184,3,0,0,0,3,4,0,0,0,4
5804,sqxe3hcqlxrrzpmh5q.cn,dga,3.78494,1,17,21,1,0.05882,0.18024,0,0,0,0,0,0,0,0,0,0
5929,sickfell.net,dga,3.25163,3,8,12,1,0.375,0.27097,1,0,0,0,1,3,0,0,0,3
4374,e9659.dspg.akamaiedge.net,legit,3.70347,8,10,25,0,0.8,0.14814,7,5,5,3,20,5,0,0,0,5
683,webex.com,legit,2.9477,3,5,9,0,0.6,0.32752,0,0,0,0,0,1,1,0,0,2
5550,mtp22mzmznzf12kzivhwo11lvizo31f42drmu.org,dga,4.17793,6,24,41,1,0.25,0.1019,0,0,0,0,0,0,0,0,0,0
5749,ceomcemyiycuowoi.org,dga,3.28418,9,10,20,1,0.9,0.16421,1,0,0,0,1,3,0,0,0,3
7881,secure-disorder.mx,dga,3.41938,6,10,18,1,0.6,0.18997,3,0,0,0,3,7,0,0,0,7
6388,7a5wzkyrs356qe38t7.com,dga,4.1867,3,10,22,1,0.3,0.1903,0,0,0,0,0,0,0,0,0,0
9725,tonelikelihood.com,dga,3.39215,8,9,18,1,0.88889,0.18845,3,0,0,0,3,3,1,0,0,4
5599,trustvoiceattractpressdog.com,dga,3.66387,9,19,29,1,0.47368,0.12634,10,1,0,0,11,9,3,0,0,12
1883,ny1-bid.adsrvr.org,legit,3.68354,3,11,18,0,0.27273,0.20464,4,0,0,0,4,0,0,0,0,0
8919,p32c29gxe21o31b28kxmxcsd30axernsi45axdy.net,dga,4.47,7,21,43,1,0.33333,0.10395,1,0,0,0,1,3,0,0,0,3
3546,gsp-ssl-commute.ls.apple.com,legit,3.55666,6,17,28,0,0.35294,0.12702,9,5,3,2,19,4,1,0,0,5
980,pull-cmaf-f16-va01.tiktokcdn.com,legit,4.14032,6,17,32,0,0.35294,0.12938,5,6,9,9,29,3,0,0,0,3
6280,voyuer-proper.tj,dga,3.32782,5,9,16,1,0.55556,0.20799,3,1,0,0,4,1,1,0,0,2
5999,oyfsakmtdctkujop.eu,dga,3.82687,6,12,19,1,0.5,0.20141,0,0,0,0,0,0,0,0,0,0
4686,wcpstatic.microsoft.com,legit,3.41444,6,15,23,0,0.4,0.14845,10,8,7,6,31,6,1,0,0,7
4278,sls.prod.dcat.dsp.trafficmanager.net,legit,3.81911,8,23,36,0,0.34783,0.10609,14,7,4,5,30,9,2,0,0,11
3169,fresnel.vimeocdn.com,legit,3.58418,6,12,20,0,0.5,0.17921,4,1,0,0,5,5,1,0,0,6
6555,yoika8ycqk20.org,dga,3.625,4,8,16,1,0.5,0.22656,0,0,0,0,0,0,0,0,0,0
5443,ljtcdagpnjiblbdq.eu,dga,3.82687,4,14,19,1,0.28571,0.20141,1,0,0,0,1,0,0,0,0,0
7059,ciqcsusommssiiaq.org,dga,3.28418,7,12,20,1,0.58333,0.16421,1,0,0,0,1,3,0,0,0,3
3702,outbrain-d.openx.net,legit,3.68418,7,10,20,0,0.7,0.18421,5,0,0,0,5,3,0,0,0,3
8073,nhmjugkkbrtcklo.com,dga,3.68188,3,15,19,1,0.2,0.19378,1,0,0,0,1,0,0,0,0,0
7537,sirivyw.info,dga,3.18872,4,7,12,1,0.57143,0.26573,0,0,0,0,0,2,0,0,0,2
4810,api.scheduler.teams.microsoft.com,legit,3.83911,11,18,33,0,0.61111,0.11634,16,9,8,6,39,8,0,0,0,8
8467,gunyb38jsf12osh14e51nxk47d20l28oqk27ayl48.org,dga,4.58031,6,20,45,1,0.3,0.10178,0,0,0,0,0,0,0,0,0,0
6554,mivlutqig.cc,dga,3.25163,3,8,12,1,0.375,0.27097,1,0,0,0,1,1,0,0,0,1
262,checkappexec.microsoft.com,legit,3.65739,8,16,26,0,0.5,0.14067,8,9,7,6,30,3,0,0,0,3
6321,xkjtcdxrxpsyqfduitl.de,dga,3.93626,3,18,22,1,0.16667,0.17892,1,0,0,0,1,1,0,0,0,1
4348,asimov.events.data.trafficmanager.net,legit,3.68879,13,20,37,0,0.65,0.0997,12,4,1,3,20,13,2,0,0,15
3037,vop.sundaysky.com,legit,3.61687,4,11,17,0,0.36364,0.21276,1,0,0,0,1,2,0,0,0,2
2879,sploit-edge.smartscreen.microsoft.com,legit,3.8642,11,22,37,0,0.5,0.10444,14,10,8,6,38,9,0,0,0,9
7396,qgfusnogtq.com,dga,3.37878,3,10,14,1,0.3,0.24134,1,0,0,0,1,0,0,0,0,0
6285,wxavyykjltbocvlj.eu,dga,3.82687,4,14,19,1,0.28571,0.20141,0,0,0,0,0,0,0,0,0,0
1083,p16-sign-va.tiktokcdn.com,legit,4.00386,5,14,25,0,0.35714,0.16015,4,6,7,6,23,3,0,0,0,3
6271,ryqeyb.dyndns.org,dga,3.33718,2,13,17,1,0.15385,0.1963,2,1,0,0,3,4,3,4,3,14
3035,sync.sharethis.com,legit,3.57243,4,12,18,0,0.33333,0.19847,1,0,0,0,1,4,0,0,0,4
2061,bolt.dropbox.com,legit,3.25,4,10,16,0,0.4,0.20312,2,0,0,0,2,1,0,0,0,1
9483,releasesengineering.am,dga,3.08377,10,11,22,1,0.90909,0.14017,8,0,0,0,8,12,4,0,0,16
5465,bjajoxvalbfx.com,dga,3.375,4,11,16,1,0.36364,0.21094,0,0,0,0,0,0,0,0,0,0
7082,wanathug.ru,dga,3.0958,4,6,11,1,0.66667,0.28144,1,0,0,0,1,2,0,0,0,2
3764,agent-cluster3.prod.us001-prod.arcticwolf.net,legit,4.24153,11,24,45,0,0.45833,0.09426,13,6,3,2,24,8,3,0,0,11
8326,1xq0e8wrsh7f5ba.ddns.net,dga,4.1683,3,14,24,1,0.21429,0.17368,2,1,0,0,3,4,4,3,2,13
8301,dogageinvitediscussavoid.com,dga,3.65505,12,15,28,1,0.8,0.13054,5,1,0,0,6,6,0,0,0,6
8752,pbhigjihybblwaagrh.ac,dga,3.52257,5,15,21,1,0.33333,0.16774,0,0,0,0,0,0,0,0,0,0
5967,wgswuptqsgqdygig.us,dga,3.26083,3,15,19,1,0.2,0.17162,0,0,0,0,0,0,0,0,0,0
6864,nafkokxe.ru,dga,3.27761,4,6,11,1,0.66667,0.29796,0,0,0,0,0,0,0,0,0,0
3183,arc.trafficmanager.net,legit,3.33421,7,13,22,0,0.53846,0.15156,6,3,1,3,13,7,1,0,0,8
7723,idurgafdic.com,dga,3.37878,5,8,14,1,0.625,0.24134,1,0,0,0,1,1,0,0,0,1
2366,array502.prod.do.dsp.mp.microsoft.com,legit,3.71259,8,20,37,0,0.4,0.10034,12,12,10,9,43,5,2,0,0,7
9571,soammqommwaggigc.org,dga,3.18418,6,13,20,1,0.46154,0.15921,1,0,0,0,1,2,0,0,0,2
8250,yudmmdq.net,dga,3.0958,2,8,11,1,0.25,0.28144,0,0,0,0,0,0,0,0,0,0
4753,sdk.iad-05.braze.com,legit,3.88418,5,9,20,0,0.55556,0.19421,2,0,0,0,2,1,0,0,0,1
7604,eqtcsgfqbex.org,dga,3.50689,3,11,15,1,0.27273,0.23379,0,0,0,0,0,1,3,2,1,7
9539,bamuxuni.ru,dga,3.02717,5,5,11,1,1.0,0.2752,1,0,0,0,1,2,0,0,0,2
3161,whiteboard.microsoft.com,legit,3.75163,8,14,24,0,0.57143,0.15632,8,8,7,6,29,5,0,0,0,5
496,sectigo.com,legit,3.0958,4,6,11,0,0.66667,0.28144,2,0,0,0,2,3,0,0,0,3
2953,sq-tungsten-ts.amazon-adsystem.com,legit,3.77484,8,21,34,0,0.38095,0.11102,10,1,3,3,17,7,0,0,0,7
3972,bid.contextweb.com,legit,3.50326,5,11,18,0,0.45455,0.19463,6,2,0,0,8,3,2,0,0,5
3984,players.brightcove.net,legit,3.97057,6,14,22,0,0.42857,0.18048,4,0,0,0,4,5,2,0,0,7
76,optimizationguide-pa.googleapis.com,legit,3.82974,16,16,35,0,1.0,0.10942,9,6,4,4,23,8,3,2,1,14
8389,1fcdkbmderm01jivuh3t3pi.ddns.net,dga,4.25,5,20,32,1,0.25,0.13281,5,1,0,0,6,6,4,3,2,15
212,noam.cc.skype.com,legit,3.29277,4,10,17,0,0.4,0.19369,2,0,0,0,2,1,0,0,0,1
9743,swsjidcbimtw.pw,dga,3.32323,2,12,15,1,0.16667,0.22155,0,0,0,0,0,0,0,0,0,0
8187,gaculsutu.com,dga,3.18083,5,7,13,1,0.71429,0.24468,0,0,0,0,0,2,0,0,0,2
2571,ids.ad.gt,legit,2.72548,2,5,9,0,0.4,0.30283,4,0,0,0,4,0,0,0,0,0
241,whatsapp.net,legit,3.08496,3,8,12,0,0.375,0.25708,3,1,0,0,4,1,0,0,0,1
4164,get.s-onetag.com,legit,3.375,5,8,16,0,0.625,0.21094,3,0,0,0,3,5,1,0,0,6
4828,internal.query.g03.yahoodns.net,legit,3.9621,9,16,31,0,0.5625,0.12781,6,1,0,1,8,5,2,1,0,8
7093,ajihambrsk.com,dga,3.52164,4,9,14,1,0.44444,0.25155,1,0,0,0,1,1,0,0,0,1
9180,kqnxfleceqxcjtusb.de,dga,3.78418,4,15,20,1,0.26667,0.18921,3,0,0,0,3,3,0,0,0,3
7968,tpclgqknovyxucqye.com,dga,3.88018,4,16,21,1,0.25,0.18477,0,0,0,0,0,0,0,0,0,0
8041,weduekwaqeaxh.ddns.net,dga,3.51603,7,13,22,1,0.53846,0.15982,4,1,0,0,5,6,3,2,2,13
9223,yhewyyrttmxjldxq.com,dga,3.78418,2,17,20,1,0.11765,0.18921,0,0,0,0,0,0,0,0,0,0
265,gateway.facebook.com,legit,3.54644,8,10,20,0,0.8,0.17732,4,0,0,0,4,4,1,0,0,5
4966,bag-smoot.v.aaplimg.com,legit,3.60967,7,12,23,0,0.58333,0.15694,5,0,0,0,5,0,0,0,0,0
3713,fmipalservice.fe.apple-dns.net,legit,3.80291,9,17,30,0,0.52941,0.12676,12,7,4,3,26,8,3,1,0,12
5869,oukcwadwdxuq.org,dga,3.5,5,10,16,1,0.5,0.21875,2,0,0,0,2,0,0,0,0,0
9865,cgopsihakbka.jp,dga,3.50689,4,10,15,1,0.4,0.23379,0,0,0,0,0,1,0,0,0,1
9175,idrhuvdtqf.com,dga,3.6645,3,10,14,1,0.3,0.26175,0,0,0,0,0,0,0,0,0,0
2382,a2047.mm2.akamai.net,legit,3.34644,6,6,20,0,1.0,0.16732,4,3,4,3,14,2,0,0,0,2
604,pinimg.com,legit,2.92193,3,6,10,0,0.5,0.29219,2,0,0,0,2,2,0,0,0,2
3976,ad.intl.xiaomi.com,legit,3.30827,7,8,18,0,0.875,0.18379,5,0,0,0,5,3,0,0,0,3
8076,vowuku.info,dga,3.0958,5,5,11,1,1.0,0.28144,0,0,0,0,0,0,0,0,0,0
3317,downloads.dell.com,legit,3.26633,5,11,18,0,0.45455,0.18146,5,0,0,0,5,3,0,0,0,3
2372,pus6-collabhubrtc.officeapps.live.com,legit,4.10082,11,21,37,0,0.52381,0.11083,10,5,4,3,22,6,0,0,0,6
4174,foresee.com,legit,2.84535,5,5,11,0,1.0,0.25867,3,0,0,0,3,4,1,0,0,5
9144,ouamkhyaqxndtsr.com,dga,3.93214,5,13,19,1,0.38462,0.20695,2,0,0,0,2,2,0,0,0,2
6064,ectjbpjkzj.com,dga,3.32486,2,11,14,1,0.18182,0.23749,0,0,0,0,0,1,0,0,0,1
3145,office.akadns.net,legit,3.49923,6,9,17,0,0.66667,0.20584,7,7,7,5,26,4,1,0,0,5
5189,vocabic.info,dga,3.08496,5,6,12,1,0.83333,0.25708,1,0,0,0,1,2,0,0,0,2
3388,webexcontent.com,legit,3.20282,5,10,16,0,0.5,0.20018,5,2,0,0,7,5,3,0,0,8
4116,net.b-0016.b-msedge.net,legit,3.53422,4,10,23,0,0.4,0.15366,3,2,1,0,6,5,0,0,0,5
4231,cdn.smoot.apple.com,legit,3.43162,5,11,19,0,0.45455,0.18061,8,6,4,2,20,2,0,0,0,2
6773,ahudeninuwevl.ddns.net,dga,3.48171,7,13,22,1,0.53846,0.15826,4,1,0,0,5,8,3,2,1,14
8668,ixwtgncvo8qlmlo0w41.ddns.net,dga,4.20897,4,18,28,1,0.22222,0.15032,3,1,0,0,4,4,3,2,1,10
6603,jbqdjttkzwvhtncsymw.com,dga,3.969,1,21,23,1,0.04762,0.17257,0,0,0,0,0,0,0,0,0,0
5130,bcclodcdnbcfbcfb.online,dga,3.11641,4,18,23,1,0.22222,0.1355,3,2,0,0,5,1,0,0,0,1
9420,venialiumpredicatorum.com,dga,3.78347,11,13,25,1,0.84615,0.15134,7,0,0,0,7,9,0,0,0,9
6843,ijiymbelulgw.ru,dga,3.50689,5,9,15,1,0.55556,0.23379,0,0,0,0,0,2,0,0,0,2
5282,pumywop.info,dga,3.25163,4,7,12,1,0.57143,0.27097,0,0,0,0,0,0,0,0,0,0
248,azureedge.net,legit,3.08506,6,6,13,0,1.0,0.23731,3,2,1,1,7,3,0,0,0,3
5284,bjdp3ovffvn4ne4ds7.ru,dga,3.91613,3,13,21,1,0.23077,0.18648,1,0,0,0,1,1,0,0,0,1
1370,c.appier.net,legit,3.08496,4,6,12,0,0.66667,0.25708,5,2,1,0,8,1,0,0,0,1
9034,dietdotliftsearchwellpriest.com,dga,3.80872,10,20,31,1,0.5,0.12286,6,0,0,0,6,8,1,0,0,9
2890,onedscolprdcus11.centralus.cloudapp.azure.com,legit,3.87199,14,25,45,0,0.56,0.08604,19,5,3,4,31,8,3,0,0,11
2961,onedscolprdcus03.centralus.cloudapp.azure.com,legit,3.91643,14,25,45,0,0.56,0.08703,19,5,3,4,31,8,3,0,0,11
1153,eu-mobile.events.data.microsoft.com,legit,3.94329,13,17,35,0,0.76471,0.11267,14,9,7,6,36,8,1,0,0,9
5302,edxckiqy.com.bo,dga,3.50689,4,9,15,1,0.44444,0.23379,3,2,1,0,6,3,2,1,0,6
8056,qeboheq.info,dga,3.08496,5,6,12,1,0.83333,0.25708,0,0,0,0,0,0,0,0,0,0
7259,fxvhqtglra.de,dga,3.70044,2,10,13,1,0.2,0.28465,1,0,0,0,1,1,0,0,0,1
317,safeframe.googlesyndication.com,legit,3.87324,12,17,31,0,0.70588,0.12494,10,5,4,3,22,10,3,2,1,16
4793,huntress.io,legit,3.27761,4,6,11,0,0.66667,0.29796,3,0,0,0,3,2,2,0,0,4
3802,e2.akamaiedge.net,legit,3.21953,8,6,17,0,1.33333,0.18938,5,5,5,3,18,4,0,0,0,4
3104,cr.adobe.com,legit,3.08496,4,6,12,0,0.66667,0.25708,3,0,0,0,3,1,0,0,0,1
2502,oath.cloud,legit,3.12193,4,5,10,0,0.8,0.31219,1,0,0,0,1,1,0,0,0,1
4950,bfp.global.dual.dotomi.weighted.com.akadns.net,legit,4.04712,14,25,46,0,0.56,0.08798,12,6,7,7,32,8,3,1,0,12
6056,bojicum.info,dga,3.25163,5,6,12,1,0.83333,0.27097,1,0,0,0,1,1,0,0,0,1
4341,pixel-origin.mathtag.com,legit,3.88684,8,13,24,0,0.61538,0.16195,6,0,0,0,6,7,0,0,0,7
1660,log16-applog-useast5.us.tiktokv.com,legit,4.09315,10,17,35,0,0.58824,0.11695,11,8,5,3,27,5,0,0,0,5
3510,www.baidu.com,legit,3.18083,4,7,13,0,0.57143,0.24468,0,0,0,0,0,0,0,0,0,0
8300,ufcedeihqod.ddns.net,dga,3.48418,6,12,20,1,0.5,0.17421,5,2,0,0,7,7,3,2,1,13
916,cf-st.sc-cdn.net,legit,3.07782,1,11,16,0,0.09091,0.19236,3,1,0,0,4,2,0,0,0,2
809,gsa.apple.com,legit,3.2389,4,7,13,0,0.57143,0.24915,5,4,3,2,14,1,0,0,0,1
9749,fqdaylscthgegyguhynrtkx.biz,dga,4.25453,4,22,27,1,0.18182,0.15758,1,0,0,0,1,1,0,0,0,1
8820,ansnito4kpk6ojircr3.ddns.net,dga,3.95021,6,17,28,1,0.35294,0.14108,3,1,0,0,4,7,4,3,2,16
640,r.manage.microsoft.com,legit,3.53831,7,12,22,0,0.58333,0.16083,9,9,7,8,33,5,0,0,0,5
8998,gmymvvokmsoeokfha.su,dga,3.54644,6,13,20,1,0.46154,0.17732,0,0,0,0,0,0,0,0,0,0
1977,dscb.akamai.net,legit,3.45656,5,8,15,0,0.625,0.23044,4,3,4,3,14,2,0,0,0,2
6669,permanentpees.com,dga,3.26393,6,10,17,1,0.6,0.192,5,1,0,0,6,6,1,0,0,7
6099,tokdixwlhknq.com,dga,3.75,3,12,16,1,0.25,0.23438,0,1,0,0,1,0,0,0,0,0
3769,cms.msn.com,legit,2.48171,1,8,11,0,0.125,0.22561,2,0,0,0,2,0,0,0,0,0
2236,37-courier.push.apple.com,legit,3.86347,8,11,25,0,0.72727,0.15454,9,4,3,2,18,4,0,0,0,4
8141,xingrocaystpuvxs.eu,dga,3.93214,6,12,19,1,0.5,0.20695,3,0,0,0,3,3,1,0,0,4
473,configuration.apple.com,legit,3.79509,9,12,23,0,0.75,0.165,10,5,3,2,20,6,4,2,1,13
1844,rpt.cedexis.com,legit,3.50689,4,9,15,0,0.44444,0.23379,3,0,0,0,3,4,0,0,0,4
3072,securedvisit.com,legit,3.5,6,9,16,0,0.66667,0.21875,3,0,0,0,3,7,0,0,0,7
8217,uymjph6jiwyjy66fne.net,dga,3.62922,4,14,22,1,0.28571,0.16496,0,0,0,0,0,1,0,0,0,1
1934,rupload.facebook.com,legit,3.62193,8,10,20,0,0.8,0.1811,6,0,0,0,6,2,0,0,0,2
1105,mozilla.net,legit,3.27761,4,6,11,0,0.66667,0.29796,0,0,0,0,0,1,0,0,0,1
3103,pulltiktokf10.ovc.gslb.rocket-cdn.com,legit,4.17527,7,23,37,0,0.30435,0.11285,4,5,4,2,15,3,0,0,0,3
6921,streaming-generation.sh,dga,3.58835,8,13,23,1,0.61538,0.15602,13,0,0,0,13,14,4,2,1,21
8741,sdpeyqrxhghcivy.biz,dga,3.93214,3,15,19,1,0.2,0.20695,0,0,0,0,0,0,0,0,0,0
2847,itunes.apple.com.edgekey.net,legit,3.75343,10,14,28,0,0.71429,0.13405,12,9,6,4,31,8,2,1,0,11
3303,t.pubmatic.com,legit,3.23593,4,8,14,0,0.5,0.23114,4,0,0,0,4,4,1,0,0,5
5312,etsoouw.vn,dga,3.12193,4,5,10,1,0.8,0.31219,2,0,0,0,2,1,0,0,0,1
5988,mplziiluogikfm.com,dga,3.41938,6,11,18,1,0.54545,0.18997,1,0,0,0,1,0,0,0,0,0
232,l.google.com,legit,2.68872,4,6,12,0,0.66667,0.22406,2,5,4,3,14,1,0,0,0,1
8116,iyhrrgggojvw.ru,dga,3.27291,3,11,15,1,0.27273,0.21819,0,0,0,0,0,0,0,0,0,0
4671,enrichment.osi.office.net,legit,3.43327,9,13,25,0,0.69231,0.13733,5,5,4,3,17,5,1,0,0,6
277,us-api.asm.skype.com,legit,3.54644,6,10,20,0,0.6,0.17732,4,1,1,0,6,1,0,0,0,1
6286,dawlcznaits.tv,dga,3.52164,3,10,14,1,0.3,0.25155,0,0,0,0,0,1,0,0,0,1
950,x2.c.lencr.org,legit,3.18201,2,8,14,0,0.25,0.22729,4,0,0,0,4,2,0,0,0,2
9039,rkerdjmlyfrirwoljvwf.com,dga,3.75163,4,19,24,1,0.21053,0.15632,1,0,0,0,1,2,0,0,0,2
8113,mrbujmlxvlqdyuolq.su,dga,3.64644,4,15,20,1,0.26667,0.18232,0,0,0,0,0,0,0,0,0,0
6397,ewbbrvdnuklqcbxro.pw,dga,3.88418,3,16,20,1,0.1875,0.19421,2,0,0,0,2,1,0,0,0,1
5285,dimynoho.info,dga,3.02699,5,7,13,1,0.71429,0.23285,0,0,0,0,0,0,0,0,0,0
2178,pull-flv-l16-sg01.tiktokcdn.com.atomile.com,legit,4.20233,9,23,43,0,0.3913,0.09773,10,10,13,11,44,7,2,1,0,10
3766,upp.itunes.apple.com,legit,3.48418,7,10,20,0,0.7,0.17421,8,4,3,2,17,4,0,0,0,4
594,wns.windows.com,legit,3.05656,3,10,15,0,0.3,0.20377,2,0,0,0,2,3,0,0,0,3
7819,ewu8iwycq8us.net,dga,3.5,5,8,16,1,0.625,0.21875,1,0,0,0,1,0,0,0,0,0
2389,jwplayer.com,legit,3.58496,3,8,12,0,0.375,0.29875,2,0,0,0,2,2,0,0,0,2
9003,kabdriygwr.com,dga,3.6645,3,10,14,1,0.3,0.26175,0,0,0,0,0,1,0,0,0,1
7974,flierfriend.net,dga,3.05656,5,9,15,1,0.55556,0.20377,3,0,0,0,3,4,0,0,0,4
9124,variousbridge.net,dga,3.73452,7,9,17,1,0.77778,0.21968,3,1,0,0,4,3,0,0,0,3
5714,pub68h54j46k37era67pscxm29ltn30bzhwl18cq.com,dga,4.83421,4,23,44,1,0.17391,0.10987,2,0,0,0,2,2,0,0,0,2
6449,waouxwtlrishv.org,dga,3.73452,5,11,17,1,0.45455,0.21968,1,0,0,0,1,2,1,0,0,3
6782,verremissionishasreser.com,dga,3.3018,10,15,26,1,0.66667,0.12699,6,1,0,0,7,12,4,0,0,16
163,iphone-ld.apple.com,legit,3.57662,6,10,19,0,0.6,0.18824,7,4,3,2,16,3,1,0,0,4
4184,probe-edge.v.aaplimg.com,legit,3.77206,8,12,24,0,0.66667,0.15717,9,3,1,0,13,3,1,0,0,4
2941,pull-f5-va01.fcdn.us.tiktokv.com.c.worldfcdn2.com,legit,4.23663,8,28,49,0,0.28571,0.08646,8,10,9,5,32,5,2,1,0,8
9316,8uc2c6ky8aw2.net,dga,3.625,3,7,16,1,0.42857,0.22656,0,0,0,0,0,0,0,0,0,0
3991,appsync-api.us-east-1.amazonaws.com,legit,3.82144,11,17,35,0,0.64706,0.10918,10,4,4,3,21,6,0,0,0,6
1926,crazyegg.com,legit,3.25163,3,8,12,0,0.375,0.27097,2,0,0,0,2,1,0,0,0,1
509,prod.bidr.io,legit,2.75163,4,6,12,0,0.66667,0.2293,3,3,2,1,9,0,1,0,0,1
4922,www.tm.prd.ags.akadns.net,legit,3.47908,4,16,25,0,0.25,0.13916,7,4,4,3,18,2,1,0,0,3
2131,a1371.z.akamai.net,legit,3.35021,6,5,18,0,1.2,0.18612,3,3,4,3,13,2,0,0,0,2
7112,vensuaveniepapepos.com,dga,3.42512,10,11,22,1,0.90909,0.15569,2,0,0,0,2,5,0,0,0,5
93,adservice.google.com,legit,3.54644,8,10,20,0,0.8,0.17732,9,7,5,4,25,5,2,1,0,8
2515,array602.prod.do.dsp.mp.microsoft.com,legit,3.71259,8,20,37,0,0.4,0.10034,12,12,10,9,43,5,2,0,0,7
2784,cdx.cedexis.net,legit,3.05656,4,9,15,0,0.44444,0.20377,4,0,0,0,4,4,0,0,0,4
5595,fpiivkagoyyqtc.biz,dga,3.79465,5,12,18,1,0.41667,0.21081,1,0,0,0,1,0,0,0,0,0
5971,miwebuqo.ru,dga,3.27761,5,5,11,1,1.0,0.29796,1,0,0,0,1,1,0,0,0,1
4072,data.cdnbasket.net,legit,3.19716,5,11,18,0,0.45455,0.17762,5,1,0,0,6,5,0,0,0,5
4880,public.wamsm-a-1.prod.infra.webex.com,legit,4.15217,10,19,37,0,0.52632,0.11222,8,4,3,2,17,5,2,0,0,7
739,g.akamaiedge.net,legit,3.15564,7,7,16,0,1.0,0.19723,5,5,5,3,18,4,0,0,0,4
8593,rdnuphnmdxmgejfcxl.tj,dga,3.91613,2,18,21,1,0.11111,0.18648,2,0,0,0,2,2,0,0,0,2
4503,js.appboycdn.com,legit,3.5,3,11,16,0,0.27273,0.21875,6,3,1,0,10,1,0,0,0,1
8734,mdfdladncdbdadnf.com,dga,3.04644,3,16,20,1,0.1875,0.15232,3,0,0,0,3,2,0,0,0,2
1708,apple-finance.query.yahoo.com,legit,3.92627,11,14,29,0,0.78571,0.13539,9,3,2,2,16,5,2,1,0,8
7563,cqxxrvblvuhtkfeq.eu,dga,3.72161,4,14,19,1,0.28571,0.19587,0,0,0,0,0,0,0,0,0,0
3758,e5048.dsca.akamaiedge.net,legit,3.73366,9,9,25,0,1.0,0.14935,7,5,5,3,20,6,0,0,0,6
9035,w0chs07pwpg2mt1rs07.ddns.net,dga,3.96772,1,18,28,1,0.05556,0.1417,2,1,0,0,3,4,3,3,2,12
3062,ibytedtos.com,legit,3.39275,4,8,13,0,0.5,0.26098,2,0,0,0,2,2,0,0,0,2
6011,potprophetedebuissentest.com,dga,3.59756,10,17,28,1,0.58824,0.12848,9,2,0,0,11,9,3,0,0,12
963,namequery.com,legit,3.39275,5,7,13,0,0.71429,0.26098,2,0,0,0,2,2,0,0,0,2
6042,5hctglktidmtwtk0ghu.ddns.net,dga,3.86576,3,21,28,1,0.14286,0.13806,3,1,0,0,4,5,3,3,2,13
4545,appsync-realtime-api.us-east-1.amazonaws.com,legit,3.98964,15,21,44,0,0.71429,0.09067,12,4,4,3,23,8,0,0,0,8
7147,tyqz784tl6z1tj6r66.ru,dga,3.59447,1,11,21,1,0.09091,0.17117,0,0,0,0,0,0,0,0,0,0
9772,syndicationentire.it,dga,3.34644,8,11,20,1,0.72727,0.16732,7,1,0,0,8,9,5,2,1,17
6867,pqyqueudbjlcimqwn.net,dga,3.88018,5,15,21,1,0.33333,0.18477,0,0,0,0,0,0,0,0,0,0
6695,pwvrfmhqcfaqb.org,dga,3.73452,2,14,17,1,0.14286,0.21968,0,0,0,0,0,0,0,0,0,0
2828,cyberark.com,legit,3.25163,3,8,12,0,0.375,0.27097,2,0,0,0,2,4,0,0,0,4
1665,idpix.media6degrees.com,legit,3.58835,9,11,23,0,0.81818,0.15602,5,0,0,0,5,4,0,0,0,4
4466,ncc.avast.com,legit,3.02699,3,8,13,0,0.375,0.23285,2,1,0,0,3,2,0,0,0,2
5016,screencatchdishtellproposed.com,dga,3.7442,9,21,31,1,0.42857,0.12078,9,1,0,0,10,9,1,0,0,10
9988,xubonir.info,dga,3.08496,5,6,12,1,0.83333,0.25708,1,0,0,0,1,2,0,0,0,2
6732,puxhugko.ru,dga,3.02717,4,6,11,1,0.66667,0.2752,0,0,0,0,0,0,0,0,0,0
9384,mzk57jwg53cwdqbrazjsiul48dzlqk27muir.net,dga,4.60306,6,25,40,1,0.24,0.11508,1,0,0,0,1,2,0,0,0,2
635,hotjar.com,legit,3.12193,3,6,10,0,0.5,0.31219,0,0,0,0,0,1,0,0,0,1
5403,kjtagufqbex.org,dga,3.77356,4,10,15,1,0.4,0.25157,1,0,0,0,1,2,3,2,2,9
8114,kemilyx.info,dga,3.4183,4,7,12,1,0.57143,0.28486,1,0,0,0,1,2,0,0,0,2
732,image6.pubmatic.com,legit,3.57662,7,9,19,0,0.77778,0.18824,5,1,0,0,6,5,1,0,0,6
7426,yagowswkwqwauyom.org,dga,3.38418,6,13,20,1,0.46154,0.16921,0,0,0,0,0,1,0,0,0,1
6090,newsexerciseshapediscover.com,dga,3.67644,11,17,29,1,0.64706,0.12677,6,0,0,0,6,8,2,0,0,10
3098,moatads.com.edgekey.net,legit,3.53422,8,12,23,0,0.66667,0.15366,9,5,3,1,18,6,2,1,0,9
8772,negotiationcheckbornpossess.com,dga,3.73244,11,19,31,1,0.57895,0.1204,5,0,0,0,5,8,4,2,1,15
5200,irkigltncp.com,dga,3.52164,3,10,14,1,0.3,0.25155,0,0,0,0,0,0,0,0,0,0
9935,contactinfluenceaccountborrow.com,dga,3.59366,12,20,33,1,0.6,0.1089,11,1,0,0,12,10,2,1,0,13
9464,anaeeklakbcflfak.website,dga,3.47018,9,14,24,1,0.64286,0.14459,0,0,0,0,0,2,0,0,0,2
8653,efgaztklw.com,dga,3.70044,3,9,13,1,0.33333,0.28465,0,0,0,0,0,0,0,0,0,0
816,bttrack.com,legit,3.0958,2,8,11,0,0.25,0.28144,1,0,0,0,1,2,1,0,0,3
2151,tiktokcdn.com.c.bytetcdn.com,legit,3.36576,5,19,28,0,0.26316,0.12021,6,9,9,6,30,6,2,1,0,9
8594,dehrydylscjvvcxkklnsl.net,dga,3.81366,2,22,25,1,0.09091,0.15255,0,0,0,0,0,2,0,0,0,2
3981,www-linkedin-com.l-0005.l-msedge.net,legit,3.89841,7,18,36,0,0.38889,0.10829,6,4,2,0,12,6,1,0,0,7
5205,gnvdfwjkdlmorqjyt.tw,dga,3.92193,1,18,20,1,0.05556,0.1961,0,0,0,0,0,1,0,0,0,1
1638,recaptcha.net,legit,3.08506,4,8,13,0,0.5,0.23731,2,0,0,0,2,3,1,0,0,4
7877,wmpeevtsduadjt.com,dga,3.72548,5,12,18,1,0.41667,0.20697,1,0,0,0,1,0,0,0,0,0
5070,foqitoh.info,dga,2.85539,5,6,12,1,0.83333,0.23795,0,0,0,0,0,1,0,0,0,1
7955,cassandrakristina.net,dga,3.2728,7,13,21,1,0.53846,0.15585,4,0,0,0,4,10,4,0,0,14
4621,ios.prod.ftl.netflix.com,legit,3.72018,6,14,24,0,0.42857,0.15501,5,4,3,2,14,2,1,0,0,3
9202,marriagerequiremarchshow.com,dga,3.59756,11,16,28,1,0.6875,0.12848,4,1,0,0,5,7,1,0,0,8
9154,syxbldhhnodkfnjg.eu,dga,3.93214,3,15,19,1,0.2,0.20695,0,0,0,0,0,0,0,0,0,0
2904,pull-f5-gcp01.fcdn.us.tiktokv.com.c.worldfcdn2.com,legit,4.21534,7,30,50,0,0.23333,0.08431,8,10,9,5,32,5,2,1,0,8
9543,vpqdyvwwgopydgtv.eu,dga,3.47135,3,15,19,1,0.2,0.1827,0,0,0,0,0,0,0,0,0,0
4505,st3.zoom.us,legit,2.91398,3,5,11,0,0.6,0.26491,2,0,0,0,2,2,0,0,0,2
3458,goskope.com,legit,3.02717,4,6,11,0,0.66667,0.2752,0,0,0,0,0,0,0,0,0,0
4979,cdn.bitdefender.net,legit,3.11583,5,12,19,0,0.41667,0.16399,4,2,1,0,7,6,0,0,0,6
5268,owliluheukcuok.ddns.net,dga,3.70813,8,13,23,1,0.61538,0.16122,3,1,0,0,4,4,3,2,2,11
4169,content.uplynk.com,legit,3.46132,4,12,18,0,0.33333,0.1923,6,2,0,0,8,4,2,0,0,6
9311,pickcity.net,dga,3.08496,3,8,12,1,0.375,0.25708,2,0,0,0,2,2,0,0,0,2
6995,stylerequireoccasionbagpen.com,dga,3.9899,12,17,30,1,0.70588,0.133,6,0,0,0,6,9,2,0,0,11
1652,cp801.prod.do.dsp.mp.microsoft.com,legit,3.51734,6,19,34,0,0.31579,0.10345,11,12,10,9,42,3,2,0,0,5
6267,controldiscover.com,dga,3.47135,6,12,19,1,0.5,0.1827,5,1,0,0,6,5,3,0,1,9
5050,vmtgcxpydsriifbq.eu,dga,4.14266,4,14,19,1,0.28571,0.21803,1,0,0,0,1,1,0,0,0,1
243,me.gvt1.com,legit,3.0958,2,6,11,0,0.33333,0.28144,1,0,0,0,1,0,0,0,0,0
4914,contentsync.onenote.com,legit,2.96381,7,14,23,0,0.5,0.12886,5,2,0,0,7,5,3,0,0,8
5466,trading-interaction.yt,dga,3.48171,7,13,22,1,0.53846,0.15826,8,0,0,0,8,7,5,2,1,15
9738,nlhwrmnbicnlsdcr.eu,dga,3.68188,3,15,19,1,0.2,0.19378,2,0,0,0,2,1,0,0,0,1
3086,jsdelivr.map.fastly.net,legit,3.88205,5,15,23,0,0.33333,0.16878,6,1,0,0,7,5,0,0,0,5
5335,uqzdzbvwhripzjvkn.com,dga,4.07066,3,17,21,1,0.17647,0.19384,0,0,0,0,0,1,0,0,0,1
5829,teguajvkp.com,dga,3.70044,4,8,13,1,0.5,0.28465,1,0,0,0,1,1,0,0,0,1
2402,a.sportradarserving.com,legit,3.70813,7,14,23,0,0.5,0.16122,5,1,1,1,8,6,4,1,0,11
3215,lastpass.com,legit,3.02206,3,8,12,0,0.375,0.25184,1,1,0,0,2,3,1,0,0,4
9994,yuoratlgapbdpbn.com,dga,3.82687,5,13,19,1,0.38462,0.20141,3,0,0,0,3,3,0,0,0,3
9462,radiosurveyassociateasktake.com,dga,3.69228,14,16,31,1,0.875,0.11911,6,0,0,0,6,8,2,0,0,10
3906,www.amazon.es,legit,3.02699,4,7,13,0,0.57143,0.23285,4,1,3,3,11,3,0,0,0,3
3690,cookies.nextmillmedia.com,legit,3.64307,10,13,25,0,0.76923,0.14572,6,0,0,0,6,5,0,0,0,5
6600,prriqmgofk.com,dga,3.37878,3,10,14,1,0.3,0.24134,2,0,0,0,2,1,0,0,0,1
6523,thosetrust.net,dga,2.95021,4,9,14,1,0.44444,0.21073,3,0,0,0,3,3,0,0,0,3
3699,res.office365.com.edgekey.net,legit,3.8404,9,13,29,0,0.69231,0.13243,10,9,7,4,30,8,3,1,0,12
3996,ads.avct.cloud,legit,3.23593,4,8,14,0,0.5,0.23114,4,0,0,0,4,0,0,0,0,0
7188,aprer.la,dga,2.5,3,4,8,1,0.75,0.3125,4,0,0,0,4,2,0,0,0,2
4312,inventory.vidazoo.com,legit,3.63041,8,11,21,0,0.72727,0.17288,4,1,0,0,5,4,1,0,0,5
7646,rebeccannemalandra.net,dga,3.1867,8,13,22,1,0.61538,0.14485,3,0,0,0,3,11,1,0,0,12
6738,ixseospeurxuc.ddns.net,dga,3.57262,7,13,22,1,0.53846,0.16239,3,1,0,0,4,5,3,2,2,12
1676,rumcdn.geoedge.be,legit,3.26393,6,9,17,0,0.66667,0.192,4,4,2,0,10,3,0,0,0,3
4613,static-akam.licdn.com,legit,3.55852,6,12,21,0,0.5,0.16945,9,2,1,0,12,7,1,0,0,8
4368,b-dc-msedge.net.b-0016.b-msedge.net,legit,3.61444,6,17,35,0,0.35294,0.10327,4,2,1,0,7,5,0,0,0,5
5854,bpfiahnuqpzn.tv,dga,3.64022,3,11,15,1,0.27273,0.24268,0,0,0,0,0,0,0,0,0,0
5129,reliefriskrespondadaptcraft.com,dga,3.87324,10,20,31,1,0.5,0.12494,8,0,0,0,8,8,2,0,0,10
8599,dxuatedldgcurx.com,dga,3.57243,5,12,18,1,0.41667,0.19847,3,0,0,0,3,3,1,0,0,4
295,2mdn.net,legit,2.75,1,5,8,0,0.2,0.34375,1,0,0,0,1,1,0,0,0,1
8165,yassnpi.nl,dga,2.92193,2,7,10,1,0.28571,0.29219,1,0,0,0,1,1,1,0,0,2
5937,companywaraccountbidrepair.com,dga,3.7899,11,18,30,1,0.61111,0.12633,5,1,0,0,6,7,1,0,2,10
1341,images.bitmoji.com,legit,3.41938,7,9,18,0,0.77778,0.18997,4,1,0,0,5,4,0,0,0,4
869,b-graph.facebook.com,legit,3.68418,6,11,20,0,0.54545,0.18421,4,0,0,0,4,3,0,0,0,3
4073,ads.us.e-planning.net,legit,3.49923,6,11,21,0,0.54545,0.16663,6,0,0,0,6,4,1,0,0,5
7768,0pij8pavwtq3.org,dga,3.875,3,9,16,1,0.33333,0.24219,1,0,0,0,1,0,0,0,0,0
5326,pxaraxngdhpwsphao.com,dga,3.65376,5,15,21,1,0.33333,0.17399,1,0,0,0,1,2,0,0,0,2
5600,rugamdurwo.com,dga,3.23593,5,8,14,1,0.625,0.23114,1,0,0,0,1,1,0,0,0,1
1608,vortex.data.microsoft.com,legit,3.62347,8,14,25,0,0.57143,0.14494,10,8,7,6,31,7,0,0,0,7
9717,oculispeteboehlau.com,dga,3.65376,10,10,21,1,1.0,0.17399,2,0,0,0,2,4,0,0,0,4
5822,wjilrilcim.ru,dga,3.02699,4,8,13,1,0.5,0.23285,0,0,0,0,0,1,0,0,0,1
4123,c.media-amazon.com,legit,3.30827,7,8,18,0,0.875,0.18379,5,1,3,2,11,4,0,0,0,4
1382,mobilemaps.googleapis.com,legit,3.49366,10,13,25,0,0.76923,0.13975,7,6,4,4,21,5,0,0,0,5
253,sfx.ms,legit,2.25163,0,5,6,0,0.0,0.37527,0,0,0,0,0,0,0,0,0,0
4855,wamsm-a-3.prod.infra.webex.com,legit,3.9899,8,15,30,0,0.53333,0.133,6,4,3,2,15,4,2,0,0,6
4647,tasks-pa.googleapis.com,legit,3.64249,8,12,23,0,0.66667,0.15837,6,6,4,4,20,5,0,0,0,5
5951,boavavhuheqo.ddns.net,dga,3.63041,7,12,21,1,0.58333,0.17288,2,1,0,0,3,4,4,3,2,13
6062,egsuispenitentiales.com,dga,3.58835,10,12,23,1,0.83333,0.15602,6,1,0,0,7,9,1,0,0,10
4085,zscaler.net,legit,3.27761,3,7,11,0,0.42857,0.29796,2,0,0,0,2,3,0,0,0,3
6655,bdcbcbcelabbfbem.cc,dga,2.71533,3,15,19,1,0.2,0.14291,1,0,0,0,1,5,0,0,0,5
1956,eu-office.events.data.microsoft.com,legit,3.80744,13,17,35,0,0.76471,0.10878,14,13,10,8,45,8,1,0,0,9
8388,ceamugei.ru,dga,3.0958,6,4,11,1,1.5,0.28144,4,0,0,0,4,4,0,0,0,4
5641,jeaseoso.ru,dga,2.91398,6,4,11,1,1.5,0.26491,2,1,0,0,3,3,0,0,0,3
4912,cdn.classlink.com,legit,3.33718,3,12,17,0,0.25,0.1963,5,2,1,0,8,4,1,0,0,5
5655,nrsnhbfy.com,dga,3.4183,1,10,12,1,0.1,0.28486,0,0,0,0,0,0,0,0,0,0
5406,gfynunapgsgooqxk.eu,dga,3.68188,6,12,19,1,0.5,0.19378,2,1,0,0,3,0,0,0,0,0
4483,gateway.prod.us-east-1.forester.a2z.com,legit,4.0385,12,18,39,0,0.66667,0.10355,12,5,3,2,22,9,5,0,0,14
3564,nuid.imrworldwide.com,legit,3.46328,7,12,21,0,0.58333,0.16492,1,0,0,0,1,2,0,0,0,2
6739,jckpqfvy.net,dga,3.58496,1,10,12,1,0.1,0.29875,0,0,0,0,0,0,0,0,0,0
5944,ghsmtkvxbidpwhibh.net,dga,3.88018,3,17,21,1,0.17647,0.18477,0,0,0,0,0,0,0,0,0,0
4702,e10883.g.akamaiedge.net,legit,3.58835,8,7,23,0,1.14286,0.15602,5,5,5,3,18,4,0,0,0,4
4022,static-cdn.spot.im,legit,3.46132,4,11,18,0,0.36364,0.1923,7,2,1,0,10,6,1,0,0,7
7660,dffnbdcofbdfldco.com,dga,2.94644,3,16,20,1,0.1875,0.14732,2,0,0,0,2,1,0,0,0,1
6990,pollutionmortgagesplitdeserve.com,dga,3.90773,12,20,33,1,0.6,0.11842,8,2,1,0,11,10,4,2,0,16
8490,pomandug.ru,dga,3.27761,4,6,11,1,0.66667,0.29796,1,0,0,0,1,4,1,0,0,5
3495,teredo.ipv6.microsoft.com,legit,3.65366,8,13,25,0,0.61538,0.14615,10,8,7,6,31,6,2,0,0,8
4866,glancecdn.net,legit,3.02699,3,9,13,0,0.33333,0.23285,3,1,0,0,4,5,1,1,0,7
4747,na.network-auth.com,legit,3.72161,6,10,19,0,0.6,0.19587,0,0,0,0,0,3,0,0,0,3
1806,ctnsnet.com,legit,2.91398,2,8,11,0,0.25,0.26491,0,0,0,0,0,3,0,0,0,3
8596,cgdwbgc.dynserv.com,dga,3.68188,2,15,19,1,0.13333,0.19378,3,1,1,0,5,4,5,5,4,18
2527,array802.prod.do.dsp.mp.microsoft.com,legit,3.71259,8,20,37,0,0.4,0.10034,12,12,10,9,43,5,2,0,0,7
743,chat.cdn.whatsapp.net,legit,3.3321,4,14,21,0,0.28571,0.15867,6,3,1,0,10,2,1,0,0,3
516,onetrust.com,legit,3.25163,4,7,12,0,0.57143,0.27097,3,0,0,0,3,4,1,0,0,5
8629,tasicgom.com,dga,3.08496,4,7,12,1,0.57143,0.25708,2,0,0,0,2,5,0,0,0,5
8885,hillfind.net,dga,3.08496,3,8,12,1,0.375,0.25708,1,0,0,0,1,2,0,0,0,2
9442,kodemuolabbafe.ddns.net,dga,3.67531,8,13,23,1,0.61538,0.1598,3,1,0,0,4,7,4,3,2,16
3454,corp.apple.com,legit,3.03915,4,8,14,0,0.5,0.21708,7,4,3,2,16,3,0,0,0,3
7772,azgvu.ht,dga,3.0,2,5,8,1,0.4,0.375,0,0,0,0,0,0,0,0,0,0
9133,dqnxtilavqphdjmk.eu,dga,4.0374,4,14,19,1,0.28571,0.21249,1,0,0,0,1,2,0,0,0,2
9423,betterinstead.net,dga,3.02864,6,10,17,1,0.6,0.17816,6,0,0,0,6,9,3,0,0,12
5808,emgywuiiommiwemi.org,dga,3.12193,9,10,20,1,0.9,0.1561,1,0,0,0,1,3,0,0,0,3
8486,hui25huo31pwcsi65ero61owk67nulznvd10nx.net,dga,4.5109,10,19,42,1,0.52632,0.1074,2,0,0,0,2,2,0,0,0,2
3448,qg3.apps.qualys.com,legit,3.57662,4,11,19,0,0.36364,0.18824,4,2,1,0,7,0,0,0,0,0
9648,tujeqepu.info,dga,3.39275,6,6,13,1,1.0,0.26098,0,0,0,0,0,0,0,0,0,0
3093,pardot.com,legit,3.12193,3,6,10,0,0.5,0.31219,0,0,0,0,0,1,0,0,0,1
7897,wsgqyuqqkgygiuqc.org,dga,3.32193,4,15,20,1,0.26667,0.1661,0,0,0,0,0,0,0,0,0,0
556,token.rubiconproject.com,legit,3.63684,8,14,24,0,0.57143,0.15154,6,3,0,0,9,5,2,0,0,7
3007,2.realtime.services.box.net,legit,3.73231,9,13,27,0,0.69231,0.13823,10,2,1,1,14,8,2,1,0,11
4627,iosapps.itunes.g.aaplimg.com,legit,3.62809,10,14,28,0,0.71429,0.12957,7,1,0,0,8,3,0,0,0,3
5095,qs2waoa4asus.org,dga,3.28064,6,7,16,1,0.85714,0.20504,1,0,0,0,1,2,0,0,0,2
7769,nuerwbgdtpgcnrfu.eu,dga,3.57662,5,13,19,1,0.38462,0.18824,1,0,0,0,1,1,0,0,0,1
3477,web.diagnostic.networking.aws.dev,legit,3.86198,10,19,33,0,0.52632,0.11703,6,0,0,0,6,8,1,0,0,9
2143,acdn.adnxs-simple.com,legit,3.72565,5,13,21,0,0.38462,0.17741,6,3,1,0,10,4,0,0,0,4
8782,vwhvdyz.cc,dga,2.92193,0,9,10,1,0.0,0.29219,0,0,0,0,0,0,0,0,0,0
125,bag.itunes.apple.com,legit,3.78418,7,10,20,0,0.7,0.18921,7,4,3,2,16,4,0,0,0,4
7601,wv1l5250ytun7rqjsj721po.ddns.net,dga,4.28891,3,18,32,1,0.16667,0.13403,2,1,0,0,3,4,4,3,2,13
1643,www.tm.ak.prd.aadg.trafficmanager.net,legit,3.66123,9,22,37,0,0.40909,0.09895,10,5,1,3,19,6,1,0,0,7
8946,strucverusredimitpapales.com,dga,3.7979,10,17,28,1,0.58824,0.13564,9,0,0,0,9,9,1,0,0,10
6235,tznigqxwmescozusbek.com,dga,4.00182,6,16,23,1,0.375,0.17399,3,0,0,0,3,4,0,0,0,4
9949,bvvbbr.gy,dga,2.41938,0,8,9,1,0.0,0.26882,0,0,0,0,0,0,0,0,0,0
1344,capi.grammarly.com,legit,3.30827,5,11,18,0,0.45455,0.18379,5,1,1,0,7,5,0,0,0,5
400,adobedtm.com,legit,3.08496,4,7,12,0,0.57143,0.25708,2,0,0,0,2,2,0,0,0,2
8130,odiyljkzbn.com,dga,3.6645,3,10,14,1,0.3,0.26175,0,0,0,0,0,0,0,0,0,0
1156,auth.grammarly.com,legit,3.41938,5,11,18,0,0.45455,0.18997,3,0,0,0,3,4,0,0,0,4
3881,fp-vs-nocache.azureedge.net,legit,3.95453,9,14,27,0,0.64286,0.14646,5,2,1,2,10,5,0,0,0,5
1175,mozgcp.net,legit,3.32193,2,7,10,0,0.28571,0.33219,0,0,0,0,0,0,0,0,0,0
4298,ssl.sc.omtrdc.net,legit,3.29277,2,12,17,0,0.16667,0.19369,0,0,0,0,0,1,0,0,0,1
424,proxy.safebrowsing.apple,legit,3.88684,7,15,24,0,0.46667,0.16195,3,1,0,0,4,2,2,0,0,4
7446,qhkaywwxklghjjrp.eu,dga,3.82687,3,15,19,1,0.2,0.20141,0,0,0,0,0,0,0,0,0,0
2445,star.fallback.c10r.facebook.com,legit,3.70404,8,17,31,0,0.47059,0.11949,5,0,0,0,5,5,0,0,0,5
8757,krovhcyxxhkvnblrtljaut.com,dga,4.00813,4,21,26,1,0.19048,0.15416,1,0,0,0,1,0,0,0,0,0
1601,mon16-platform-useast5.us.tiktokv.com,legit,4.17527,10,19,37,0,0.52632,0.11285,10,6,4,3,23,9,0,0,0,9
2406,l-ring.msedge.net,legit,3.45482,4,10,17,0,0.4,0.20322,5,2,1,0,8,5,2,0,0,7
5903,scufncxkvr.com,dga,3.46772,2,11,14,1,0.18182,0.24769,0,0,0,0,0,0,0,0,0,0
1111,store.microsoft.com,legit,3.1953,6,11,19,0,0.54545,0.16817,9,8,7,6,30,5,0,0,0,5
4821,exchange-match.mediaplex.com,legit,3.7979,9,16,28,0,0.5625,0.13564,8,1,0,0,9,6,1,0,0,7
4634,bam-sdk-configs.bamgrid.com,legit,3.83804,6,17,27,0,0.35294,0.14215,4,1,0,0,5,4,1,0,0,5
1074,segment.io,legit,3.12193,4,5,10,0,0.8,0.31219,3,1,0,0,4,2,1,0,0,3
6874,4qwec682ky0e.top,dga,3.875,3,7,16,1,0.42857,0.24219,0,0,0,0,0,1,0,0,0,1
1636,g2.gumgum.com,legit,2.66123,3,7,13,0,0.42857,0.20471,0,0,0,0,0,0,0,0,0,0
4118,vid.connatix.com,legit,3.375,5,9,16,0,0.55556,0.21094,6,2,0,0,8,4,3,0,0,7
6588,msjhxakmggadetmn.kz,dga,3.68188,3,15,19,1,0.2,0.19378,1,0,0,0,1,2,0,0,0,2
1564,mid.rkdms.com,legit,3.02699,2,9,13,0,0.22222,0.23285,2,0,0,0,2,1,0,0,0,1
9705,itempiscacurat.com,dga,3.46132,7,10,18,1,0.7,0.1923,4,0,0,0,4,8,0,0,0,8
5727,watchedranging.sg,dga,3.57247,4,12,17,1,0.33333,0.21015,4,0,0,0,4,5,1,0,0,6
3127,www.apple.com.edgekey.net.globalredir.akadns.net,legit,3.95324,14,27,48,0,0.51852,0.08236,14,12,10,7,43,10,3,1,0,14
9815,urdykwuxjukdbh.ru,dga,3.26393,4,12,17,1,0.33333,0.192,0,0,0,0,0,0,0,0,0,0
5694,znsce.to,dga,3.0,2,5,8,1,0.4,0.375,1,0,0,0,1,2,0,0,0,2
8941,mjfscpmpgtbmvkpt.eu,dga,3.64215,2,16,19,1,0.125,0.19169,0,0,0,0,0,0,0,0,0,0
1313,europe.smartscreen.microsoft.com,legit,3.59314,11,18,32,0,0.61111,0.11229,10,8,7,6,31,6,0,0,0,6
9553,qoschccsw.ac,dga,2.75163,2,9,12,1,0.22222,0.2293,0,0,0,0,0,0,0,0,0,0
1823,hwcdn.net,legit,2.9477,1,7,9,0,0.14286,0.32752,2,1,0,0,3,1,0,0,0,1
3031,prod.pocket.prod.cloudops.mozgcp.net,legit,3.66329,9,22,36,0,0.40909,0.10176,8,7,6,4,25,1,1,0,0,2
1610,device-metrics-us.amazon.com,legit,3.86933,10,14,28,0,0.71429,0.13819,8,2,3,3,16,8,0,0,0,8
7214,brooklynnmarianne.net,dga,3.45853,7,13,21,1,0.53846,0.16469,3,0,0,0,3,5,0,0,0,5
9365,remissionempaeodem.com,dga,3.33421,10,11,22,1,0.90909,0.15156,3,0,0,0,3,8,2,0,0,10
4104,powerpoint-telemetry.officeapps.live.com,legit,3.92757,14,22,40,0,0.63636,0.09819,13,5,4,3,25,11,0,0,0,11
5732,wxm5t5q85m7i125c42.cn,dga,3.72565,1,9,21,1,0.11111,0.17741,0,0,0,0,0,0,0,0,0,0
1152,mobile.launchdarkly.com,legit,3.88205,7,14,23,0,0.5,0.16878,2,0,0,0,2,3,0,0,0,3
6249,ohdexocuer.ddns.net,dga,3.43162,6,11,19,1,0.54545,0.18061,3,1,0,0,4,6,3,2,1,12
2025,array805.prod.do.dsp.mp.microsoft.com,legit,3.71259,8,20,37,0,0.4,0.10034,12,12,10,9,43,5,2,0,0,7
9867,fnmuifybu.co.ug,dga,3.32323,5,8,15,1,0.625,0.22155,2,1,0,0,3,1,1,0,0,2
6094,xbgttd.com.hn,dga,3.39275,1,10,13,1,0.1,0.26098,3,2,1,0,6,2,2,1,0,5
7504,bccliuenjuilrxizgv.com,dga,3.84535,7,14,22,1,0.5,0.17479,2,0,0,0,2,1,0,0,0,1
9920,wicedsitan.com,dga,3.52164,5,8,14,1,0.625,0.25155,5,1,0,0,6,7,1,0,0,8
6515,gdoqnwqcmq.com,dga,3.03915,2,11,14,1,0.18182,0.21708,0,0,0,0,0,0,0,0,0,0
7207,xoryqdvmt.com.pa,dga,3.625,3,11,16,1,0.27273,0.22656,2,2,1,0,5,3,2,1,0,6
2873,n-able.com,legit,3.32193,3,5,10,0,0.6,0.33219,1,0,0,0,1,1,0,0,0,1
1541,polyfill.io,legit,2.66353,4,6,11,0,0.66667,0.24214,0,0,0,0,0,0,0,0,0,0
6046,eyomyk.net,dga,2.92193,3,6,10,1,0.5,0.29219,0,0,0,0,0,1,0,0,0,1
9463,amleawbiikhui.ddns.net,dga,3.78875,8,12,22,1,0.66667,0.17222,5,1,0,0,6,7,4,3,2,16
2932,us.ck-ie.com,legit,3.25163,4,5,12,0,0.8,0.27097,3,0,0,0,3,0,0,0,0,0
6079,skills-drawn.yt,dga,3.64022,2,11,15,1,0.18182,0.24268,1,0,0,0,1,1,0,0,0,1
2888,sirius.mwbsys.com,legit,3.26393,4,11,17,0,0.36364,0.192,3,0,0,0,3,2,0,0,0,2
5264,omaqivik.ddns.net,dga,3.61687,5,10,17,1,0.5,0.21276,3,1,0,0,4,6,3,2,2,13
9475,ruypothxsvhqdy.biz,dga,3.9477,3,14,18,1,0.21429,0.21932,0,0,0,0,0,0,0,0,0,0
3737,external-preview.redd.it,legit,3.56977,8,13,24,0,0.61538,0.14874,5,0,0,0,5,5,1,0,0,6
9407,nsvpvoadnihnv.com,dga,3.41042,4,12,17,1,0.33333,0.20061,2,0,0,0,2,3,0,0,0,3
6457,bgjjnvfpponj.biz,dga,3.32782,2,13,16,1,0.15385,0.20799,2,0,0,0,2,1,0,0,0,1
6838,gguv.dm,dga,2.52164,1,5,7,1,0.2,0.36023,0,0,0,0,0,0,0,0,0,0
2297,array606.prod.do.dsp.mp.microsoft.com,legit,3.65853,8,20,37,0,0.4,0.09888,12,12,10,9,43,5,2,0,0,7
5084,ftjumvh34dyfqhugtpudteukqm69j46i25l58.com,dga,4.54024,7,23,41,1,0.30435,0.11074,1,0,0,0,1,1,0,0,0,1
860,ce.lijit.com,legit,3.08496,4,6,12,0,0.66667,0.25708,3,0,0,0,3,2,0,0,0,2
1036,pull-cmaf-f16-gcp01.ttlivecdn.com,legit,4.15016,5,19,33,0,0.26316,0.12576,5,1,2,1,9,4,0,0,0,4
4507,data.adsrvr.org,legit,3.00624,4,9,15,0,0.44444,0.20042,5,0,0,0,5,2,0,0,0,2
8841,hfgkpmmujrgbegdy.eu,dga,3.68188,4,14,19,1,0.28571,0.19378,0,0,0,0,0,1,0,0,0,1
8601,rirokhux.ru,dga,2.84535,4,6,11,1,0.66667,0.25867,1,0,0,0,1,1,0,0,0,1
5163,tsilfaftadrrs.com,dga,3.49923,4,12,17,1,0.33333,0.20584,2,0,0,0,2,2,0,0,0,2
8696,gqwm4u8ecukm.top,dga,3.75,4,9,16,1,0.44444,0.23438,0,0,0,0,0,1,0,0,0,1
1460,aadg.trafficmanager.net,legit,3.4101,8,13,23,0,0.61538,0.14827,7,3,1,3,14,6,1,0,0,7
6527,xpkct.com.gl,dga,3.25163,1,9,12,1,0.11111,0.27097,2,2,1,0,5,2,2,1,0,5
1358,functional.events.data.microsoft.com,legit,3.82924,12,20,36,0,0.6,0.10637,14,9,7,6,36,9,3,1,1,14
8985,ojspejinuf5tu87.ddns.net,dga,3.80351,6,13,24,1,0.46154,0.15848,3,1,0,0,4,5,3,3,2,13
267,go.microsoft.com,legit,3.125,5,9,16,0,0.55556,0.19531,6,8,7,6,27,2,0,0,0,2
2264,pt.ispot.tv,legit,2.66353,2,7,11,0,0.28571,0.24214,0,0,0,0,0,1,0,0,0,1
3018,fef.msua04.manage.microsoft.com,legit,3.78437,10,15,31,0,0.66667,0.12208,9,9,7,8,33,6,0,0,0,6
8497,gaqyp.eu,dga,3.0,3,4,8,1,0.75,0.375,0,0,0,0,0,0,0,0,0,0
7573,ogkwcmucywawoyma.org,dga,3.34644,6,13,20,1,0.46154,0.16732,1,0,0,0,1,1,0,0,0,1
9101,ddokbbfdddbamaad.co.uk,dga,3.04945,6,14,22,1,0.42857,0.13861,6,2,0,0,8,4,1,0,0,5
1462,rootca1.amazontrust.com,legit,3.41444,8,12,23,0,0.66667,0.14845,9,1,3,3,16,5,0,0,0,5
4131,t.a3cloud.net,legit,3.39275,4,6,13,0,0.66667,0.26098,3,3,2,1,9,0,0,0,0,0
8123,dmyauupho.ro,dga,3.25163,5,6,12,1,0.83333,0.27097,0,0,0,0,0,0,0,0,0,0
8984,vxiitvnvylposrnps.com,dga,3.6897,4,16,21,1,0.25,0.1757,0,0,0,0,0,1,0,0,0,1
9468,laatqcujel.com,dga,3.37878,5,8,14,1,0.625,0.24134,1,0,0,0,1,3,0,0,0,3
9698,darkbreak.net,dga,3.08506,4,8,13,1,0.5,0.23731,2,0,0,0,2,3,0,0,0,3
2471,login.yahoo.com,legit,3.24022,6,7,15,0,0.85714,0.21601,3,0,0,1,4,1,0,0,0,1
9609,odsitongur.com,dga,3.46772,5,8,14,1,0.625,0.24769,2,0,0,0,2,3,0,0,0,3
42,www.googleapis.com,legit,3.41938,6,10,18,0,0.6,0.18997,5,6,4,4,19,3,0,0,0,3
1543,aptrinsic.com,legit,3.39275,4,8,13,0,0.5,0.26098,3,0,0,0,3,5,1,0,0,6
8660,winnerwarclaimforcerentmarry.com,dga,3.58487,10,21,32,1,0.47619,0.11203,7,1,0,0,8,10,2,0,0,12
6440,pvyqtafox.cc,dga,3.4183,2,9,12,1,0.22222,0.28486,1,0,0,0,1,1,0,0,0,1
7896,irrjkjnowwue.biz,dga,3.5,5,10,16,1,0.5,0.21875,0,0,0,0,0,0,0,0,0,0
8808,gafsbcuiwcymao.info,dga,3.72161,7,11,19,1,0.63636,0.19587,1,0,0,0,1,1,0,5,4,10
7287,hrxdcdtax.ht,dga,2.9183,1,10,12,1,0.1,0.24319,2,0,0,0,2,1,0,0,0,1
9007,damagesitselectchargeprint.com,dga,3.8314,10,19,30,1,0.52632,0.12771,9,2,0,0,11,13,2,1,0,16
953,usertrust.com,legit,3.08506,4,8,13,0,0.5,0.23731,4,1,0,0,5,3,1,0,0,4
6181,q0wl38ctipebkt7.ddns.net,dga,4.05351,3,15,24,1,0.2,0.1689,3,1,0,0,4,5,3,3,2,13
4045,acctcdn.msauth.net,legit,3.30827,4,12,18,0,0.33333,0.18379,3,2,1,0,6,2,0,0,0,2
8048,melgcnurof.com,dga,3.37878,4,9,14,1,0.44444,0.24134,2,0,0,0,2,1,0,0,0,1
8450,mixodove.ru,dga,3.27761,5,5,11,1,1.0,0.29796,1,0,0,0,1,2,1,0,0,3
6111,tgjvojjwbhwc.biz,dga,3.45282,2,13,16,1,0.15385,0.2158,0,0,0,0,0,0,0,0,0,0
183,data-edge.smartscreen.microsoft.com,legit,3.75674,11,20,35,0,0.55,0.10734,14,10,8,6,38,10,0,0,0,10
6357,gqlxrgfqbex.cc,dga,3.23593,1,12,14,1,0.08333,0.23114,0,0,0,0,0,1,3,2,1,7
7233,mhmmfytmbhvrdext.eu,dga,3.51109,3,15,19,1,0.2,0.18479,0,0,0,0,0,1,0,0,0,1
3619,ocsp.verisign.com,legit,3.49923,5,10,17,0,0.5,0.20584,2,0,0,0,2,5,3,0,0,8
4188,atlassian.net,legit,2.87314,5,7,13,0,0.71429,0.22101,1,0,0,0,1,5,1,0,0,6
4767,config.ads.vungle.com,legit,3.78494,6,12,21,0,0.5,0.18024,7,2,0,0,9,3,1,0,0,4
2593,fcdn.us.tiktokv.com.c.worldfcdn2.com,legit,3.78453,6,23,36,0,0.26087,0.10513,8,10,7,4,29,5,2,1,0,8
3452,www.imdb.com,legit,2.85539,2,8,12,0,0.25,0.23795,0,0,0,0,0,0,0,0,0,0
89,windows.net,legit,3.0958,3,7,11,0,0.42857,0.28144,1,0,0,0,1,2,0,0,0,2
3684,gates.grammarly.com,legit,3.43162,5,12,19,0,0.41667,0.18061,7,0,0,0,7,7,1,0,0,8
3310,static.cdninstagram.com,legit,3.46858,6,15,23,0,0.4,0.15081,11,1,0,0,12,11,1,0,0,12
6393,enweceddi.com,dga,3.02699,5,7,13,1,0.71429,0.23285,3,0,0,0,3,5,0,0,0,5
6389,pwnthwulogiumver.net,dga,3.82193,6,13,20,1,0.46154,0.1911,3,0,0,0,3,2,1,0,0,3
2266,downloaddispatch.itunes.apple.com,legit,3.89971,11,19,33,0,0.57895,0.11817,10,4,3,2,19,7,0,0,0,7
5878,groupfirst.net,dga,3.52164,4,9,14,1,0.44444,0.25155,3,0,0,0,3,1,0,0,0,1
9357,kcufqpxymucp.space,dga,3.53049,4,13,18,1,0.30769,0.19614,0,0,0,0,0,0,0,0,0,0
2761,cdn.jwplayer.com,legit,3.75,3,11,16,0,0.27273,0.23438,4,2,1,0,7,3,0,0,0,3
7435,fnfur.bo,dga,2.75,2,5,8,1,0.4,0.34375,0,0,0,0,0,0,0,0,0,0
8097,lwjgagvvimxco.nu,dga,3.75,4,11,16,1,0.36364,0.23438,1,0,0,0,1,1,0,0,0,1
803,us-east1-aws.api.snapchat.com,legit,3.74196,9,14,29,0,0.64286,0.12903,8,3,1,0,12,4,1,0,0,5
8694,kdleeaeemboedcfa.de,dga,3.0761,9,9,19,1,1.0,0.1619,3,0,0,0,3,4,0,0,0,4
51,msn.com,legit,2.52164,1,5,7,0,0.2,0.36023,0,0,0,0,0,0,0,0,0,0
8089,vfsrfojixecc.ru,dga,3.50689,4,10,15,1,0.4,0.23379,0,0,0,0,0,1,0,0,0,1
1247,bs.serving-sys.com,legit,3.61437,3,12,18,0,0.25,0.2008,4,1,1,1,7,3,3,1,0,7
9241,hefuagjeanrtilth.eu,dga,3.57662,8,10,19,1,0.8,0.18824,2,0,0,0,2,3,0,0,0,3
6569,1jinwdkxy2odg4eredmhwbs.ddns.net,dga,4.15252,5,22,32,1,0.22727,0.12977,7,1,0,0,8,8,4,3,2,17
9676,afyjjfarnnlpfbur.eu,dga,3.47135,5,13,19,1,0.38462,0.1827,0,0,0,0,0,1,0,0,0,1
6050,pchpgdreho.com,dga,3.23593,3,10,14,1,0.3,0.23114,1,0,0,0,1,1,0,0,0,1
7477,maxaxuk.info,dga,3.25163,5,6,12,1,0.83333,0.27097,1,0,0,0,1,1,0,0,0,1
5637,ncabbekdnlldoeoa.com,dga,3.38418,7,12,20,1,0.58333,0.16921,1,0,0,0,1,3,0,0,0,3
3985,e-0009.e-msedge.net,legit,3.17611,5,6,19,0,0.83333,0.16716,3,2,1,0,6,3,0,0,0,3
3500,pull-a5-tt01.fcdn.us.tiktokv.com.c.bytefcdn-oversea.com,legit,4.3199,12,30,55,0,0.4,0.07854,12,10,9,5,36,9,5,1,0,15
461,cdninstagram.com,legit,3.5,4,11,16,0,0.36364,0.21875,7,1,0,0,8,8,0,0,0,8
1305,ecn-us.dev.virtualearth.net,legit,3.73601,9,14,27,0,0.64286,0.13837,5,0,0,0,5,6,0,0,0,6
8631,toylwfuyrq.com,dga,3.52164,3,10,14,1,0.3,0.25155,0,0,0,0,0,0,0,0,0,0
447,mathtag.com,legit,2.91398,3,7,11,0,0.42857,0.26491,3,0,0,0,3,3,0,0,0,3
8975,sugarwebfirmgiftdraftserve.com,dga,3.92323,9,20,30,1,0.45,0.13077,3,1,1,0,5,6,2,1,0,9
8442,7rg6ubilt1miifkzbx.net,dga,4.06148,5,13,22,1,0.38462,0.18461,1,0,0,0,1,1,0,0,0,1
9633,gicaslafi.com,dga,3.2389,5,7,13,1,0.71429,0.24915,1,0,0,0,1,4,0,0,0,4
5089,masuhno.com,dga,3.0958,4,6,11,1,0.66667,0.28144,1,0,0,0,1,3,0,0,0,3
9904,morlsufjatghxgcww.com,dga,3.91613,4,16,21,1,0.25,0.18648,1,0,0,0,1,3,0,0,0,3
3787,us-east-1.aiv-delivery.net,legit,3.74833,9,11,26,0,0.81818,0.14417,6,1,0,0,7,7,1,0,0,8
24,facebook.com,legit,3.02206,5,6,12,0,0.83333,0.25184,2,0,0,0,2,2,0,0,0,2
3616,entitlements.jwplayer.com,legit,3.81366,7,16,25,0,0.4375,0.15255,7,1,0,0,8,7,1,0,0,8
5543,hfoqvedxjiayxpcqssu.com,dga,4.08878,6,16,23,1,0.375,0.17777,1,0,0,0,1,3,0,0,0,3
1238,prod.service.minerva.devices.a2z.com,legit,3.71885,12,18,36,0,0.66667,0.1033,15,6,3,2,26,10,5,1,0,16
1122,syndication.twitter.com,legit,3.62118,7,14,23,0,0.5,0.15744,7,0,0,0,7,9,4,2,1,16
9999,anqzzkcmxwzvcqexzi.com,dga,3.60694,4,17,22,1,0.23529,0.16395,0,0,0,0,0,1,0,0,0,1
3807,adxcel-ec2.com,legit,3.32486,4,7,14,0,0.57143,0.23749,2,0,0,0,2,3,0,0,0,3
320,suite.office.com,legit,3.25,7,7,16,0,1.0,0.20312,5,4,4,3,16,5,0,0,0,5
9714,reductionscultures.wtf,dga,3.66353,7,14,22,1,0.5,0.16652,5,0,0,0,5,6,4,1,1,12
7507,es64u064uceg.net,dga,3.32782,5,5,16,1,1.0,0.20799,2,0,0,0,2,2,0,0,0,2
1640,tynt.com,legit,2.75,1,6,8,0,0.16667,0.34375,1,0,0,0,1,0,0,0,0,0
6127,qrltxoth.com,dga,3.25163,2,9,12,1,0.22222,0.27097,0,0,0,0,0,0,0,0,0,0
7169,tractmarks.de,dga,3.2389,3,9,13,1,0.33333,0.24915,2,0,0,0,2,4,1,0,0,5
4373,mon-va.tiktokv.com,legit,3.35021,5,10,18,0,0.5,0.18612,3,5,4,3,15,2,0,0,0,2
721,cdn.id5-sync.com,legit,3.32782,2,10,16,0,0.2,0.20799,2,2,1,0,5,1,0,0,0,1
3506,celtra.com,legit,3.12193,3,6,10,0,0.5,0.31219,2,0,0,0,2,3,1,0,0,4
3460,sakura.goguardian.com,legit,3.53517,9,10,21,0,0.9,0.16834,1,1,0,0,2,3,0,0,0,3
8920,yeat.sk,dga,2.80735,2,4,7,1,0.5,0.40105,2,0,0,0,2,2,0,0,0,2
3673,pointmediatracker.com,legit,3.63041,8,12,21,0,0.66667,0.17288,6,0,0,0,6,6,1,0,0,7
1913,api.permutive.com,legit,3.49923,7,8,17,0,0.875,0.20584,4,1,1,0,6,3,0,0,0,3
1463,life360.com,legit,3.45943,3,4,11,0,0.75,0.31449,1,0,0,0,1,0,0,0,0,0
6425,pmwktoapbhnuroqfoqbm.mu,dga,3.76227,6,16,23,1,0.375,0.16358,2,1,0,0,3,0,0,0,0,0
7420,improvementdeterminecome.com,dga,3.31184,11,16,28,1,0.6875,0.11828,9,3,0,0,12,13,6,0,0,19
2001,0.pool.ntp.org,legit,2.98523,3,7,14,0,0.42857,0.21323,2,0,0,0,2,0,0,0,0,0
6821,csecuevdocgeuy.com,dga,3.2391,7,10,18,1,0.7,0.17995,2,0,0,0,2,3,0,0,0,3
1938,hs-scripts.com,legit,3.32486,2,10,14,0,0.2,0.23749,1,0,0,0,1,1,0,0,0,1
5484,m8mndfhacnwh26tdbc.ru,dga,3.91613,2,15,21,1,0.13333,0.18648,0,0,0,0,0,2,0,0,0,2
205,protection.outlook.com,legit,3.35649,9,11,22,0,0.81818,0.15257,8,1,0,0,9,4,3,1,1,9
2752,static-ecst.licdn.com,legit,3.49923,5,13,21,0,0.38462,0.16663,8,1,0,0,9,7,1,0,0,8
5199,dfpmwwlrv.hn,dga,3.4183,0,11,12,1,0.0,0.28486,0,0,0,0,0,0,0,0,0,0
723,static.xx.fbcdn.net,legit,3.43162,3,13,19,0,0.23077,0.18061,7,1,0,0,8,6,1,0,0,7
4233,publisher-assets.spot.im,legit,3.68456,7,14,24,0,0.5,0.15352,4,0,0,0,4,5,2,0,0,7
8424,lkoclr.dyndns.org,dga,3.38158,2,13,17,1,0.15385,0.19892,2,1,0,0,3,4,3,4,3,14
3197,config.office.akadns.net,legit,3.57393,8,13,24,0,0.61538,0.14891,9,8,8,6,31,6,2,0,0,8
2301,im-apps.net,legit,3.27761,3,6,11,0,0.5,0.29796,2,1,0,0,3,0,0,0,0,0
8345,nvpg8a6axus5ek2hjs.biz,dga,4.27761,5,12,22,1,0.41667,0.19444,1,0,0,0,1,0,0,0,0,0
2400,pancake.g.aaplimg.com,legit,3.40399,7,11,21,0,0.63636,0.16209,5,0,0,0,5,2,0,0,0,2
526,download.windowsupdate.com,legit,3.67141,9,15,26,0,0.6,0.14121,6,0,0,0,6,5,1,0,0,6
9660,aqfndkkuhuppgrht.eu,dga,3.68188,5,13,19,1,0.38462,0.19378,1,0,0,0,1,1,0,0,0,1
2658,monorail-edge.shopifysvc.com,legit,4.09307,9,16,28,0,0.5625,0.14618,6,2,1,0,9,5,0,0,0,5
8278,dejwx.nl,dga,3.0,1,6,8,1,0.16667,0.375,0,0,0,0,0,1,0,0,0,1
2581,ocsp.comodoca.com,legit,2.69866,6,9,17,0,0.66667,0.15874,3,2,1,0,6,3,2,1,0,6
2660,onedscolprdeus04.eastus.cloudapp.azure.com,legit,3.89185,15,21,42,0,0.71429,0.09266,17,5,3,4,29,9,1,0,0,10
6262,nwoeylnsaiftomg.com,dga,3.78714,6,12,19,1,0.5,0.19932,0,0,0,0,0,2,0,0,0,2
5079,aopldfuhwhgra.org,dga,3.49923,5,11,17,1,0.45455,0.20584,2,0,0,0,2,1,0,0,0,1
62,lencr.org,legit,2.9477,2,6,9,0,0.33333,0.32752,3,0,0,0,3,2,0,0,0,2
9589,cicteoci.ru,dga,2.84535,5,5,11,1,1.0,0.25867,2,0,0,0,2,2,0,0,0,2
4719,public.wsjcm-a-10.prod.infra.webex.com,legit,4.29097,9,20,38,0,0.45,0.11292,7,4,3,2,16,4,2,0,0,6
1081,api.btloader.com,legit,3.625,6,8,16,0,0.75,0.22656,5,1,1,0,7,2,0,0,0,2
656,fcmconnection.googleapis.com,legit,3.58005,10,16,28,0,0.625,0.12786,8,7,4,4,23,8,3,1,1,13
3331,elb.us-west-2.amazonaws.com,legit,3.8562,8,13,27,0,0.61538,0.14282,7,1,3,3,14,6,1,0,0,7
8010,xirwijuv.ru,dga,2.91398,4,6,11,1,0.66667,0.26491,0,0,0,0,0,0,0,0,0,0
9550,mirrorwellfinanceconcern.com,dga,3.39629,9,18,28,1,0.5,0.1213,7,1,0,0,8,10,3,1,0,14
7063,8mgu4icuc2se.net,dga,3.625,5,7,16,1,0.71429,0.22656,2,0,0,0,2,2,0,0,0,2
1973,az416426.vo.msecnd.net,legit,3.87966,4,9,22,0,0.44444,0.17635,2,0,0,0,2,3,0,0,0,3
7613,victimimprovement.tk,dga,3.40869,6,13,20,1,0.46154,0.17043,7,2,0,0,9,6,3,0,0,9
5013,w2oagqg2cmwi.org,dga,3.32782,4,9,16,1,0.44444,0.20799,0,0,0,0,0,0,0,0,0,0
9291,m270ons6els03dcb34sj14e.ddns.net,dga,4.05423,4,16,32,1,0.25,0.12669,4,1,0,0,5,6,4,3,2,15
168,www.googleadservices.com,legit,3.65727,8,14,24,0,0.57143,0.15239,10,7,5,5,27,7,2,1,0,10
3132,cs.lkqd.net,legit,3.27761,1,8,11,0,0.125,0.29796,1,0,0,0,1,0,0,0,0,0
3195,rubicon-match.dotomi.com,legit,3.60539,8,13,24,0,0.61538,0.15022,7,1,0,0,8,8,1,0,0,9
2097,1928505594.rsc.cdn77.org,legit,3.85539,1,8,24,0,0.125,0.16064,3,1,0,0,4,1,0,0,0,1
2368,mobtrakk.com,legit,3.08496,3,8,12,0,0.375,0.25708,1,0,0,0,1,1,1,0,0,2
2908,onedscolprdcus13.centralus.cloudapp.azure.com,legit,3.91643,14,25,45,0,0.56,0.08703,19,5,3,4,31,8,3,0,0,11
5669,pgefafebxtaibxpp.im,dga,3.36609,6,12,19,1,0.5,0.17716,3,0,0,0,3,2,0,0,0,2
9197,marutik.info,dga,3.4183,5,6,12,1,0.83333,0.28486,2,1,0,0,3,3,0,0,0,3
5236,geholdi.com,dga,3.27761,4,6,11,1,0.66667,0.29796,1,0,0,0,1,1,0,0,0,1
9891,ozeedureinw.com,dga,3.45656,7,7,15,1,1.0,0.23044,3,0,0,0,3,3,0,0,0,3
7411,guifossiotpai.ddns.net,dga,3.57262,8,12,22,1,0.66667,0.16239,2,1,0,0,3,5,4,3,2,14
9986,hen766pis4ugjebgkd.com,dga,4.1867,5,12,22,1,0.41667,0.1903,2,0,0,0,2,2,0,0,0,2
4778,vidstatb.taboola.com,legit,3.40869,7,11,20,0,0.63636,0.17043,6,0,0,0,6,4,0,0,0,4
9750,asguixxuabumuvi.ddns.net,dga,3.6683,9,13,24,1,0.69231,0.15285,2,1,0,0,3,5,4,3,2,14
3416,amazon.fr,legit,2.9477,3,5,9,0,0.6,0.32752,3,1,3,2,9,3,0,0,0,3
4354,onedscolprdaus00.australiasoutheast.cloudapp.azure.com,legit,3.94443,21,27,54,0,0.77778,0.07304,18,5,3,4,30,9,2,0,0,11
4179,e4751.b.akamaiedge.net,legit,3.66353,8,7,22,0,1.14286,0.16652,5,5,5,3,18,4,0,0,0,4
7324,alexandreachastity.net,dga,3.57262,8,13,22,1,0.61538,0.16239,5,1,0,0,6,10,2,0,0,12
4637,az764295.vo.msecnd.net,legit,4.06148,4,9,22,0,0.44444,0.18461,2,0,0,0,2,3,0,0,0,3
376,eb2.3lift.com,legit,3.54659,3,6,13,0,0.5,0.27281,1,0,0,0,1,0,0,0,0,0
3790,com-c-3.edgekey.net.globalredir.akadns.net,legit,4.02603,12,22,42,0,0.54545,0.09586,8,6,5,3,22,9,2,0,0,11
9080,tufakiva.info,dga,3.2389,6,6,13,1,1.0,0.24915,0,0,0,0,0,0,0,0,0,0
9819,vyxyrlwsctth.ru,dga,3.50689,1,13,15,1,0.07692,0.23379,0,0,0,0,0,0,0,0,0,0
1758,binaries.templates.cdn.office.net,legit,3.77548,11,18,33,0,0.61111,0.11441,13,6,5,3,27,11,1,0,0,12
4458,video.adaptv.advertising.com,legit,3.74398,10,15,28,0,0.66667,0.13371,6,0,0,0,6,7,2,0,0,9
455,cc-api-data.adobe.io,legit,3.32193,9,7,20,0,1.28571,0.1661,6,1,0,0,7,3,0,0,0,3
3308,geotrust.com,legit,3.25163,4,7,12,0,0.57143,0.27097,3,0,0,0,3,2,0,0,0,2
2911,onedscolprdcus05.centralus.cloudapp.azure.com,legit,3.91643,14,25,45,0,0.56,0.08703,19,5,3,4,31,8,3,0,0,11
9408,uajbexwcmhghm.in,dga,3.75,4,11,16,1,0.36364,0.23438,0,0,0,0,0,1,1,0,0,2
8690,rywacyg.su,dga,3.12193,2,7,10,1,0.28571,0.31219,0,0,0,0,0,1,0,0,0,1
2938,api-partner.spotify.com,legit,3.79509,7,13,23,0,0.53846,0.165,4,1,0,0,5,4,0,0,0,4
6201,kcguodegymaqaaeev.net,dga,3.6897,9,11,21,1,0.81818,0.1757,1,0,0,0,1,2,0,0,0,2
2628,events.mz.unity3d.com,legit,3.78494,5,12,21,0,0.41667,0.18024,4,1,0,0,5,4,1,0,0,5
8617,mcuw2ou4y060.top,dga,3.625,4,6,16,1,0.66667,0.22656,1,0,0,0,1,0,0,0,0,0
5375,fuxbozde.ru,dga,3.27761,4,6,11,1,0.66667,0.29796,0,0,0,0,0,1,0,0,0,1
8537,christopherarabella.net,dga,3.64249,8,14,23,1,0.57143,0.15837,3,0,0,0,3,9,3,0,2,14
7615,1fstwj7xi6o8mx36q4i.ddns.net,dga,4.23593,4,15,28,1,0.26667,0.15128,3,1,0,0,4,5,4,3,2,14
19,apple.com,legit,2.9477,3,5,9,0,0.6,0.32752,4,3,2,1,10,1,0,0,0,1
8644,cummpprqdhrcpbic.eu,dga,3.43162,4,14,19,1,0.28571,0.18061,3,0,0,0,3,1,0,0,0,1
6860,aeeiqowigmmegwga.org,dga,3.18418,9,10,20,1,0.9,0.15921,0,0,0,0,0,0,0,0,0,0
5270,fgvvixjcemabkkxve.cc,dga,3.54644,4,15,20,1,0.26667,0.17732,2,0,0,0,2,4,0,0,0,4
674,ssl-images-amazon.com,legit,3.52257,7,11,21,0,0.63636,0.16774,5,2,3,2,12,5,0,0,0,5
6997,wlaecrecniqigqh.info,dga,3.68418,7,12,20,1,0.58333,0.18421,2,0,0,0,2,4,0,0,0,4
6760,yobnsyfqbex.com,dga,3.50689,3,11,15,1,0.27273,0.23379,0,0,0,0,0,2,3,2,1,8
9265,pdcyjmezabp.tv,dga,3.6645,2,11,14,1,0.18182,0.26175,0,0,0,0,0,0,0,0,0,0
1333,p13n.adobe.io,legit,3.39275,5,4,13,0,1.25,0.26098,2,0,0,0,2,1,0,0,0,1
5644,cewwkosqgweygsao.org,dga,3.40869,6,13,20,1,0.46154,0.17043,1,0,0,0,1,1,0,0,0,1
9883,ygiwqoq8uoio.net,dga,3.45282,7,7,16,1,1.0,0.2158,0,0,0,0,0,0,0,0,0,0
4477,vox-chorus.map.fastly.net,legit,4.13366,6,15,25,0,0.4,0.16535,7,1,0,0,8,4,0,0,0,4
7584,sideexperiencedsurroundcrash.com,dga,3.69143,12,19,32,1,0.63158,0.11536,9,0,0,0,9,11,2,1,0,14
625,lh4.googleusercontent.com,legit,3.65366,8,14,25,0,0.57143,0.14615,10,8,4,3,25,7,3,0,0,10
2977,array615.prod.do.dsp.mp.microsoft.com,legit,3.71259,8,20,37,0,0.4,0.10034,12,12,10,9,43,5,2,0,0,7
7926,walmnpmfofgglj.com,dga,3.46132,3,14,18,1,0.21429,0.1923,1,0,0,0,1,0,0,0,0,0
4730,fm.flashtalking.com,legit,3.72161,4,13,19,0,0.30769,0.19587,2,0,0,0,2,4,1,0,0,5
7109,sxcbpyeijffibpyu.eu,dga,3.51109,6,12,19,1,0.5,0.18479,0,1,0,0,1,0,0,0,0,0
6952,oevwwguiwcymao.info,dga,3.64215,8,10,19,1,0.8,0.19169,1,0,0,0,1,1,0,5,4,10
6428,aeuwkwwqgaceaigi.org,dga,3.40869,9,10,20,1,0.9,0.17043,2,0,0,0,2,3,0,0,0,3
4638,heads-fa.scdn.co,legit,3.375,4,9,16,0,0.44444,0.21094,5,1,0,0,6,2,0,0,0,2
9114,eiguiokaiwmgmiyc.org,dga,3.48418,9,10,20,1,0.9,0.17421,1,0,0,0,1,1,0,0,0,1
5660,klhzoanansnan.com,dga,3.21953,5,11,17,1,0.45455,0.18938,0,0,0,0,0,2,2,4,3,11
5676,ommbgfjdubybhdwbd.pw,dga,3.48418,2,17,20,1,0.11765,0.17421,0,0,0,0,0,1,0,0,0,1
3866,ipv4.cws.conviva.com,legit,3.40869,5,11,20,0,0.45455,0.17043,4,2,0,0,6,2,2,0,0,4
724,imrworldwide.com,legit,3.25,5,10,16,0,0.5,0.20312,0,0,0,0,0,2,0,0,0,2
30,skype.com,legit,3.16993,2,6,9,0,0.33333,0.35221,0,0,0,0,0,0,0,0,0,0
4904,c-0001.c-msedge.net,legit,3.43162,3,8,19,0,0.375,0.18061,4,2,1,0,7,3,0,0,0,3
2710,onedscolprdeus09.eastus.cloudapp.azure.com,legit,3.89185,15,21,42,0,0.71429,0.09266,17,5,3,4,29,9,1,0,0,10
5038,xpun.nl,dga,2.52164,1,5,7,1,0.2,0.36023,0,0,0,0,0,0,0,0,0,0
9019,121d7dof3f787tw0uvoh7r7.ddns.net,dga,4.0122,4,15,32,1,0.26667,0.12538,3,1,0,0,4,4,3,3,2,12
6574,tshtjwvupnkpmwwe.biz,dga,3.88418,3,16,20,1,0.1875,0.19421,0,0,0,0,0,0,0,0,0,0
1005,pull-a5-sg01.tiktokcdn.com,legit,4.16198,5,14,26,0,0.35714,0.16008,4,6,9,9,28,2,0,0,0,2
1244,bdec.microsoft.com,legit,3.41938,5,11,18,0,0.45455,0.18997,6,8,7,6,27,4,0,0,0,4
1669,ocsp.edge.digicert.com,legit,3.4474,7,12,22,0,0.58333,0.1567,8,3,1,0,12,6,1,0,0,7
1571,teamviewer.com,legit,3.32486,6,7,14,0,0.85714,0.23749,4,0,0,0,4,4,0,0,0,4
6627,granvillesullivan.net,dga,3.40399,7,13,21,1,0.53846,0.16209,4,0,0,0,4,5,0,0,0,5
9617,cjjqfvskgecssdclwffm.so,dga,3.67531,2,20,23,1,0.1,0.1598,1,0,0,0,1,2,0,0,0,2
7751,fobdism.de,dga,3.12193,3,6,10,1,0.5,0.31219,0,0,0,0,0,1,0,0,0,1
2553,a-ring-fallback.msedge.net,legit,3.95006,7,15,26,0,0.46667,0.15193,5,2,1,0,8,6,2,0,0,8
41,play.google.com,legit,3.1899,5,8,15,0,0.625,0.21266,3,5,4,3,15,2,0,0,0,2
4562,platform-akam.linkedin.com,legit,3.87314,8,15,26,0,0.53333,0.14897,6,1,1,0,8,6,0,0,0,6
910,cloud.tenable.com,legit,3.49923,6,9,17,0,0.66667,0.20584,7,3,2,1,13,3,0,0,0,3
8610,ltteunyvvjvfytvxi.tw,dga,3.42193,3,16,20,1,0.1875,0.1711,1,0,0,0,1,1,0,0,0,1
1776,telecommandsvc.microsoft.com,legit,3.6645,8,18,28,0,0.44444,0.13088,11,9,7,6,33,11,2,0,0,13
9366,tyrybaeklq.com,dga,3.6645,3,10,14,1,0.3,0.26175,0,0,0,0,0,0,0,0,0,0
4861,data.agkn.com,legit,3.18083,4,7,13,0,0.57143,0.24468,3,0,0,0,3,2,0,0,0,2
1778,cloudinary.com,legit,3.52164,5,8,14,0,0.625,0.25155,3,3,2,1,9,2,0,0,0,2
5705,daaadkdlbcbdmcca.cc,dga,2.68953,4,14,19,1,0.28571,0.14155,1,0,0,0,1,1,0,0,0,1
2603,fef.msua02.manage.microsoft.com,legit,3.78437,10,15,31,0,0.66667,0.12208,9,9,7,8,33,6,0,0,0,6
7642,swq4xafq44kcdlly67.com,dga,3.97057,2,14,22,1,0.14286,0.18048,1,0,0,0,1,0,0,0,0,0
6913,kymohiirsa.com,dga,3.37878,5,8,14,1,0.625,0.24134,0,0,0,0,0,0,0,0,0,0
8840,nonsuquestum.com,dga,3.20282,6,9,16,1,0.66667,0.20018,3,0,0,0,3,5,1,0,0,6
5073,vdwphrduswupy.com,dga,3.61687,3,13,17,1,0.23077,0.21276,1,0,0,0,1,0,0,0,0,0
4208,metrics.brightcove.com,legit,3.60694,6,14,22,0,0.42857,0.16395,3,0,0,0,3,5,1,0,0,6
4927,hexagon-analytics.com,legit,3.88018,7,12,21,0,0.58333,0.18477,3,0,0,0,3,4,0,0,0,4
5220,cyshvlhdqb.com,dga,3.52164,1,12,14,1,0.08333,0.25155,0,0,0,0,0,0,0,0,0,0
6633,xirxeiqi.ru,dga,2.66353,5,5,11,1,1.0,0.24214,0,0,0,0,0,0,0,0,0,0
8400,papatemporefacere.com,dga,3.17757,9,11,21,1,0.81818,0.15131,6,0,0,0,6,8,2,0,0,10
1790,us-east-sync.bidswitch.net,legit,3.74833,6,16,26,0,0.375,0.14417,4,1,0,0,5,4,0,0,0,4
4998,sync.hgrtb.com,legit,3.52164,1,11,14,0,0.09091,0.25155,0,0,0,0,0,0,0,0,0,0
2803,adscale.de,legit,2.72193,4,5,10,0,0.8,0.27219,3,0,0,0,3,2,0,0,0,2
6609,glasslisten.net,dga,3.05656,4,10,15,1,0.4,0.20377,4,0,0,0,4,6,2,0,0,8
4835,geo.mnc260.mcc310.pub.3gppnetwork.org,legit,4.05731,6,19,37,0,0.31579,0.10966,3,0,0,0,3,4,0,0,0,4
8246,buxfeoci.ru,dga,3.27761,5,5,11,1,1.0,0.29796,0,0,0,0,0,0,0,0,0,0
5087,peobcoekqoin.ddns.net,dga,3.52257,7,12,21,1,0.58333,0.16774,4,1,0,0,5,6,3,2,1,12
3936,news-assets.apple.com,legit,3.49923,6,12,21,0,0.5,0.16663,7,4,3,2,16,5,1,0,0,6
3680,logincdn.msauth.net,legit,3.78714,5,12,19,0,0.41667,0.19932,5,2,1,0,8,2,0,0,0,2
6367,huwneppaaeoqk.com,dga,3.61687,7,9,17,1,0.77778,0.21276,1,0,0,0,1,1,0,0,0,1
9470,impressionresortsuggestsail.com,dga,3.6468,11,19,31,1,0.57895,0.11764,6,0,0,0,6,8,4,0,0,12
4142,rubiconcm.digitaleast.mobi,legit,3.85429,10,14,26,0,0.71429,0.14824,8,2,0,0,10,10,2,0,0,12
7229,a0q0e4uoqsis.org,dga,3.5,6,6,16,1,1.0,0.21875,0,0,0,0,0,2,0,0,0,2
3257,directory-search-a.wbx2.com,legit,4.0323,7,15,27,0,0.46667,0.14934,3,0,0,0,3,6,0,0,0,6
1729,b1.nel.goog,legit,2.91398,3,5,11,0,0.6,0.26491,0,0,0,0,0,2,0,0,0,2
4239,instantmessaging-pa-jms-us.googleapis.com,legit,3.81403,13,23,41,0,0.56522,0.09303,12,6,4,4,26,9,2,0,0,11
2469,id.a-mx.com,legit,3.0958,3,5,11,0,0.6,0.28144,2,0,0,0,2,0,0,0,0,0
4746,cdn.clinch.co,legit,2.77736,2,9,13,0,0.22222,0.21364,5,2,1,0,8,2,0,0,0,2
562,cs.dds.microsoft.com,legit,3.17095,4,13,20,0,0.30769,0.15855,9,8,7,6,30,4,1,1,0,6
1420,ib.3lift.com,legit,3.25163,3,6,12,0,0.5,0.27097,1,0,0,0,1,0,0,0,0,0
9712,ijyqfrwoystvqnom.me,dga,3.82687,4,14,19,1,0.28571,0.20141,1,0,0,0,1,2,0,0,0,2
1033,pull-cmaf-l77-va01.tiktokcdn.com,legit,4.11673,6,17,32,0,0.35294,0.12865,5,6,9,9,29,3,0,0,0,3
3883,fp-vs.azureedge.net,legit,3.72161,6,10,19,0,0.6,0.19587,5,2,1,2,10,3,0,0,0,3
8710,abfldolfddenblaa.co,dga,3.18137,6,12,19,1,0.5,0.16744,1,0,0,0,1,4,0,0,0,4
269,clients3.google.com,legit,3.47135,6,10,19,0,0.6,0.1827,5,6,4,3,18,2,1,0,0,3
4601,pm-widget.taboola.com,legit,3.78494,7,11,21,0,0.63636,0.18024,4,1,0,0,5,4,0,0,0,4
5681,igamlac.com,dga,2.91398,4,6,11,1,0.66667,0.26491,1,0,0,0,1,3,0,0,0,3
4129,file.force.com,legit,3.09307,5,7,14,0,0.71429,0.22093,3,0,0,0,3,3,0,0,0,3
8521,krkinfysnnddsdmy.eu,dga,3.43162,3,15,19,1,0.2,0.18061,2,0,0,0,2,3,0,0,0,3
6907,wqgpkcmiy.net,dga,3.70044,2,10,13,1,0.2,0.28465,1,0,0,0,1,1,0,0,0,1
1129,rtb.openx.net,legit,3.08506,3,8,13,0,0.375,0.23731,1,0,0,0,1,1,0,0,0,1
207,smoot.apple.com,legit,3.1899,5,8,15,0,0.625,0.21266,6,4,3,2,15,1,0,0,0,1
2104,mnc260.mcc310.pub.3gppnetwork.org,legit,4.08955,4,18,33,0,0.22222,0.12393,2,0,0,0,2,3,0,0,0,3
3406,jwpsrv.com,legit,3.32193,1,8,10,0,0.125,0.33219,0,0,0,0,0,0,0,0,0,0
4696,rackcdn.com,legit,3.02717,2,8,11,0,0.25,0.2752,3,1,1,0,5,3,0,0,0,3
7364,yhhqvebfcfuvgunek.com,dga,3.82089,5,15,21,1,0.33333,0.18195,0,0,0,0,0,2,0,0,0,2
8798,hlmdcshvfuq.com,dga,3.50689,2,12,15,1,0.16667,0.23379,0,0,0,0,0,0,0,0,0,0
1593,media1.giphy.com,legit,3.625,5,8,16,0,0.625,0.22656,1,0,0,0,1,1,0,0,0,1
7791,avqcbvpbyv.com,dga,3.18201,2,11,14,1,0.18182,0.22729,0,0,0,0,0,0,0,0,0,0
6678,imeevstuvelo.pw,dga,3.45656,6,8,15,1,0.75,0.23044,2,0,0,0,2,3,0,0,0,3
2806,fmip.fe.apple-dns.net,legit,3.52257,5,12,21,0,0.41667,0.16774,9,5,3,2,19,4,1,0,0,5
8390,2gq8ike8qois.top,dga,3.5,5,7,16,1,0.71429,0.21875,0,0,0,0,0,1,0,0,0,1
9813,ihtiobihcii.ddns.net,dga,3.24145,7,11,20,1,0.63636,0.16207,3,1,0,0,4,5,5,3,2,15
6005,oskigzq.mooo.com,dga,3.0244,6,8,16,1,0.75,0.18902,2,0,0,0,2,0,1,2,1,4
1705,pull-f5-sg01.fcdn.us.tiktokv.com,legit,4.1875,5,18,32,0,0.27778,0.13086,6,7,7,4,24,2,0,0,0,2
6836,wykbjrundruepm.net,dga,3.72548,4,13,18,1,0.30769,0.20697,0,0,0,0,0,1,0,0,0,1
4387,gts.byteoversea.net,legit,3.36609,6,11,19,0,0.54545,0.17716,5,0,0,0,5,5,3,0,0,8
3805,tags.w55c.net,legit,3.2389,2,7,13,0,0.28571,0.24915,2,0,0,0,2,1,0,0,0,1
1763,prod.ingestion-edge.prod.dataops.mozgcp.net,legit,3.81036,13,24,43,0,0.54167,0.08861,16,6,4,2,28,10,5,1,0,16
278,cp.wd.microsoft.com,legit,3.39189,4,12,19,0,0.33333,0.17852,8,8,7,6,29,2,0,0,0,2
8921,quodvenialiumnon.com,dga,3.54644,9,10,20,1,0.9,0.17732,3,0,0,0,3,4,0,0,0,4
7404,atbmddilg.com,dga,3.39275,3,9,13,1,0.33333,0.26098,1,0,0,0,1,2,0,0,0,2
3563,hpdaas.com,legit,3.12193,3,6,10,0,0.5,0.31219,0,0,0,0,0,1,0,0,0,1
7288,toambshtmybvcc.com,dga,3.30827,3,14,18,1,0.21429,0.18379,1,0,0,0,1,1,0,0,0,1
1410,content-signature-2.cdn.mozilla.net,legit,3.95444,10,19,35,0,0.52632,0.11298,11,4,1,0,16,9,3,0,0,12
9697,bgnypscddlbb.me.uk,dga,3.68354,2,14,18,1,0.14286,0.20464,2,0,0,0,2,1,0,0,0,1
3975,brightcove.net,legit,3.52164,4,9,14,0,0.44444,0.25155,1,0,0,0,1,3,1,0,0,4
8180,etiaminfernusoperantur.com,dga,3.69026,11,14,26,1,0.78571,0.14193,8,0,0,0,8,8,1,0,0,9
1095,pd.itunes.apple.com,legit,3.64215,6,10,19,0,0.6,0.19169,8,4,3,2,17,4,0,0,0,4
2937,pull-f5-tt02-infra.fcdn.us.tiktokv.com.c.worldfcdn2.com,legit,4.21262,9,32,55,0,0.28125,0.07659,10,10,9,5,34,7,2,1,0,10
2052,ad.adsrvr.org,legit,2.87314,3,8,13,0,0.375,0.22101,4,0,0,0,4,0,0,0,0,0
9270,scrcvcuiwcymao.biz,dga,3.61437,5,12,18,1,0.41667,0.2008,2,0,0,0,2,1,0,5,4,10
9673,gqcnklugaii.com,dga,3.50689,5,9,15,1,0.55556,0.23379,0,0,0,0,0,0,0,0,0,0
1060,pull-f5-sg01.tiktokcdn.com,legit,4.16198,4,15,26,0,0.26667,0.16008,4,6,9,9,28,2,0,0,0,2
4751,api-glb-ausw2b.smoot.apple.com,legit,3.93957,9,15,30,0,0.6,0.13132,8,5,3,2,18,1,0,0,0,1
590,bh.contextweb.com,legit,3.38158,4,11,17,0,0.36364,0.19892,5,2,0,0,7,3,2,0,0,5
7487,f4p6xwir4u23srvr1j.biz,dga,4.06148,3,12,22,1,0.25,0.18461,0,0,0,0,0,0,0,0,0,0
3556,iad-usadmm.dotomi.com,legit,3.2728,8,10,21,0,0.8,0.15585,4,0,0,0,4,3,0,0,0,3
1715,urbanairship.com,legit,3.625,6,9,16,0,0.66667,0.22656,0,0,0,0,0,1,0,0,0,1
9584,rhscropbmjnyxfaamorvdqptyd.net,dga,4.21506,5,24,30,1,0.20833,0.1405,3,1,0,0,4,2,0,0,0,2
5825,adcaeccnacfnccma.com,dga,2.73935,6,13,20,1,0.46154,0.13697,2,0,0,0,2,4,0,0,0,4
4827,geo-applefinance-cache.internal.query.g03.yahoodns.net,legit,4.16433,18,27,54,0,0.66667,0.07712,13,4,2,2,21,11,4,2,0,17
3750,outbrain.org,legit,3.25163,5,6,12,0,0.83333,0.27097,3,0,0,0,3,2,0,0,0,2
748,dmd.metaservices.microsoft.com,legit,3.58108,9,18,30,0,0.5,0.11937,13,10,8,7,38,9,2,1,0,12
6933,badattackfinancebornhold.com,dga,3.7979,9,18,28,1,0.5,0.13564,5,0,0,0,5,7,2,1,0,10
5519,aliisrarussacram.com,dga,3.14644,8,11,20,1,0.72727,0.15732,5,0,0,0,5,5,0,0,0,5
1098,ipcdn.apple.com,legit,3.32323,4,9,15,0,0.44444,0.22155,7,6,4,2,19,2,0,0,0,2
6025,sivociferanturil.com,dga,3.78418,8,11,20,1,0.72727,0.18921,3,0,0,0,3,5,1,0,0,6
5483,cdadfcurgxtcoldov.net,dga,3.74899,5,15,21,1,0.33333,0.17852,3,0,0,0,3,1,0,0,0,1
8695,alexandrinaatterberry.net,dga,3.30347,9,15,25,1,0.6,0.13214,5,0,0,0,5,9,3,0,0,12
703,ocsp.sectigo.com,legit,3.15564,5,9,16,0,0.55556,0.19723,3,0,0,0,3,3,0,0,0,3
177,enterprise.activity.windows.com,legit,3.84888,10,18,31,0,0.55556,0.12416,10,1,0,0,11,11,3,0,0,14
1453,qq.com,legit,2.25163,1,4,6,0,0.25,0.37527,0,0,0,0,0,0,0,0,0,0
153,init.itunes.apple.com,legit,3.55852,8,10,21,0,0.8,0.16945,8,4,3,2,17,6,0,0,0,6
1572,kit.fontawesome.com,legit,3.57662,7,10,19,0,0.7,0.18824,4,0,0,0,4,5,0,0,0,5
1421,photos-ugc.l.googleusercontent.com,legit,3.69675,11,19,34,0,0.57895,0.10873,10,8,4,3,25,7,3,0,0,10
5440,eakkdkkpopwx.org,dga,3.25,4,11,16,1,0.36364,0.20312,1,0,0,0,1,1,0,0,0,1
348,px.ads.linkedin.com,legit,3.68188,5,11,19,0,0.45455,0.19378,7,0,0,0,7,2,0,0,0,2
4853,nyt.com,legit,2.80735,1,5,7,0,0.2,0.40105,0,0,0,0,0,0,0,0,0,0
1605,c.bytefcdn-oversea.com,legit,3.84535,6,13,22,0,0.46154,0.17479,6,1,0,0,7,6,3,0,0,9
52,icloud.com,legit,2.92193,4,5,10,0,0.8,0.29219,3,3,2,1,9,1,0,0,0,1
4864,login.salesforce.com,legit,3.58418,7,11,20,0,0.63636,0.17921,5,0,0,0,5,5,0,0,0,5
1219,jadserve.postrelease.com,legit,3.56977,9,13,24,0,0.69231,0.14874,9,1,1,0,11,9,2,1,0,12
8279,oafdnbfoklfodkea.eu,dga,3.32636,8,10,19,1,0.8,0.17507,2,0,0,0,2,2,0,0,0,2
9889,hggvhhiyd.yi.org,dga,3.03064,3,11,16,1,0.27273,0.18942,1,0,0,0,1,0,0,0,0,0
1870,outcome-ssp.supersonicads.com,legit,3.673,10,16,29,0,0.625,0.12666,8,1,0,0,9,8,2,0,0,10
87,sharepoint.com,legit,3.6645,5,8,14,0,0.625,0.26175,3,0,0,0,3,3,0,0,0,3
1352,api.sc-gw.com,legit,3.39275,3,7,13,0,0.42857,0.26098,2,1,1,0,4,0,0,0,0,0
9897,dulidkfqatay.biz,dga,3.625,5,10,16,1,0.5,0.22656,3,0,0,0,3,2,0,0,0,2
6878,wrotefindarticles.uz,dga,3.92193,7,12,20,1,0.58333,0.1961,7,0,0,0,7,8,0,0,0,8
2089,dmxleo.com,legit,2.92193,3,6,10,0,0.5,0.29219,1,0,0,0,1,1,0,0,0,1
3904,styles.redditmedia.com,legit,3.57262,7,13,22,0,0.53846,0.16239,6,0,0,0,6,7,0,0,0,7
5109,djouiogea.com,dga,3.33468,7,5,13,1,1.4,0.25651,3,0,0,0,3,2,0,0,0,2
9324,brmhnvkqoyuc.cm,dga,3.64022,2,12,15,1,0.16667,0.24268,0,0,0,0,0,0,0,0,0,0
3449,idr.cdnwidget.com,legit,3.45482,4,11,17,0,0.36364,0.20322,4,2,0,0,6,3,0,0,0,3
5193,hkfvyuxzxdvxjfwe.com,dga,3.88418,3,16,20,1,0.1875,0.19421,0,0,0,0,0,0,0,0,0,0
7126,ebfllaekbkdfakfo.com,dga,3.34644,6,13,20,1,0.46154,0.16732,0,0,0,0,0,1,0,0,0,1
3953,aolcdn.com,legit,2.92193,3,6,10,0,0.5,0.29219,2,1,0,0,3,1,0,0,0,1
4255,commercial.ocsp.identrust.com,legit,3.74541,9,17,29,0,0.52941,0.12915,7,2,0,0,9,6,2,0,0,8
4872,warnermediacdn.com,legit,3.39215,6,11,18,0,0.54545,0.18845,4,1,0,0,5,6,0,0,0,6
7761,pxfkfgvfcbbjfbnq.eu,dga,3.57662,2,16,19,1,0.125,0.18824,0,0,0,0,0,0,0,0,0,0
4028,shop.app,legit,2.40564,2,5,8,0,0.4,0.3007,0,0,0,0,0,0,0,0,0,0
9925,rtikupkt.dyndns.org,dga,3.61635,3,14,19,1,0.21429,0.19033,3,2,0,0,5,5,3,4,3,15
7561,cebhmpphuk.com,dga,3.23593,3,10,14,1,0.3,0.23114,2,0,0,0,2,1,0,0,0,1
3396,opus.analytics.yahoo.com,legit,3.60539,9,12,24,0,0.75,0.15022,6,0,0,1,7,3,0,0,0,3
5497,wm0ygaw6s2ga.org,dga,3.45282,3,9,16,1,0.33333,0.2158,0,0,0,0,0,0,0,0,0,0
543,htlb.casalemedia.com,legit,3.58418,7,11,20,0,0.63636,0.17921,3,0,0,0,3,5,0,0,0,5
7932,dixvsewswmmwdbchu.com,dga,3.65376,4,16,21,1,0.25,0.17399,1,0,0,0,1,1,0,0,0,1
4431,inscloudgate.net,legit,3.625,6,9,16,0,0.66667,0.22656,5,3,2,1,11,4,1,0,0,5
3667,adobesc.com,legit,3.0958,4,6,11,0,0.66667,0.28144,2,0,0,0,2,2,0,0,0,2
3413,micpn.com,legit,2.72548,2,6,9,0,0.33333,0.30283,2,1,0,0,3,2,0,0,0,2
6273,egwfscgwwkfq.com,dga,3.32782,2,13,16,1,0.15385,0.20799,0,0,0,0,0,0,0,0,0,0
1524,undertone.com,legit,3.2389,5,7,13,0,0.71429,0.24915,2,0,0,0,2,5,1,0,0,6
6745,studyappreciatemirrordeal.com,dga,3.77144,11,17,29,1,0.64706,0.13005,10,1,0,0,11,10,1,0,0,11
289,clients.google.com,legit,3.35021,6,10,18,0,0.6,0.18612,6,6,4,3,19,2,1,0,0,3
191,googletagservices.com,legit,3.52257,8,12,21,0,0.66667,0.16774,8,6,4,3,21,8,2,1,0,11
380,init-cdn.itunes-apple.com.akadns.net,legit,3.81911,11,19,36,0,0.57895,0.10609,13,11,10,9,43,10,3,1,0,14
9193,mwy4qois2824.net,dga,3.75,3,7,16,1,0.42857,0.23438,0,0,0,0,0,1,0,0,0,1
8101,enqm.com.sv,dga,3.0958,2,7,11,1,0.28571,0.28144,3,2,1,0,6,3,2,1,0,6
9566,owvfanvsoc.com,dga,3.18201,4,9,14,1,0.44444,0.22729,0,0,0,0,0,1,0,0,0,1
2138,a1837.z.akamai.net,legit,3.46132,6,5,18,0,1.2,0.1923,3,3,4,3,13,2,0,0,0,2
5451,8awyoqwu4ioy.org,dga,3.45282,6,7,16,1,0.85714,0.2158,0,0,0,0,0,0,0,0,0,0
5501,harrietteanabella.net,dga,3.11828,9,11,21,1,0.81818,0.14849,2,0,0,0,2,9,0,0,0,9
401,assets.adobedtm.com,legit,3.26083,6,11,19,0,0.54545,0.17162,5,0,0,0,5,5,1,0,0,6
2814,prebid-a.rubiconproject.com,legit,3.8562,9,15,27,0,0.6,0.14282,6,2,0,0,8,5,2,0,0,7
9974,servicechairassumesetdeal.com,dga,3.64697,12,16,29,1,0.75,0.12576,7,2,1,1,11,12,4,1,0,17
5923,yworsqspjxocjhmf.com,dga,3.68418,3,16,20,1,0.1875,0.18421,0,0,0,0,0,1,0,0,0,1
4243,cdn.mxpnl.com,legit,3.08506,1,10,13,0,0.1,0.23731,3,2,1,0,6,1,0,0,0,1
8438,qwwjeqq.cc,dga,2.44644,1,8,10,1,0.125,0.24464,0,0,0,0,0,0,0,0,0,0
9383,ockkfacmflccamnd.co.uk,dga,3.26104,5,15,22,1,0.33333,0.14823,4,1,0,0,5,5,1,0,0,6
9425,mamitumyvig.eu,dga,3.18201,6,7,14,1,0.85714,0.22729,3,0,0,0,3,4,0,0,0,4
5842,yeeoppboac.dyndns.org,dga,3.59447,6,13,21,1,0.46154,0.17117,3,1,0,0,4,5,3,4,3,15
8507,rockbecomeringmeetdisappointed.com,dga,3.79704,13,20,34,1,0.65,0.11168,9,2,0,0,11,11,4,1,0,16
2802,alicdn.com,legit,3.12193,3,6,10,0,0.5,0.31219,4,1,0,0,5,2,0,0,0,2
1924,ad-events.flashtalking.com,legit,4.05602,7,16,26,0,0.4375,0.156,6,1,0,0,7,6,2,0,0,8
6004,kyysqsyuauwmmmwi.org,dga,3.54644,5,14,20,1,0.35714,0.17732,0,0,0,0,0,0,0,0,0,0
6889,anisestsuntgratuita.com,dga,3.5014,9,13,23,1,0.69231,0.15223,7,0,0,0,7,11,2,0,0,13
4565,sf.tlu.dl.delivery.mp.microsoft.com,legit,3.82144,8,21,35,0,0.38095,0.10918,11,8,7,7,33,7,1,0,0,8
8721,kknbbeoemebdooac.online,dga,3.32748,10,12,23,1,0.83333,0.14467,1,0,0,0,1,3,0,0,0,3
9690,servedgilbert.wtf,dga,3.57247,4,12,17,1,0.33333,0.21015,3,2,1,0,6,5,2,1,0,8
874,mail.yahoo.com,legit,3.03915,6,6,14,0,1.0,0.21708,2,0,0,1,3,1,0,0,0,1
5503,byudzsao.cl,dga,3.45943,3,7,11,1,0.42857,0.31449,0,0,0,0,0,0,0,0,0,0
8882,cngceslbuc.ms,dga,3.18083,2,10,13,1,0.2,0.24468,2,0,0,0,2,2,0,0,0,2
6789,npgbttgxoteduqat.su,dga,3.61635,5,13,19,1,0.38462,0.19033,3,0,0,0,3,3,0,0,0,3
6697,cysanmh.ro,dga,3.32193,2,7,10,1,0.28571,0.33219,0,0,0,0,0,1,0,0,0,1
1596,ess-apple.com.akadns.net,legit,3.62581,7,13,24,0,0.53846,0.15108,11,9,9,9,38,6,4,1,0,11
6985,madlmlccbofbddnf.cc,dga,3.15557,2,16,19,1,0.125,0.16608,4,0,0,0,4,3,1,0,0,4
9378,ceeqyyagouokgyog.org,dga,3.18418,8,11,20,1,0.72727,0.15921,2,0,0,0,2,1,0,0,0,1
8351,dpuumdqnkg.com,dga,3.37878,3,10,14,1,0.3,0.24134,0,0,0,0,0,0,0,0,0,0
6766,ocleeokfccnfolaa.eu,dga,3.18137,9,9,19,1,1.0,0.16744,1,0,0,0,1,2,0,0,0,2
5140,canonesmagisanilongius.com,dga,3.43046,11,14,26,1,0.78571,0.13194,5,0,0,0,5,8,1,0,0,9
4087,us-east-1.sonar.prime-video.amazon.dev,legit,3.92517,14,16,38,0,0.875,0.10329,8,3,3,3,17,9,0,0,0,9
7781,kuguoaksaiggusys.org,dga,3.14644,8,11,20,1,0.72727,0.15732,1,0,0,0,1,0,0,0,0,0
2697,onedscolprdeus01.eastus.cloudapp.azure.com,legit,3.89185,15,21,42,0,0.71429,0.09266,17,5,3,4,29,9,1,0,0,10
7727,roomfell.net,dga,3.08496,4,7,12,1,0.57143,0.25708,2,0,0,0,2,2,0,0,0,2
1362,cp601.prod.do.dsp.mp.microsoft.com,legit,3.51734,6,19,34,0,0.31579,0.10345,11,12,10,9,42,3,2,0,0,5
7076,meetingbatshowrollcrashorder.com,dga,3.91391,10,21,32,1,0.47619,0.12231,7,0,0,0,7,9,1,0,0,10
8945,uroccuximivibia.ddns.net,dga,3.83496,9,13,24,1,0.69231,0.15979,4,1,0,0,5,5,4,3,2,14
8775,fjpbgdribncc.ga,dga,3.50689,2,12,15,1,0.16667,0.23379,0,0,0,0,0,1,0,0,0,1
4442,getgo.com,legit,2.72548,3,5,9,0,0.6,0.30283,1,0,0,0,1,2,0,0,0,2
9913,igimducn.com,dga,3.08496,4,7,12,1,0.57143,0.25708,0,0,0,0,0,0,0,0,0,0
113,mobile.events.data.microsoft.com,legit,3.80423,11,17,32,0,0.64706,0.11888,14,9,7,6,36,8,1,0,0,9
7434,agwnmyt.mooo.com,dga,3.07782,5,9,16,1,0.55556,0.19236,2,0,0,0,2,0,1,2,1,4
4287,eat.hungryroot.com,legit,3.57243,6,10,18,0,0.6,0.19847,4,0,0,0,4,2,0,0,0,2
297,tile-service.weather.microsoft.com,legit,3.78926,12,18,34,0,0.66667,0.11145,14,10,8,7,39,9,3,2,1,15
5925,walkinggalaxy.mo,dga,3.45282,5,10,16,1,0.5,0.2158,1,0,0,0,1,2,1,0,0,3
3437,ep.learnplatform.com,legit,3.52193,6,12,20,0,0.5,0.1761,5,0,0,0,5,6,0,0,0,6
5769,ahuacoahikwal.ru,dga,3.25,8,7,16,1,1.14286,0.20312,1,0,0,0,1,2,0,0,0,2
3858,malwarebytes.com,legit,3.625,5,10,16,0,0.5,0.22656,4,0,0,0,4,5,0,0,0,5
9356,pmildmna.nf,dga,3.0958,2,8,11,1,0.25,0.28144,1,0,0,0,1,1,0,0,0,1
2065,captive-cidr.origin-apple.com.akadns.net,legit,3.99644,13,21,40,0,0.61905,0.09991,12,9,9,9,39,11,3,1,0,15
4623,tappx.com,legit,2.9477,2,6,9,0,0.33333,0.32752,3,1,0,0,4,1,0,0,0,1
2997,siteimproveanalytics.io,legit,3.74095,10,12,23,0,0.83333,0.16265,6,1,0,0,7,8,2,0,0,10
6927,iktspgeoya.biz,dga,3.6645,5,8,14,1,0.625,0.26175,1,1,0,0,2,1,0,1,0,2
6728,ouosqwiugkeq.info,dga,3.45482,8,8,17,1,1.0,0.20322,1,0,0,0,1,0,0,3,2,5
1965,bolt-gcdn.sc-cdn.net,legit,3.44644,2,14,20,0,0.14286,0.17232,2,2,1,0,5,1,0,0,0,1
6869,z763swxjti1qqaabga.com,dga,4.15239,5,12,22,1,0.41667,0.18874,1,0,0,0,1,1,0,0,0,1
8189,cyaufsiugkeq.info,dga,3.73452,7,9,17,1,0.77778,0.21968,0,0,0,0,0,1,0,3,2,6
2492,prod.cagenerator.pki.strln.net,legit,3.69807,8,18,30,0,0.44444,0.12327,10,4,2,1,17,9,1,0,0,10
8475,concessasnmalletprimis.com,dga,3.56545,8,17,26,1,0.47059,0.13713,8,1,0,0,9,11,3,0,0,14
8396,relationinbox.su,dga,3.625,7,8,16,1,0.875,0.22656,5,0,0,0,5,8,3,2,1,14
84,lh3.googleusercontent.com,legit,3.65366,8,14,25,0,0.57143,0.14615,10,8,4,3,25,7,3,0,0,10
9534,14qpsxcnipc0al3.ddns.net,dga,3.97018,3,15,24,1,0.2,0.16542,2,1,0,0,3,5,3,2,2,12
7006,lvygtypwyn.com,dga,3.46772,1,12,14,1,0.08333,0.24769,0,0,0,0,0,0,0,0,0,0
6084,gyhwkemhqmvcajzkzbigehqprhqlj.biz,dga,4.08955,5,27,33,1,0.18519,0.12393,2,0,0,0,2,3,0,0,0,3
8060,toqteoxa.ru,dga,3.0958,5,5,11,1,1.0,0.28144,1,0,0,0,1,1,0,0,0,1
2017,bat-bing-com.a-0001.a-msedge.net,legit,3.84314,8,13,32,0,0.61538,0.1201,7,4,3,1,15,7,2,0,0,9
5413,ieltnkheqi.com,dga,3.52164,5,8,14,1,0.625,0.25155,0,0,0,0,0,1,0,0,0,1
5185,ezrmojnrzr.com,dga,3.03915,3,10,14,1,0.3,0.21708,0,0,0,0,0,0,0,0,0,0
9332,list-drink-jacket.com,dga,3.91613,5,13,21,1,0.38462,0.18648,3,0,0,0,3,6,2,0,0,8
7560,utedk0w8ixcng6evi8udmv3.ddns.net,dga,4.07782,7,18,32,1,0.38889,0.12743,4,1,0,0,5,6,3,2,2,13
8846,kffecfmmacneobfd.com,dga,3.24644,5,14,20,1,0.35714,0.16232,1,0,0,0,1,4,0,0,0,4
3938,control.kochava.com,legit,3.36609,6,11,19,0,0.54545,0.17716,4,1,0,0,5,2,2,0,1,5
2198,pull-o5-gcp01.tiktokcdn.com.c.bytefcdn-oversea.com,legit,4.34398,11,28,50,0,0.39286,0.08688,10,10,12,10,42,9,5,1,0,15
4536,gmscompliance-pa.googleapis.com,legit,3.60663,11,17,31,0,0.64706,0.11634,9,7,4,4,24,7,2,1,0,10
8028,iwemsernet.com,dga,3.32486,5,8,14,1,0.625,0.23749,2,1,0,0,3,5,1,0,0,6
4769,push-rtmp-l11-va01.tiktokcdn.com,legit,4.17923,5,18,32,0,0.27778,0.1306,5,6,7,8,26,2,0,0,0,2
357,geo.prod.do.dsp.mp.microsoft.com,legit,3.39737,8,18,32,0,0.44444,0.10617,12,12,10,9,43,4,2,0,0,6
7736,mindweighgatherbringhear.com,dga,3.74398,9,18,28,1,0.5,0.13371,5,0,0,0,5,8,3,1,1,13
6296,kemixan.info,dga,3.25163,5,6,12,1,0.83333,0.27097,1,0,0,0,1,3,0,0,0,3
9138,rfwudfiosppm.org,dga,3.5,4,11,16,1,0.36364,0.21875,1,0,0,0,1,0,0,0,0,0
2960,platform.linkedin.com,legit,3.82089,6,13,21,0,0.46154,0.18195,5,0,0,0,5,5,0,0,0,5
9220,khglnjbeaqaunldx.eu,dga,3.72161,6,12,19,1,0.5,0.19587,1,0,0,0,1,2,0,0,0,2
5040,esergimlohw.com,dga,3.50689,5,9,15,1,0.55556,0.23379,4,1,0,0,5,3,1,0,0,4
7292,0y4iceku86s2.net,dga,3.875,4,6,16,1,0.66667,0.24219,2,1,0,0,3,2,0,0,0,2
5455,krjmjrltbw.com,dga,3.37878,1,12,14,1,0.08333,0.24134,0,0,0,0,0,0,0,0,0,0
7754,nrvpvuaq.com,dga,3.4183,3,8,12,1,0.375,0.28486,0,0,0,0,0,0,0,0,0,0
8937,adtnoqbmjgguxoww.eu,dga,3.82687,6,12,19,1,0.5,0.20141,1,0,0,0,1,0,0,0,0,0
3753,u.4dex.io,legit,2.9477,4,2,9,0,2.0,0.32752,0,0,0,0,0,1,0,0,0,1
5351,sbamwingzknizhckntc.com,dga,3.76227,4,18,23,1,0.22222,0.16358,3,0,0,0,3,3,1,0,0,4
6506,dgnwndnulcvsdbcom.in,dga,3.58418,3,16,20,1,0.1875,0.17921,2,1,0,0,3,4,1,0,0,5
5571,proexecertenenturq.com,dga,3.35195,8,13,22,1,0.61538,0.15236,7,2,0,0,9,6,3,0,0,9
8583,sitpenasecclesiis.com,dga,3.3321,8,12,21,1,0.66667,0.15867,4,0,0,0,4,9,0,0,0,9
2579,publishers.tremorhub.com,legit,3.72018,7,15,24,0,0.46667,0.15501,5,0,0,0,5,5,2,0,0,7
9711,lyxaluja.info,dga,3.39275,5,7,13,1,0.71429,0.26098,0,0,0,0,0,0,0,0,0,0
202,gvt1.com,legit,3.0,1,5,8,0,0.2,0.375,0,0,0,0,0,0,0,0,0,0
7320,jguhhtufcjww.biz,dga,3.5,3,12,16,1,0.25,0.21875,0,0,0,0,0,0,0,0,0,0
290,android.clients.google.com,legit,3.67141,9,14,26,0,0.64286,0.14121,9,6,4,3,22,4,2,0,0,6
321,webshell.suite.office.com,legit,3.65366,9,13,25,0,0.69231,0.14615,5,4,4,3,16,6,0,0,0,6
398,nav-edge.smartscreen.microsoft.com,legit,3.8366,10,20,34,0,0.5,0.11284,12,10,8,6,36,8,0,0,0,8
8357,drelzqognj.com,dga,3.6645,3,10,14,1,0.3,0.26175,1,0,0,0,1,2,0,0,0,2
6107,ingiheslu.com,dga,3.54659,5,7,13,1,0.71429,0.27281,2,0,0,0,2,2,1,0,0,3
2385,sportradarserving.com,legit,3.72565,6,14,21,0,0.42857,0.17741,5,1,1,1,8,6,4,1,0,11
1278,acuityplatform.com,legit,3.61437,6,11,18,0,0.54545,0.2008,2,0,0,0,2,5,0,0,0,5
5682,ug3jsb28uyuqxwgfqt.com,dga,4.06148,4,14,22,1,0.28571,0.18461,0,0,0,0,0,0,0,0,0,0
4386,pub.network,legit,3.45943,3,7,11,0,0.42857,0.31449,0,0,0,0,0,0,0,0,0,0
6509,wgblpbacyt.com,dga,3.52164,2,11,14,1,0.18182,0.25155,0,0,0,0,0,1,0,0,0,1
3502,us.tiktokv.com.c.bytefcdn-oversea.com,legit,3.99001,10,21,37,0,0.47619,0.10784,12,9,6,4,31,9,5,1,0,15
5880,yvblcquawhkdxths.eu,dga,4.0374,4,14,19,1,0.28571,0.21249,0,0,0,0,0,0,0,0,0,0
2018,zeotap.com,legit,3.12193,4,5,10,0,0.8,0.31219,2,0,0,0,2,1,0,0,0,1
5196,3g4l1vdwt7lecjspcf.cn,dga,4.07066,1,15,21,1,0.06667,0.19384,1,0,0,0,1,2,0,0,0,2
563,fbs.smoot.apple.com,legit,3.43162,5,11,19,0,0.45455,0.18061,7,4,3,2,16,1,0,0,0,1
1237,minerva.devices.a2z.com,legit,3.67531,8,11,23,0,0.72727,0.1598,9,1,0,0,10,9,3,0,0,12
8211,henffaoe.com,dga,3.08496,5,6,12,1,0.83333,0.25708,1,0,0,0,1,1,0,0,0,1
9809,mctipdmsqseghl.com,dga,3.68354,3,14,18,1,0.21429,0.20464,2,0,0,0,2,2,0,0,0,2
1304,www.redditstatic.com,legit,3.44644,5,13,20,0,0.38462,0.17232,7,0,0,0,7,9,1,0,0,10
4034,phonedeviceverification-pa.googleapis.com,legit,3.96503,18,20,41,0,0.9,0.09671,12,8,4,4,28,15,6,2,1,24
2826,is-ssl.mzstatic.com.itunes-apple.com.akadns.net,legit,3.87812,13,26,47,0,0.5,0.08251,17,9,9,9,44,14,4,1,0,19
9152,fkysupdqyxdakxip.eu,dga,3.61635,5,13,19,1,0.38462,0.19033,0,0,0,0,0,1,0,0,0,1
3156,e4518.dscapi7.akamaiedge.net,legit,3.92325,10,10,28,0,1.0,0.14012,9,6,5,3,23,6,0,0,0,6
3538,fg.download.windowsupdate.com.c.footprint.net,legit,3.89687,13,26,45,0,0.5,0.0866,13,3,2,2,20,9,4,1,0,14
3216,usadmm.dotomi.com,legit,3.10188,6,9,17,0,0.66667,0.18246,4,0,0,0,4,3,0,0,0,3
3862,myworkdaycdn.com,legit,3.375,3,12,16,0,0.25,0.21094,2,1,0,0,3,2,0,0,0,2
3270,web.hb.ad.cpe.dotomi.com,legit,3.48644,7,12,24,0,0.58333,0.14527,7,0,0,0,7,3,1,0,0,4
5324,ij1rib36ork6wtc87bmdsxo.ddns.net,dga,4.28891,5,19,32,1,0.26316,0.13403,3,1,0,0,4,6,4,3,2,15
349,graph.instagram.com,legit,3.57662,5,12,19,0,0.41667,0.18824,6,0,0,0,6,6,0,0,0,6
529,yimg.com,legit,2.75,2,5,8,0,0.4,0.34375,0,0,0,0,0,0,0,0,0,0
6511,qtgubbteuqje.com,dga,3.375,5,10,16,1,0.5,0.21094,1,0,0,0,1,1,0,0,0,1
4232,mm.bing.net,legit,2.91398,2,7,11,0,0.28571,0.26491,1,0,0,0,1,1,1,0,0,2
1185,mobile-gtalk.l.google.com,legit,3.46347,8,13,25,0,0.61538,0.13854,3,5,4,3,15,2,0,0,0,2
4905,hb.omtrdc.net,legit,3.39275,2,9,13,0,0.22222,0.26098,0,0,0,0,0,1,0,0,0,1
3263,contextual-analytics.wunderkind.co,legit,4.02086,11,20,34,0,0.55,0.11826,9,1,0,0,10,10,1,0,0,11
8399,uponsuch.net,dga,3.25163,4,7,12,1,0.57143,0.27097,1,0,0,0,1,3,0,0,0,3
9131,ibydohgfajs0k0kp72u.ddns.net,dga,4.28039,5,17,28,1,0.29412,0.15287,2,1,0,0,3,4,3,3,2,12
2306,media.apple.com,legit,3.24022,6,7,15,0,0.85714,0.21601,6,4,3,2,15,2,0,0,0,2
3042,outlook.live.com,legit,3.25,7,7,16,0,1.0,0.20312,4,0,0,0,4,1,0,0,0,1
9375,qxaedyjpnrxfpsspc.com,dga,3.88018,3,17,21,1,0.17647,0.18477,1,0,0,0,1,1,0,0,0,1
2613,c-bing-com.a-0001.a-msedge.net,legit,3.8314,7,12,30,0,0.58333,0.12771,6,4,3,1,14,6,2,0,0,8
4090,w.usabilla.com,legit,3.37878,5,7,14,0,0.71429,0.24134,1,0,0,0,1,1,0,0,0,1
4805,rv-gateway.supersonicads.com,legit,4.11058,9,16,28,0,0.5625,0.14681,7,0,0,0,7,8,2,0,0,10
4474,bkrtx.com,legit,3.16993,1,7,9,0,0.14286,0.35221,0,0,0,0,0,0,0,0,0,0
966,apresolve.spotify.com,legit,3.78494,7,12,21,0,0.58333,0.18024,6,0,0,0,6,4,1,0,0,5
3358,business-bing-com.b-0005.b-msedge.net,legit,3.79689,8,18,37,0,0.44444,0.10262,7,4,2,0,13,9,4,0,0,13
946,cl4.apple.com,legit,3.08506,3,7,13,0,0.42857,0.23731,5,4,3,2,14,1,0,0,0,1
7871,ponwsdumgdkvcswjvvwf.com,dga,3.77206,3,20,24,1,0.15,0.15717,1,0,0,0,1,1,0,0,0,1
1959,d2.shared.global.fastly.net,legit,3.81008,6,16,27,0,0.375,0.14111,5,1,0,0,6,5,0,0,0,5
5486,cup42lydyd60jxf62dvotc39gse61g43c29e11nw.com,dga,4.52717,5,22,44,1,0.22727,0.10289,1,0,0,0,1,1,0,0,0,1
2087,1561539925.rsc.cdn77.org,legit,3.77206,1,8,24,0,0.125,0.15717,3,1,0,0,4,1,0,0,0,1
2629,bf.dynatrace.com,legit,3.625,4,10,16,0,0.4,0.22656,4,0,0,0,4,5,3,1,0,9
1908,hotmail.com,legit,3.0958,4,6,11,0,0.66667,0.28144,1,0,0,0,1,1,0,0,0,1
8037,xpkfcgrm.cx,dga,3.0958,0,10,11,1,0.0,0.28144,0,0,0,0,0,0,0,0,0,0
900,app.snapchat.com,legit,3.15564,4,10,16,0,0.4,0.19723,4,1,0,0,5,1,1,0,0,2
4534,openai.com,legit,3.12193,5,4,10,0,1.25,0.31219,1,0,0,0,1,1,0,0,0,1
9864,xbevgeesd.com,dga,3.33468,4,8,13,1,0.5,0.25651,2,0,0,0,2,3,0,0,0,3
7009,rdrsscvjw.su,dga,3.02206,1,10,12,1,0.1,0.25184,0,0,0,0,0,0,0,0,0,0
6453,puryxuq.com,dga,3.27761,3,7,11,1,0.42857,0.29796,0,0,0,0,0,0,0,0,0,0
4976,app.hubspot.com,legit,3.32323,4,9,15,0,0.44444,0.22155,3,1,0,0,4,0,0,0,0,0
7484,meefobblffbaamcc.de,dga,3.18137,6,12,19,1,0.5,0.16744,1,0,0,0,1,1,0,0,0,1
7964,wusdtlswluut.com,dga,3.20282,4,11,16,1,0.36364,0.20018,1,0,0,0,1,0,0,0,0,0
2005,events.bouncex.net,legit,3.2391,6,10,18,0,0.6,0.17995,5,1,0,0,6,3,2,0,0,5
4402,dscapi6.akamai.net,legit,3.50326,7,8,18,0,0.875,0.19463,6,4,4,3,17,3,0,0,0,3
3467,riskified.com,legit,3.33468,5,7,13,0,0.71429,0.25651,1,0,0,0,1,3,1,0,0,4
7828,uenllmlcyhskkktso.tw,dga,3.64644,3,16,20,1,0.1875,0.18232,1,0,0,0,1,1,0,0,0,1
9817,8y42gig64q4i.org,dga,3.28064,3,6,16,1,0.5,0.20504,0,0,0,0,0,0,0,0,0,0
4873,cdc.carbonblack.io,legit,3.28104,5,11,18,0,0.45455,0.18228,3,0,0,0,3,5,0,0,0,5
2719,roku.com,legit,2.75,3,4,8,0,0.75,0.34375,1,0,0,0,1,0,0,0,0,0
4716,statsf-tm.everesttech.net,legit,3.28888,6,16,25,0,0.375,0.13156,7,0,0,0,7,9,4,0,0,13
9796,wyvgijkeuf.com,dga,3.80735,4,9,14,1,0.44444,0.27195,0,0,0,0,0,0,0,0,0,0
969,partner.googleadservices.com,legit,3.82486,10,16,28,0,0.625,0.1366,10,7,5,5,27,9,2,1,0,12
5522,xudosawo.ru,dga,3.0958,5,5,11,1,1.0,0.28144,0,0,0,0,0,0,0,0,0,0
5534,hbhqakdex.com.ng,dga,3.75,3,11,16,1,0.27273,0.23438,2,2,1,0,5,3,2,1,0,6
7730,gaporderavoidbikedetailair.com,dga,3.73957,14,15,30,1,0.93333,0.12465,5,0,0,0,5,8,0,0,0,8
2407,criteo-partners.tremorhub.com,legit,3.75887,9,17,29,0,0.52941,0.12962,6,0,0,0,6,9,1,0,0,10
7422,milkenjoy.net,dga,3.39275,4,8,13,1,0.5,0.26098,2,0,0,0,2,2,0,0,0,2
725,myanalytics.cdn.office.net,legit,3.69026,7,16,26,0,0.4375,0.14193,8,6,5,3,22,5,0,0,0,5
1109,aws.duplex.snapchat.com,legit,3.84922,6,14,23,0,0.42857,0.16736,6,1,0,0,7,3,1,0,0,4
5445,coachcontributemachineconsider.com,dga,3.68233,13,20,34,1,0.65,0.1083,7,1,0,0,8,14,2,0,1,17
3712,y.one.impact-ad.jp,legit,3.68354,5,9,18,0,0.55556,0.20464,3,0,0,0,3,3,1,0,0,4
2942,amplify.outbrain.com,legit,3.82193,7,11,20,0,0.63636,0.1911,6,0,0,0,6,3,0,0,0,3
1774,us.gts.ttoverseaus.net,legit,3.20899,7,12,22,0,0.58333,0.14586,6,0,0,0,6,4,3,0,0,7
6549,qrixfgnquidn.net,dga,3.45282,4,11,16,1,0.36364,0.2158,1,0,0,0,1,2,0,0,0,2
1426,app.slack.com,legit,3.08506,3,8,13,0,0.375,0.23731,3,1,0,0,4,2,0,0,0,2
7050,josephinecheyanne.net,dga,3.36329,8,12,21,1,0.66667,0.16016,2,0,0,0,2,5,1,0,0,6
3024,logs.roku.com,legit,3.18083,4,7,13,0,0.57143,0.24468,3,0,0,0,3,0,0,0,0,0
9531,lckkhdehxmts.com,dga,3.5,2,13,16,1,0.15385,0.21875,0,0,0,0,0,1,0,0,0,1
2171,pull-flv-l10-va01.tiktokcdn.com.rocket-cdn.com,legit,4.10792,8,26,46,0,0.30769,0.0893,7,10,12,10,39,5,2,1,0,8
4452,push-rtmp-l77-va01.tiktokcdn.com,legit,4.26532,5,18,32,0,0.27778,0.13329,5,6,7,8,26,2,0,0,0,2
6672,pointabout.net,dga,3.18201,6,7,14,1,0.85714,0.22729,4,0,0,0,4,2,0,0,0,2
3143,archive-digger.com,legit,3.61437,6,10,18,0,0.6,0.2008,2,0,0,0,2,4,0,0,0,4
5826,eboa.com.pt,dga,3.0958,4,5,11,1,0.8,0.28144,2,2,1,0,5,2,2,1,0,5
7236,x67ct2zglyjk.net,dga,3.875,1,11,16,1,0.09091,0.24219,0,0,0,0,0,0,0,0,0,0
8886,foadqanuleqiewe.ddns.net,dga,3.60539,9,13,24,1,0.69231,0.15022,5,1,0,0,6,6,4,3,2,15
1295,ssum.casalemedia.com,legit,3.30869,8,10,20,0,0.8,0.16543,3,0,0,0,3,6,0,0,0,6
7732,jononiru.ru,dga,2.73216,5,5,11,1,1.0,0.24838,1,0,0,0,1,2,0,0,0,2
6362,buddyprintstickmisssiteresult.com,dga,3.8441,9,23,33,1,0.3913,0.11649,11,0,0,0,11,15,4,0,0,19
8982,uwwohus.com,dga,2.91398,4,6,11,1,0.66667,0.26491,1,0,0,0,1,0,0,0,0,0
862,unpkg.com,legit,3.16993,2,6,9,0,0.33333,0.35221,0,0,0,0,0,0,0,0,0,0
100,windows.com,legit,3.0958,3,7,11,0,0.42857,0.28144,1,0,0,0,1,2,0,0,0,2
2974,box.net,legit,2.80735,2,4,7,0,0.5,0.40105,0,0,0,0,0,0,0,0,0,0
8347,eagkjqmsei.com,dga,3.52164,5,8,14,1,0.625,0.25155,2,0,0,0,2,2,0,0,0,2
7904,feuwfxxulszt.com,dga,3.625,4,11,16,1,0.36364,0.22656,0,0,0,0,0,0,0,0,0,0
3319,vast.adsafeprotected.com,legit,3.57393,8,14,24,0,0.57143,0.14891,8,2,0,0,10,5,1,0,0,6
8767,rkfnjfqqwfmphleafztdce.com,dga,4.08506,4,21,26,1,0.19048,0.15712,3,0,0,0,3,3,0,0,0,3
9706,licentiosaepromissionem.com,dga,3.48583,12,14,27,1,0.85714,0.1291,10,3,0,0,13,11,5,0,0,16
2920,gslb.rocket-cdn.com,legit,3.78714,3,13,19,0,0.23077,0.19932,3,1,0,0,4,2,0,0,0,2
5419,avhevupauxex.ddns.net,dga,3.49923,7,12,21,1,0.58333,0.16663,2,1,0,0,3,4,3,2,1,10
489,msftauth.net,legit,3.18872,3,8,12,0,0.375,0.26573,1,0,0,0,1,1,0,0,0,1
6304,bxigdnmpcb.com,dga,3.37878,2,11,14,1,0.18182,0.24134,1,0,0,0,1,1,0,0,0,1
4919,tag.crsspxl.com,legit,3.50689,2,11,15,0,0.18182,0.23379,3,0,0,0,3,1,0,0,0,1
7410,apmymvgshjaakgumm.cc,dga,3.48418,4,15,20,1,0.26667,0.17421,1,0,0,0,1,0,0,0,0,0
4541,rum-collector-2.pingdom.net,legit,3.91211,7,15,27,0,0.46667,0.14489,4,0,0,0,4,6,1,0,0,7
1082,us-east4-gcp.api.snapchat.com,legit,3.78834,8,15,29,0,0.53333,0.13063,8,3,1,0,12,4,1,0,0,5
818,e17437.dsct.akamaiedge.net,legit,3.79622,8,10,26,0,0.8,0.14601,7,5,5,3,20,5,0,0,0,5
2954,ad.tpmn.co.kr,legit,3.33468,2,8,13,0,0.25,0.25651,5,1,0,0,6,1,1,0,0,2
2403,dns-test1.hola.org,legit,3.72548,4,10,18,0,0.4,0.20697,4,1,0,0,5,6,2,1,0,9
3188,array609.prod.do.dsp.mp.microsoft.com,legit,3.71259,8,20,37,0,0.4,0.10034,12,12,10,9,43,5,2,0,0,7
2447,msn.com.edgekey.net,legit,3.36609,5,11,19,0,0.45455,0.17716,4,5,3,1,13,4,2,1,0,7
4144,e3925.dscx.akamaiedge.net,legit,3.86347,8,10,25,0,0.8,0.15454,7,5,5,3,20,5,0,0,0,5
6426,fetjouexcsmpj.com,dga,3.49923,5,11,17,1,0.45455,0.20584,1,0,0,0,1,1,0,0,0,1
7280,sanitasistumecclesie.com,dga,3.40727,10,13,24,1,0.76923,0.14197,4,0,0,0,4,11,2,0,0,13
2226,prod.nexusrules.live.com.akadns.net,legit,3.95444,11,19,35,0,0.57895,0.11298,14,9,9,9,41,8,4,1,0,13
9667,iqeigiqswakgemwk.org,dga,3.44644,7,12,20,1,0.58333,0.17232,1,0,0,0,1,2,0,0,0,2
1789,b-msedge.net,legit,3.18872,3,7,12,0,0.42857,0.26573,3,2,1,0,6,3,0,0,0,3
8161,ywqjeoueanxws.co.uk,dga,3.72161,7,10,19,1,0.7,0.19587,5,1,0,0,6,3,1,0,0,4
2316,t8.dropbox.com,legit,3.32486,3,8,14,0,0.375,0.23749,2,0,0,0,2,1,0,0,0,1
9257,ceiiuuksgoykyoog.org,dga,3.28418,9,10,20,1,0.9,0.16421,2,1,0,0,3,1,0,0,0,1
2240,31-courier.push.apple.com,legit,3.86347,8,11,25,0,0.72727,0.15454,9,4,3,2,18,4,0,0,0,4
5981,serviceothers.com,dga,3.33718,6,10,17,1,0.6,0.1963,4,2,1,1,8,4,4,2,0,10
6991,ciwotsi.com,dga,2.91398,4,6,11,1,0.66667,0.26491,0,0,0,0,0,1,0,0,0,1
4074,us.e-planning.net,legit,3.38158,5,9,17,0,0.55556,0.19892,4,0,0,0,4,4,1,0,0,5
294,3lift.com,legit,3.16993,2,5,9,0,0.4,0.35221,1,0,0,0,1,0,0,0,0,0
8009,vkdplloyvykcpksfffab.com,dga,3.68872,3,20,24,1,0.15,0.1537,2,0,0,0,2,0,0,0,0,0
8122,wskacgeumqoymkim.org,dga,3.78418,6,13,20,1,0.46154,0.18921,1,0,0,0,1,2,0,0,0,2
8265,sjmdkkvqeqhwmstmw.com,dga,3.63041,2,18,21,1,0.11111,0.17288,1,0,0,0,1,1,0,0,0,1
3096,ags.trafficmanager.net,legit,3.45943,7,13,22,0,0.53846,0.15725,7,3,1,3,14,6,1,0,0,7
3643,d1.sc.omtrdc.net,legit,3.32782,2,10,16,0,0.2,0.20799,0,0,0,0,0,1,0,0,0,1
2547,dual-s-ring.msedge.net,legit,3.69785,6,12,22,0,0.5,0.16808,5,2,1,0,8,5,2,0,0,7
2473,dl-debug.dropbox.com,legit,3.64644,5,12,20,0,0.41667,0.18232,2,0,0,0,2,2,0,0,0,2
5646,indulgentieecclesie.com,dga,3.43141,10,12,23,1,0.83333,0.14919,7,1,0,0,8,9,1,0,0,10
8133,q8m6m0wnmfe8grox3vk4slu.ddns.net,dga,4.39032,4,20,32,1,0.2,0.1372,3,1,0,0,4,4,3,3,2,12
230,cdnjs.cloudflare.com,legit,3.68418,5,13,20,0,0.38462,0.18421,7,4,3,2,16,4,0,0,0,4
8922,aeiugkwgwmeuiaew.org,dga,3.30869,10,9,20,1,1.11111,0.16543,0,0,0,0,0,0,0,1,0,1
2722,sundaysky.com,legit,3.39275,3,9,13,0,0.33333,0.26098,0,0,0,0,0,2,0,0,0,2
3628,a1834.dscg2.akamai.net,legit,3.87966,6,8,22,0,0.75,0.17635,5,3,4,3,15,3,0,0,0,3
3649,miui.com,legit,2.5,4,3,8,0,1.33333,0.3125,1,0,0,0,1,1,0,0,0,1
8212,siryfyby.info,dga,3.02699,3,9,13,1,0.33333,0.23285,0,0,0,0,0,1,0,0,0,1
7167,n75hbk7tfgmi427b6x.com,dga,4.06148,2,12,22,1,0.16667,0.18461,1,0,0,0,1,1,0,0,0,1
1514,s.innovid.com,legit,3.08506,4,7,13,0,0.57143,0.23731,2,0,0,0,2,1,0,0,0,1
2012,dev-prod05.conferdeploy.net,legit,3.81008,7,15,27,0,0.46667,0.14111,8,4,1,0,13,4,3,0,0,7
4996,transcend.io,legit,3.4183,4,7,12,0,0.57143,0.28486,3,0,0,0,3,6,2,0,0,8
9321,fgboxxmtgfil.bit,dga,3.25,3,12,16,1,0.25,0.20312,0,0,0,0,0,0,0,0,0,0
6455,vimpkuwekcyplewhb.pw,dga,3.64644,4,15,20,1,0.26667,0.18232,2,1,0,0,3,1,0,0,0,1
2156,bytedance.map.fastly.net,legit,3.62581,6,15,24,0,0.4,0.15108,9,1,0,0,10,7,1,1,0,9
1874,blob.weather.microsoft.com,legit,3.74833,8,15,26,0,0.53333,0.14417,10,8,7,6,31,5,1,1,1,8
6943,pujelil.info,dga,3.25163,5,6,12,1,0.83333,0.27097,1,0,0,0,1,1,0,0,0,1
482,gsp64-ssl.ls.apple.com,legit,3.4474,3,13,22,0,0.23077,0.1567,6,4,3,2,15,1,0,0,0,1
518,sync.mathtag.com,legit,3.375,3,11,16,0,0.27273,0.21094,4,0,0,0,4,3,0,0,0,3
9764,acfabcbdbmdkdafo.com,dga,3.07095,5,14,20,1,0.35714,0.15355,0,0,0,0,0,1,0,0,0,1
8354,rzxaxlaembia.com,dga,3.45282,6,9,16,1,0.66667,0.2158,0,0,0,0,0,2,0,0,0,2
4055,officecdn.microsoft.com,legit,3.36031,7,14,23,0,0.5,0.1461,9,14,11,8,42,5,0,0,0,5
515,mrodevicemgr.officeapps.live.com,legit,3.75705,11,18,32,0,0.61111,0.11741,9,6,4,3,22,6,0,0,0,6
6010,hpsdvcjehyqxcvjr.eu,dga,3.72161,3,15,19,1,0.2,0.19587,0,0,0,0,0,0,0,0,0,0
6412,gp54qdebc6krgp7.ddns.net,dga,3.97018,2,16,24,1,0.125,0.16542,2,1,0,0,3,5,3,3,2,13
6081,yirkehvunnsjkkqi.com,dga,3.88418,5,14,20,1,0.35714,0.19421,0,0,0,0,0,1,0,0,0,1
2903,wss-primary.slack.com,legit,3.6897,4,14,21,0,0.28571,0.1757,2,0,0,0,2,5,0,0,0,5
480,m.media-amazon.com,legit,3.2391,7,8,18,0,0.875,0.17995,5,1,3,2,11,4,0,0,0,4
4788,delivery-cdn-cf.adswizz.com,legit,4.0323,6,17,27,0,0.35294,0.14934,7,1,0,0,8,5,1,0,0,6
6461,i55jymwnqa57arg33oycsc39d30kwe41nsbsg53.biz,dga,4.48755,6,22,43,1,0.27273,0.10436,0,0,0,0,0,2,0,0,0,2
2691,x3-predictor.goguardian.com,legit,3.95823,9,14,27,0,0.64286,0.1466,4,1,0,0,5,6,0,0,0,6
6775,3tmdmjk0ip7lmp3.ddns.net,dga,3.77206,2,16,24,1,0.125,0.15717,2,1,0,0,3,4,3,2,2,11
8002,cuubimetceuwcoo.ddns.net,dga,3.57393,9,13,24,1,0.69231,0.14891,5,1,0,0,6,7,4,3,2,16
3688,logincdn.msftauth.net,legit,3.84423,5,14,21,0,0.35714,0.18306,6,2,1,0,9,3,0,0,0,3
5074,xvctydfxovhxfjkotaii.xxx,dga,3.52206,5,18,24,1,0.27778,0.14675,1,0,0,0,1,1,0,0,0,1
8039,meriwetherstrudwick.net,dga,3.58835,7,15,23,1,0.46667,0.15602,3,0,0,0,3,5,3,1,0,9
5211,5sjvkp7f1k8jobaqyo.biz,dga,4.0958,4,13,22,1,0.30769,0.18617,0,0,0,0,0,0,0,0,0,0
8805,leaguesuckcycledogcarpet.com,dga,3.74987,10,17,28,1,0.58824,0.13392,4,0,0,0,4,8,0,0,0,8
8717,foqakah.info,dga,3.08496,5,6,12,1,0.83333,0.25708,0,1,0,0,1,0,0,0,0,0
943,pull-w5-sg01.tiktokcdn.com,legit,4.16198,4,15,26,0,0.26667,0.16008,4,6,9,9,28,2,0,0,0,2
801,bootstrap.endpoint.ingress.rapid7.com,legit,3.8438,11,21,37,0,0.52381,0.10389,12,1,0,0,13,7,4,0,0,11
3508,geo.clients.config.office.akadns.net,legit,3.65245,12,19,36,0,0.63158,0.10146,15,10,8,6,39,8,4,0,0,12
4406,match.bnmla.com,legit,3.1899,3,10,15,0,0.3,0.21266,2,0,0,0,2,3,0,0,0,3
4598,zqtk.net,legit,2.75,1,6,8,0,0.16667,0.34375,0,0,0,0,0,0,0,0,0,0
9170,z8xylsm3ebfkbe7lcb.biz,dga,3.82307,3,15,22,1,0.2,0.17378,0,0,0,0,0,1,0,0,0,1
5690,dgadxnqlyxtxlgnjg.in,dga,3.40869,2,17,20,1,0.11765,0.17043,1,0,0,0,1,0,0,0,0,0
4893,siftscience.com,legit,3.1899,5,9,15,0,0.55556,0.21266,2,0,0,0,2,3,1,1,0,5
3291,calendar-pa.clients6.google.com,legit,3.90486,10,16,31,0,0.625,0.12596,6,6,4,3,19,5,1,0,0,6
7184,eduwcbiifota.com,dga,3.625,7,8,16,1,0.875,0.22656,2,0,0,0,2,2,0,0,0,2
6648,q0qt7fmn1dqlsns2wx5.ddns.net,dga,3.86933,1,20,28,1,0.05,0.13819,2,1,0,0,3,4,3,2,2,11
4330,onedscolprduks05.uksouth.cloudapp.azure.com,legit,4.02536,14,23,43,0,0.6087,0.09361,13,4,3,4,24,5,1,0,0,6
412,gspe35-ssl.ls.apple.com,legit,3.46858,4,13,23,0,0.30769,0.15081,6,4,3,2,15,1,0,0,0,1
9733,e41grj36eqd20o11cwptbwkxnqayd60a27nsmq.info,dga,4.72244,7,23,43,1,0.30435,0.10982,0,0,0,0,0,1,0,0,0,1
4401,centrastage.net,legit,3.00624,5,9,15,0,0.55556,0.20042,7,3,0,0,10,7,2,0,0,9
9918,m55qltwg4o4137l528.biz,dga,4.06148,2,9,22,1,0.22222,0.18461,0,0,0,0,0,0,0,0,0,0
7127,gvpbucwbx.tj,dga,3.4183,1,10,12,1,0.1,0.28486,0,0,0,0,0,0,0,0,0,0
1999,entitlement.diagnostics.office.com,legit,3.64571,12,19,34,0,0.63158,0.10723,10,5,4,3,22,9,1,0,0,10
7175,cwhihkdsholapet.com,dga,3.78714,5,13,19,1,0.38462,0.19932,2,0,0,0,2,2,0,5,5,12
4704,us.shb-sync.com,legit,3.32323,2,10,15,0,0.2,0.22155,2,0,0,0,2,0,0,0,0,0
2154,teams.office.com,legit,3.25,6,8,16,0,0.75,0.20312,7,4,4,3,18,5,0,0,0,5
5729,lofafdnemocoabaf.com,dga,3.24644,8,11,20,1,0.72727,0.16232,4,0,0,0,4,4,0,0,0,4
3488,play.samsungcloud.com,legit,3.63041,6,13,21,0,0.46154,0.17288,4,3,2,1,10,3,0,0,0,3
1173,ce.apple-dns.net,legit,3.32782,4,9,16,0,0.44444,0.20799,8,5,3,2,18,4,1,0,0,5
4422,api.userway.org,legit,3.50689,6,7,15,0,0.85714,0.23379,5,2,1,0,8,2,1,0,0,3
2246,34-courier.push.apple.com,legit,3.86347,8,11,25,0,0.72727,0.15454,9,4,3,2,18,4,0,0,0,4
6331,gadyfoz.com,dga,3.27761,3,7,11,1,0.42857,0.29796,1,0,0,0,1,0,0,0,0,0
9848,degreeshoulder.net,dga,3.30272,7,10,18,1,0.7,0.18348,4,0,0,0,4,4,0,0,0,4
886,sessions.bugsnag.com,legit,3.34145,6,12,20,0,0.5,0.16707,4,0,0,0,4,5,2,0,0,7
6731,cloudwash.net,dga,3.70044,4,8,13,1,0.5,0.28465,2,3,2,1,8,1,0,0,0,1
324,slscr.update.microsoft.com,legit,3.73815,7,16,26,0,0.4375,0.14378,9,8,7,6,30,4,1,0,0,5
6179,qpbeiyxvknytifqjb.cc,dga,3.82193,3,16,20,1,0.1875,0.1911,1,0,0,0,1,2,0,0,0,2
6837,qucrasseasconcioformat.com,dga,3.56545,10,15,26,1,0.66667,0.13713,9,1,0,0,10,9,2,0,0,11
1779,richaudience.com,legit,3.45282,7,8,16,0,0.875,0.2158,3,0,0,0,3,4,2,1,0,7
3194,api.company-target.com,legit,3.69785,7,12,22,0,0.58333,0.16808,6,3,2,0,11,7,2,1,0,10
203,dpm.demdex.net,legit,2.84237,3,9,14,0,0.33333,0.20303,1,0,0,0,1,3,0,0,0,3
6246,damagerequestbraingrablift.com,dga,3.9899,11,18,30,1,0.61111,0.133,10,2,0,0,12,9,3,0,0,12
8168,8kbjc2rrdwl8aifk6v.com,dga,4.0958,3,14,22,1,0.21429,0.18617,0,0,0,0,0,0,0,0,0,0
3296,www-alv.google-analytics.com,legit,3.84237,8,16,28,0,0.5,0.13723,4,5,4,3,16,4,0,0,0,4
9871,qauiqyej.com,dga,3.4183,5,6,12,1,0.83333,0.28486,0,0,0,0,0,0,0,0,0,0
8006,articulumauvelfacile.com,dga,3.54248,11,12,24,1,0.91667,0.1476,4,0,0,0,4,8,0,0,0,8
9600,omumbeobh.ddns.net,dga,3.39215,5,11,18,1,0.45455,0.18845,2,1,0,0,3,6,3,2,2,13
4064,tm.v4.a.prd.aadg.akadns.net,legit,3.42621,6,14,27,0,0.42857,0.1269,5,4,4,3,16,2,1,0,0,3
9886,sicquoillampubedificari.com,dga,3.77842,12,14,27,1,0.85714,0.13994,3,1,0,0,4,9,0,0,0,9
8132,ulsmnjguvrxouu.com,dga,3.50326,6,11,18,1,0.54545,0.19463,1,0,0,0,1,0,0,0,0,0
9136,forwardreceive.net,dga,3.46132,7,10,18,1,0.7,0.1923,2,0,0,0,2,6,0,0,0,6
5345,ffadbfabebflmdck.com,dga,3.28418,4,15,20,1,0.26667,0.16421,1,0,0,0,1,1,0,0,0,1
3544,fast.a.klaviyo.com,legit,3.53049,6,9,18,0,0.66667,0.19614,2,1,0,0,3,3,0,0,0,3
6701,rdqucdkwwckaeriam.cc,dga,3.42193,5,14,20,1,0.35714,0.1711,3,0,0,0,3,3,1,0,0,4
5305,sksyiciugcooimuo.org,dga,3.28418,9,10,20,1,0.9,0.16421,3,0,0,0,3,2,0,0,0,2
8495,royvwpmmpyir.su,dga,3.37356,3,11,15,1,0.27273,0.2249,1,0,0,0,1,0,0,0,0,0
8,ctldl.windowsupdate.com,legit,3.79509,6,15,23,0,0.4,0.165,3,0,0,0,3,5,1,0,0,6
9284,q67re8idupudgbmps0kxe2k.ddns.net,dga,4.22641,6,19,32,1,0.31579,0.13208,3,1,0,0,4,5,3,2,2,12
4724,squarespace.com,legit,3.37356,6,8,15,0,0.75,0.2249,3,0,0,0,3,5,1,0,0,6
6833,nd6kbz4vl7ryjbvs51.ru,dga,4.1066,1,14,21,1,0.07143,0.19555,0,0,0,0,0,1,0,0,0,1
8397,southpast.net,dga,3.18083,4,8,13,1,0.5,0.24468,2,1,0,0,3,2,0,0,0,2
2567,pull-flv-f10-gcp01.tiktokcdn.com.rocket-cdn.com,legit,4.11258,7,28,47,0,0.25,0.0875,7,10,12,10,39,5,2,1,0,8
4640,scontent-lga3-1.xx.fbcdn.net,legit,3.89629,4,17,28,0,0.23529,0.13915,7,3,0,0,10,5,2,0,0,7
2373,i.lencr.org,legit,3.0958,3,6,11,0,0.5,0.28144,3,0,0,0,3,2,0,0,0,2
4667,fp-afd.azureedge.net,legit,3.52193,7,10,20,0,0.7,0.1761,5,2,1,2,10,3,0,0,0,3
7078,xhxueoojuwyhbgz.com,dga,3.68188,6,12,19,1,0.5,0.19378,1,0,0,0,1,0,0,0,0,0
8290,ypupmbwjy0qfg0gpax7.ddns.net,dga,4.20897,3,20,28,1,0.15,0.15032,2,1,0,0,3,4,3,3,2,12
3791,microsoft.com-c-3.edgekey.net.globalredir.akadns.net,legit,4.13219,15,28,52,0,0.53571,0.07947,14,14,12,8,48,11,3,1,0,15
5549,uskuka.biz,dga,2.92193,4,5,10,1,0.8,0.29219,1,0,0,0,1,0,0,0,0,0
8893,gl27c923kpev.top,dga,3.75,2,8,16,1,0.25,0.23438,0,0,0,0,0,0,0,0,0,0
3147,www.google.co.uk,legit,2.98346,5,8,16,0,0.625,0.18647,5,6,4,3,18,2,1,0,0,3
3815,reachms.bfmio.com,legit,3.45482,5,10,17,0,0.5,0.20322,4,0,0,0,4,4,0,0,0,4
6749,qhglimiqvyxw.biz,dga,3.57782,3,12,16,1,0.25,0.22361,2,0,0,0,2,1,0,0,0,1
8298,703hm4if5rc03vybu4i.ddns.net,dga,4.30735,4,14,28,1,0.28571,0.15383,2,1,0,0,3,4,4,3,2,13
9963,masuhik.info,dga,3.4183,5,6,12,1,0.83333,0.28486,1,0,0,0,1,3,0,0,0,3
9102,msnbopdvwzpkitftedwx.com,dga,4.08496,4,19,24,1,0.21053,0.17021,2,0,0,0,2,3,0,0,0,3
8991,study-increased.gs,dga,3.68354,5,11,18,1,0.45455,0.20464,7,0,0,0,7,7,0,0,0,7
4896,login-ds.dotomi.com,legit,3.40582,6,10,19,0,0.6,0.17925,6,0,0,0,6,4,0,0,0,4
3022,router.infolinks.com,legit,3.68418,7,11,20,0,0.63636,0.18421,6,0,0,0,6,3,1,0,0,4
5017,bqlqscpqwsh.dynserv.com,dga,3.93618,2,19,23,1,0.10526,0.17114,3,1,1,0,5,4,5,5,4,18
7035,uka82s24m8yw.net,dga,3.75,3,7,16,1,0.42857,0.23438,0,0,0,0,0,0,0,0,0,0
7351,pktqjgn.com,dga,3.45943,1,9,11,1,0.11111,0.31449,0,0,0,0,0,0,0,0,0,0
5653,ybghttelxyri.biz,dga,3.5,3,12,16,1,0.25,0.21875,1,0,0,0,1,3,0,0,0,3
1805,usersync.gumgum.com,legit,3.32636,5,12,19,0,0.41667,0.17507,3,1,0,0,4,2,2,0,0,4
6712,iddumiggo.com,dga,2.93121,5,7,13,1,0.71429,0.22548,1,0,0,0,1,2,0,0,0,2
2675,static.vidazoo.com,legit,3.35021,7,9,18,0,0.77778,0.18612,6,0,0,0,6,5,1,0,0,6
7145,ujqxtmlopkku.biz,dga,3.75,4,11,16,1,0.36364,0.23438,1,0,0,0,1,0,0,0,0,0
5576,vonokam.info,dga,3.02206,5,6,12,1,0.83333,0.25184,2,0,0,0,2,2,0,0,0,2
2646,a.vidoomy.com,legit,3.02699,5,6,13,0,0.83333,0.23285,1,0,0,0,1,1,0,0,0,1
1273,d.akamaiedge.net,legit,3.15564,7,7,16,0,1.0,0.19723,6,5,5,3,19,4,0,0,0,4
238,init.push.apple.com,legit,3.64215,6,10,19,0,0.6,0.19169,7,4,3,2,16,4,0,0,0,4
2006,bytetcdn.com,legit,3.25163,2,9,12,0,0.22222,0.27097,3,1,0,0,4,3,0,0,0,3
7509,ivtkgkmbai.com,dga,3.37878,4,9,14,1,0.44444,0.24134,0,0,0,0,0,0,0,0,0,0
7744,hapezyz.info,dga,3.4183,4,7,12,1,0.57143,0.28486,1,0,0,0,1,0,0,0,0,0
6811,gtodczhc.com.ar,dga,3.32323,3,10,15,1,0.3,0.22155,2,2,1,0,5,2,2,1,0,5
6474,mbadcbacfmnbmbbe.eu,dga,3.07085,5,13,19,1,0.38462,0.16162,1,0,0,0,1,2,0,0,0,2
1445,cdn.confiant-integrations.net,legit,3.53851,9,17,29,0,0.52941,0.12202,11,4,1,0,16,10,5,3,1,19
3979,geo.query.yahoo.com,legit,3.36609,8,8,19,0,1.0,0.17716,3,0,0,1,4,2,0,0,0,2
9472,wifilrug.ru,dga,2.91398,4,6,11,1,0.66667,0.26491,0,0,0,0,0,0,0,0,0,0
8379,kummyaiq.biz,dga,3.25163,4,7,12,1,0.57143,0.27097,0,0,0,0,0,0,0,0,0,0
9036,sightaugust.net,dga,3.1899,5,9,15,1,0.55556,0.21266,3,0,0,0,3,3,0,0,0,3
4509,itunes.apple.com.edgesuite.net,legit,3.6314,12,14,30,0,0.85714,0.12105,13,9,6,4,32,10,2,1,0,13
8485,soceocan.ru,dga,3.0958,5,5,11,1,1.0,0.28144,1,0,0,0,1,3,0,0,0,3
3333,telemetry.microsoft.com,legit,3.43576,7,14,23,0,0.5,0.14938,8,8,7,6,29,7,0,0,0,7
7314,lriffd.yi.org,dga,3.08506,3,8,13,1,0.375,0.23731,1,0,0,0,1,1,0,0,0,1
2821,a2047.mm3.akamai.net,legit,3.44644,6,6,20,0,1.0,0.17232,4,3,4,3,14,2,0,0,0,2
9302,youconfessionalia.com,dga,3.53517,10,10,21,1,1.0,0.16834,5,1,0,0,6,4,3,0,0,7
5100,j4dirwtunwta.com,dga,3.75,4,10,16,1,0.4,0.23438,1,0,0,0,1,1,0,0,0,1
7600,nonlargitasnullopenitens.com,dga,3.69595,10,17,28,1,0.58824,0.132,5,0,0,0,5,10,1,0,0,11
8856,ppuggixbfyvmueh.com,dga,3.82687,5,13,19,1,0.38462,0.20141,1,0,0,0,1,0,0,0,0,0
10,cloud.netflix.com,legit,3.61687,5,10,17,0,0.5,0.21276,4,3,2,1,10,2,0,0,0,2
717,us.criteo.net,legit,3.2389,5,6,13,0,0.83333,0.24915,5,0,0,0,5,3,0,0,0,3
8656,qkyokxjktmhzve.org,dga,3.79465,3,14,18,1,0.21429,0.21081,0,0,0,0,0,1,0,0,0,1
4060,ocsp.rootg2.amazontrust.com,legit,3.60232,8,15,27,0,0.53333,0.13342,10,1,3,3,17,4,0,0,0,4
607,api.iris.microsoft.com,legit,3.2999,8,11,22,0,0.72727,0.15,9,9,8,6,32,4,1,0,0,5
3456,eset.com,legit,2.75,3,4,8,0,0.75,0.34375,2,0,0,0,2,3,0,0,0,3
8623,organizationexitreference.com,dga,3.59491,13,15,29,1,0.86667,0.12396,7,0,0,0,7,12,6,3,1,22
2653,onedscolprdeus13.eastus.cloudapp.azure.com,legit,3.89185,15,21,42,0,0.71429,0.09266,17,5,3,4,29,9,1,0,0,10
3139,assets.jivox.com,legit,3.45282,5,9,16,0,0.55556,0.2158,2,0,0,0,2,3,1,0,0,4
4133,crcdn01.adnxs-simple.com,legit,3.97018,4,15,24,0,0.26667,0.16542,7,2,0,0,9,3,0,0,0,3
4147,newyorker.com,legit,3.2389,4,8,13,0,0.5,0.24915,1,0,0,0,1,3,0,0,0,3
347,nelreports.net,legit,3.03915,4,9,14,0,0.44444,0.21708,1,0,0,0,1,4,0,0,0,4
3552,hb.minutemedia-prebid.com,legit,3.83327,9,13,25,0,0.69231,0.15333,7,1,0,0,8,6,0,0,0,6
22,clientservices.googleapis.com,legit,3.71938,11,16,29,0,0.6875,0.12825,14,9,5,5,33,9,3,1,0,13
651,amp-api-edge.apps.apple.com,legit,3.38379,9,13,27,0,0.69231,0.12533,11,7,4,2,24,4,0,0,0,4
9431,dr3dfwnz3vhy5yu3g5.ru,dga,3.6897,2,13,21,1,0.15385,0.1757,0,0,0,0,0,0,0,0,0,0
5011,gasozjom.ru,dga,3.27761,4,6,11,1,0.66667,0.29796,0,0,0,0,0,2,0,0,0,2
71,mtalk.google.com,legit,3.20282,5,9,16,0,0.55556,0.20018,3,5,4,3,15,2,0,0,0,2
4925,rum-static.pingdom.net,legit,3.87966,6,13,22,0,0.46154,0.17635,7,0,0,0,7,7,2,0,0,9
4910,tpt.dotomi.com,legit,2.84237,4,8,14,0,0.5,0.20303,2,0,0,0,2,3,0,0,0,3
9043,aendbofckfkaffdn.com,dga,3.32193,5,14,20,1,0.35714,0.1661,3,0,0,0,3,3,0,0,0,3
6961,sivuxos.info,dga,3.08496,5,6,12,1,0.83333,0.25708,0,0,0,0,0,1,0,0,0,1
9849,wkfbhertuvtoom.com,dga,3.68354,5,12,18,1,0.41667,0.20464,2,0,0,0,2,2,1,0,0,3
911,settings.services.mozilla.com,legit,3.74541,9,17,29,0,0.52941,0.12915,9,2,1,1,13,9,3,1,0,13
8147,xabugjfb.tl,dga,3.27761,2,8,11,1,0.25,0.29796,0,0,0,0,0,0,0,0,0,0
3644,dataservices.hp.com,legit,3.72161,6,11,19,0,0.54545,0.19587,8,2,1,1,12,8,2,1,0,11
4464,clickcertain.com,legit,3.375,5,10,16,0,0.5,0.21094,6,0,0,0,6,5,0,0,0,5
8748,ssxqggfqbex.cc,dga,3.09307,1,12,14,1,0.08333,0.22093,0,0,0,0,0,1,3,2,1,7
751,giphy.com,legit,3.16993,2,6,9,0,0.33333,0.35221,0,0,0,0,0,0,0,0,0,0
2750,imap.mail.g03.yahoodns.net,legit,3.90217,8,12,26,0,0.66667,0.15008,6,1,0,1,8,3,1,0,0,4
5532,whybi8cnmb34s0q.ddns.net,dga,4.05351,2,16,24,1,0.125,0.1689,2,1,0,0,3,4,3,3,2,12
3410,siteimproveanalytics.com,legit,3.80351,9,14,24,0,0.64286,0.15848,6,1,0,0,7,8,2,0,0,10
1645,anycast.adnxs.com,legit,3.33718,4,11,17,0,0.36364,0.1963,4,1,0,0,5,5,0,0,0,5
4840,server.agent-cluster2.prod.us001-prod.arcticwolf.net,legit,4.21979,13,28,52,0,0.46429,0.08115,14,7,4,2,27,10,6,1,0,17
9320,qlqvgwbahajq.info,dga,3.69012,4,12,17,1,0.33333,0.21707,0,0,0,0,0,0,0,0,0,0
6650,numberbehavebringplanrepair.com,dga,3.78437,11,19,31,1,0.57895,0.12208,4,0,0,0,4,8,2,0,2,12
2867,um.indexww.com.akadns.net,legit,3.73366,7,14,25,0,0.5,0.14935,6,6,7,7,26,7,3,1,0,11
2146,split.io,legit,2.75,3,4,8,0,0.75,0.34375,2,0,0,0,2,1,0,0,0,1
5242,think-district.by,dga,3.52806,3,12,17,1,0.25,0.20753,3,0,0,0,3,5,1,0,0,6
6658,hjfdxgbvqeroumwjw.pw,dga,3.98418,3,16,20,1,0.1875,0.19921,3,0,0,0,3,1,0,0,0,1
4535,pr-a.ybp.yahoo.com,legit,3.30827,5,9,18,0,0.55556,0.18379,3,0,0,1,4,0,0,0,0,0
2798,aralego.com,legit,3.0958,5,5,11,0,1.0,0.28144,2,0,0,0,2,3,0,0,0,3
7343,pqucvsaerpjdgavy.eu,dga,3.72161,6,12,19,1,0.5,0.19587,1,0,0,0,1,1,0,0,0,1
4141,forms.hubspot.com,legit,3.45482,4,11,17,0,0.36364,0.20322,1,0,0,0,1,1,0,0,0,1
3583,awmdm.com,legit,2.6416,2,6,9,0,0.33333,0.29351,0,0,0,0,0,0,0,0,0,0
2464,w185.akamai.net,legit,3.45656,5,5,15,0,1.0,0.23044,3,3,4,3,13,2,0,0,0,2
2985,gspe1-ssl.ls.apple.com.edgekey.net,legit,3.71602,8,19,34,0,0.42105,0.10929,11,9,6,4,30,5,2,1,0,8
1293,device-metrics-us-2.amazon.com,legit,3.93957,10,14,30,0,0.71429,0.13132,7,2,3,3,15,8,0,0,0,8
4056,nelsdf.measure.office.net,legit,3.63908,9,13,25,0,0.69231,0.14556,7,4,4,3,18,8,0,0,0,8
8687,5cp8gar2ud776wyjfy.biz,dga,4.27761,3,12,22,1,0.25,0.19444,0,0,0,0,0,1,0,0,0,1
5452,dkiuktvl.dynserv.com,dga,3.92193,4,14,20,1,0.28571,0.1961,3,1,1,0,5,4,5,5,4,18
6977,simonettecaulfield.net,dga,3.60694,9,12,22,1,0.75,0.16395,2,0,0,0,2,8,1,0,0,9
9465,nisupcaf.ru,dga,3.27761,4,6,11,1,0.66667,0.29796,0,0,0,0,0,4,0,0,0,4
1995,sdds3.sophosupd.com,legit,3.11583,4,12,19,0,0.33333,0.16399,1,0,0,0,1,2,0,0,0,2
137,delivery.mp.microsoft.com,legit,3.75327,7,15,25,0,0.46667,0.15013,9,8,7,7,31,6,1,0,0,7
6214,rickypaperback.gs,dga,3.49923,4,12,17,1,0.33333,0.20584,3,0,0,0,3,4,0,0,0,4
1695,ads.vungle.com,legit,3.6645,4,8,14,0,0.5,0.26175,4,1,0,0,5,1,0,0,0,1
7991,yxkn3lcl16wxsnix10un5f7.ddns.net,dga,4.17611,3,20,32,1,0.15,0.1305,2,1,0,0,3,5,3,3,2,13
989,pull-cmaf-f16-tt01.fcdn.us.tiktokv.com,legit,4.1357,6,21,38,0,0.28571,0.10883,7,7,7,4,25,3,0,0,0,3
8314,1vcv5ds6snkv7fifw2qt1bi.ddns.net,dga,4.09314,3,21,32,1,0.14286,0.12791,3,1,0,0,4,4,4,3,2,13
7595,a468qkqwis2s.net,dga,3.75,3,8,16,1,0.375,0.23438,0,0,0,0,0,1,0,0,0,1
2390,api.bounceexchange.com,legit,3.66353,9,11,22,0,0.81818,0.16652,5,1,1,0,7,3,2,0,0,5
7959,vcykhlbjbftgqgmu.eu,dga,3.93214,3,15,19,1,0.2,0.20695,0,0,0,0,0,0,0,0,0,0
9901,qojfryqfrk.com,dga,3.23593,2,11,14,1,0.18182,0.23114,0,0,0,0,0,0,0,0,0,0
9812,lulctsnlnbbdusr.im,dga,3.46132,3,14,18,1,0.21429,0.1923,1,0,0,0,1,0,0,0,0,0
2624,assets.clever.com,legit,3.29277,5,10,17,0,0.5,0.19369,5,0,0,0,5,6,2,0,0,8
522,virtualearth.net,legit,3.32782,6,9,16,0,0.66667,0.20799,2,0,0,0,2,3,0,0,0,3
3267,api.ring.com,legit,3.25163,4,6,12,0,0.66667,0.27097,3,1,1,0,5,2,2,0,0,4
2712,ms4.applovin.com,legit,3.5,4,9,16,0,0.44444,0.21875,6,3,2,1,12,1,0,0,0,1
7657,ykmlrvudgodlxua.co.uk,dga,3.6897,6,13,21,1,0.46154,0.1757,2,1,0,0,3,1,1,0,0,2
794,sc-cdn.net,legit,2.92193,1,7,10,0,0.14286,0.29219,2,1,0,0,3,1,0,0,0,1
3703,adformnet.akadns.net,legit,3.44644,6,12,20,0,0.5,0.17232,3,3,4,3,13,5,1,0,0,6
9279,cyvxqgilws.com,dga,3.6645,2,11,14,1,0.18182,0.26175,0,0,0,0,0,0,0,0,0,0
5664,ocsaeqafxeebih.ddns.net,dga,3.74095,8,13,23,1,0.61538,0.16265,2,1,0,0,3,4,3,2,2,11
121,dsce9.akamaiedge.net,legit,3.48418,8,9,20,0,0.88889,0.17421,7,5,5,3,20,5,0,0,0,5
4775,api.splashtop.com,legit,3.33718,5,10,17,0,0.5,0.1963,3,1,1,0,5,2,0,0,0,2
3271,pixels.ad.gt,legit,3.4183,3,7,12,0,0.42857,0.28486,4,0,0,0,4,1,0,0,0,1
9059,fdcokeadakmbbbnk.online,dga,3.55553,7,15,23,1,0.46667,0.15459,3,0,0,0,3,2,0,0,0,2
2427,device-api.urbanairship.com,legit,3.91211,11,13,27,0,0.84615,0.14489,4,2,1,0,7,4,0,0,0,4
2221,photosdata-pa.googleapis.com,legit,3.65148,11,14,28,0,0.78571,0.13041,7,6,4,4,21,5,0,0,0,5
6577,latigguri.com,dga,3.39275,5,7,13,1,0.71429,0.26098,2,0,0,0,2,4,1,0,0,5
883,a1818.dscw154.akamai.net,legit,3.77206,6,8,24,0,0.75,0.15717,5,3,4,3,15,3,0,0,0,3
8363,mciisiyssggusgeo.org,dga,3.18418,7,12,20,1,0.58333,0.15921,2,0,0,0,2,3,0,0,0,3
9606,lh67pi266a7h32xtbk.cn,dga,3.88018,2,10,21,1,0.2,0.18477,1,0,0,0,1,0,0,0,0,0
6169,guaficet.ddns.net,dga,3.49923,5,10,17,1,0.5,0.20584,4,3,1,0,8,7,3,2,1,13
433,config.fp.measure.office.com,legit,3.58362,10,14,28,0,0.71429,0.12799,10,5,4,3,22,8,1,0,0,9
8976,wmyaesiugkeq.net,dga,3.70282,6,9,16,1,0.66667,0.23143,1,0,0,0,1,2,0,3,2,7
6105,vvqmrxnlc.yi.org,dga,3.625,2,12,16,1,0.16667,0.22656,0,0,0,0,0,0,0,0,0,0
5572,ecjoehuenmogtndq.eu,dga,3.51109,8,10,19,1,0.8,0.18479,1,0,0,0,1,3,0,0,0,3
13,microsoftonline.com,legit,3.40582,7,11,19,0,0.63636,0.17925,8,7,6,5,26,5,1,0,0,6
3542,go.com,legit,2.25163,2,3,6,0,0.66667,0.37527,0,0,0,0,0,0,0,0,0,0
3715,umwatson.events.data.microsoft.com,legit,3.78556,11,19,34,0,0.57895,0.11134,13,9,7,6,35,8,1,0,0,9
7578,beeepo.ch,dga,2.6416,4,4,9,1,1.0,0.29351,0,0,0,0,0,1,0,0,0,1
5737,38f1d5m27ctixcb75v.cn,dga,3.97542,1,11,21,1,0.09091,0.18931,1,0,0,0,1,1,0,0,0,1
5726,nirauhusfeormfuwdovrrfinj.biz,dga,3.9523,10,18,29,1,0.55556,0.13629,3,0,0,0,3,4,0,0,0,4
8972,bkcdbcdnmdlabcbd.de,dga,2.96558,2,16,19,1,0.125,0.15608,2,1,0,0,3,2,0,0,0,2
3328,activity.windows.us,legit,3.57662,6,11,19,0,0.54545,0.18824,2,0,0,0,2,5,0,0,0,5
9622,swedenfunctions.mv,dga,3.68354,5,12,18,1,0.41667,0.20464,4,0,0,0,4,6,2,1,1,10
9786,cymuazp52grk37pwb48h24ism39ouh44gznqdr.biz,dga,4.61244,6,23,42,1,0.26087,0.10982,1,0,0,0,1,1,0,0,0,1
2875,teams-msgapi.trafficmanager.net,legit,3.66793,10,18,31,0,0.55556,0.11832,11,4,2,3,20,9,1,0,0,10
38,prod.partner.netflix.net,legit,3.51103,6,15,24,0,0.4,0.14629,5,3,2,1,11,4,1,0,0,5
999,inference.location.live.net,legit,3.38009,11,13,27,0,0.84615,0.12519,11,0,0,0,11,10,5,3,1,19
1960,fcmtoken.googleapis.com,legit,3.74095,8,13,23,0,0.61538,0.16265,6,7,4,4,21,4,0,0,0,4
7977,14c6q2ef3pqduhy43p5.ddns.net,dga,4.13754,3,15,28,1,0.2,0.14777,2,1,0,0,3,4,3,2,2,11
737,addthis.com,legit,3.27761,3,7,11,0,0.42857,0.29796,1,0,0,0,1,2,0,0,0,2
1272,i.scdn.co,legit,2.72548,2,5,9,0,0.4,0.30283,2,1,0,0,3,1,0,0,0,1
2314,joinhoney.com,legit,3.18083,5,7,13,0,0.71429,0.24468,2,0,0,0,2,3,1,0,0,4
5692,ytjskeltilkwwyth.eu,dga,3.47135,4,14,19,1,0.28571,0.1827,1,0,0,0,1,2,0,0,0,2
6783,enixonalo.ddns.net,dga,3.28104,6,10,18,1,0.6,0.18228,5,1,0,0,6,7,4,3,2,16
3821,api.us-east-1.aiv-delivery.net,legit,3.80624,11,12,30,0,0.91667,0.12687,8,2,1,0,11,7,1,0,0,8
7486,hugxifoc.ru,dga,3.27761,4,6,11,1,0.66667,0.29796,0,0,0,0,0,0,0,0,0,0
287,gdmf.apple.com,legit,3.37878,3,9,14,0,0.33333,0.24134,5,4,3,2,14,1,0,0,0,1
1284,watson.events.data.microsoft.com,legit,3.70282,10,18,32,0,0.55556,0.11571,13,9,7,6,35,8,1,0,0,9
2101,bazaarvoice.com,legit,3.32323,7,7,15,0,1.0,0.22155,2,1,0,0,3,3,0,0,0,3
2376,s.adroll.com,legit,3.08496,3,7,12,0,0.42857,0.25708,4,0,0,0,4,0,0,0,0,0
4742,inmobicdn.net,legit,3.18083,4,8,13,0,0.5,0.24468,4,1,0,0,5,3,0,0,0,3
870,drivefrontend-pa.clients6.google.com,legit,4.07243,11,20,36,0,0.55,0.11312,9,6,4,3,22,7,1,0,0,8
4999,ers.samsungcloud.com,legit,3.58418,6,12,20,0,0.5,0.17921,5,3,2,1,11,3,1,0,0,4
6194,dfmhodmguxyf.co.uk,dga,3.50326,4,12,18,1,0.33333,0.19463,2,1,0,0,3,1,1,0,0,2
4903,s.w-x.co,legit,2.75,1,4,8,0,0.25,0.34375,1,0,0,0,1,0,0,0,0,0
2383,australiasoutheast.cloudapp.azure.com,legit,3.78974,16,18,37,0,0.88889,0.10243,13,5,3,4,25,5,1,0,0,6
6212,suxqeaki.ru,dga,3.27761,5,5,11,1,1.0,0.29796,1,0,0,0,1,2,0,0,0,2
3159,event.prod.bidr.io,legit,3.35021,6,9,18,0,0.66667,0.18612,5,5,3,2,15,2,2,0,0,4
5119,actmoveluckmissfoldrepair.com,dga,3.9523,10,18,29,1,0.55556,0.13629,2,0,0,0,2,6,1,0,2,9
40,mp.microsoft.com,legit,3.15564,4,10,16,0,0.4,0.19723,7,8,7,7,29,2,0,0,0,2
4973,nova.collect.igodigital.com,legit,3.53194,10,14,27,0,0.71429,0.13081,4,1,0,0,5,5,2,0,0,7
413,init-p01md.apple.com,legit,3.78418,5,10,20,0,0.5,0.18921,7,4,3,2,16,4,0,0,0,4
9704,wjvfgmhlimdihcju.jp,dga,3.68188,3,15,19,1,0.2,0.19378,1,0,0,0,1,0,0,0,0,0
591,branch.io,legit,3.16993,3,5,9,0,0.6,0.35221,1,0,0,0,1,2,0,0,0,2
6002,iqpmasuiwcymao.info,dga,3.68188,8,10,19,1,0.8,0.19378,1,0,0,0,1,3,0,5,4,12
1116,r.msftstatic.com,legit,3.20282,3,11,16,0,0.27273,0.20018,6,0,0,0,6,5,1,0,0,6
3672,cdn-settings.segment.com,legit,3.45915,5,16,24,0,0.3125,0.14413,8,2,0,0,10,6,2,0,0,8
2876,msg.teams-msgapi.trafficmanager.net,legit,3.66117,10,21,35,0,0.47619,0.1046,11,4,2,3,20,9,1,0,0,10
6443,rfpxnhuoidylhynb.eu,dga,3.82687,5,13,19,1,0.38462,0.20141,0,0,0,0,0,0,0,0,0,0
6750,kixswbdvbuecxhlghhkk.com,dga,3.93872,4,19,24,1,0.21053,0.16411,0,0,0,0,0,1,0,0,0,1
8836,sowkfaowvqpreayvc.in,dga,3.92193,6,13,20,1,0.46154,0.1961,3,0,0,0,3,2,0,0,0,2
2401,e.dlx.addthis.com,legit,3.52806,4,10,17,0,0.4,0.20753,4,0,0,0,4,3,1,0,0,4
2647,taobao.com,legit,2.64644,5,4,10,0,1.25,0.26464,1,0,0,0,1,1,0,0,0,1
6003,cwhxjmtxtrwkswfg.eu,dga,3.78714,2,16,19,1,0.125,0.19932,0,0,0,0,0,0,0,0,0,0
2396,api.ipify.org,legit,3.02699,5,6,13,0,0.83333,0.23285,2,1,1,0,4,0,0,0,0,0
8446,temperancesamuelson.net,dga,3.46423,9,13,23,1,0.69231,0.15062,7,0,0,0,7,10,1,1,0,12
4321,creative-serving.com,legit,3.68418,7,11,20,0,0.63636,0.18421,8,1,1,1,11,8,4,1,0,13
8230,u6anbi3m7onn8dutc2.net,dga,3.91398,6,10,22,1,0.6,0.17791,1,0,0,0,1,2,0,0,0,2
5777,rkbkwcqltfaqrqbaj.su,dga,3.68418,3,16,20,1,0.1875,0.18421,0,0,0,0,0,0,0,0,0,0
2483,s.llnwi.net,legit,2.91398,2,7,11,0,0.28571,0.26491,1,0,0,0,1,0,0,0,0,0
9018,ogdcrwyongnq.biz,dga,3.625,3,12,16,1,0.25,0.22656,2,0,0,0,2,1,0,0,0,1
5891,64u02gm8ugq8.top,dga,3.625,3,6,16,1,0.5,0.22656,0,0,0,0,0,0,0,0,0,0
5979,btnizjuc.ms,dga,3.45943,2,8,11,1,0.25,0.31449,0,0,0,0,0,1,0,0,0,1
7693,ojlhxsuxtewg.org,dga,3.625,4,11,16,1,0.36364,0.22656,1,0,0,0,1,2,0,0,0,2
9343,mdtovrvgyl.com,dga,3.37878,2,11,14,1,0.18182,0.24134,0,0,0,0,0,0,0,0,0,0
9219,7tohwboxmlc2o81.ddns.net,dga,4.05351,4,14,24,1,0.28571,0.1689,2,1,0,0,3,4,3,2,1,10
1509,api.weather.com,legit,3.50689,6,7,15,0,0.85714,0.23379,5,1,1,0,7,3,1,1,1,6
2333,service-now.com,legit,3.50689,5,8,15,0,0.625,0.23379,4,2,1,1,8,4,2,1,0,7
8420,weblog-designated.cn,dga,3.78418,6,12,20,1,0.5,0.18921,5,0,0,0,5,6,1,0,0,7
1997,messaging.lifecycle.office.com,legit,3.56474,10,17,30,0,0.58824,0.11882,8,4,4,3,19,6,2,0,0,8
7793,dgkogmdmmlwp.biz,dga,3.45282,2,13,16,1,0.15385,0.2158,0,0,0,0,0,0,0,0,0,0
4135,cxcs.microsoft.net,legit,3.46132,4,12,18,0,0.33333,0.1923,7,8,7,6,28,2,0,0,0,2
8367,sporttreeiceprovidefishchallenge.com,dga,3.933,13,22,36,1,0.59091,0.10925,8,2,0,0,10,9,2,0,0,11
7327,molbknnmcfofkcdd.org,dga,3.48418,3,16,20,1,0.1875,0.17421,2,0,0,0,2,1,0,0,0,1
9090,c69jyezf52axp42juispynyb38aqc19c39h24o11.biz,dga,4.55547,7,20,44,1,0.35,0.10353,0,0,0,0,0,1,0,0,0,1
5348,gunatcea.ru,dga,3.0958,5,5,11,1,1.0,0.28144,3,0,0,0,3,3,0,0,0,3
2220,emxdgt.com,legit,3.12193,2,7,10,0,0.28571,0.31219,0,0,0,0,0,1,0,0,0,1
5529,removed-darkness.com,dga,3.58418,6,12,20,1,0.5,0.17921,3,0,0,0,3,7,2,0,0,9
6518,ixooiqye.com,dga,3.02206,6,5,12,1,1.2,0.25184,1,0,0,0,1,0,0,0,0,0
8978,hlrivgehygexcxkaytrwvgtchm.com,dga,3.96474,5,24,30,1,0.20833,0.13216,1,0,0,0,1,2,0,0,0,2
3647,ods.opinsights.azure.com,legit,3.90727,8,13,24,0,0.61538,0.1628,6,0,0,2,8,4,0,0,0,4
6358,nipaquamverbumvelcamp.com,dga,3.73366,9,15,25,1,0.6,0.14935,2,0,0,0,2,6,1,0,0,7
6999,madehigh.net,dga,3.25163,4,7,12,1,0.57143,0.27097,2,0,0,0,2,2,0,0,0,2
5232,hahuciz.info,dga,3.25163,5,6,12,1,0.83333,0.27097,0,0,0,0,0,0,0,0,0,0
8083,wwelhslcstgqgmuu.eu,dga,3.47135,5,13,19,1,0.38462,0.1827,1,0,0,0,1,2,0,0,0,2
8906,gkpylmwfbgrksin.org,dga,3.78714,2,16,19,1,0.125,0.19932,1,0,0,0,1,2,0,0,0,2
3352,i0.wp.com,legit,2.9477,2,4,9,0,0.5,0.32752,0,0,0,0,0,0,0,0,0,0
5627,wxokxsdpemcg.com,dga,3.5,3,12,16,1,0.25,0.21875,0,0,0,0,0,1,0,0,0,1
6920,oeesfedpwfvf.pw,dga,3.00624,4,10,15,1,0.4,0.20042,2,0,0,0,2,2,0,0,0,2
7771,wyudtq.at,dga,2.9477,2,6,9,1,0.33333,0.32752,0,0,0,0,0,0,0,0,0,0
6548,weidokro.ru,dga,3.0958,5,5,11,1,1.0,0.28144,1,0,0,0,1,0,0,0,0,0
5044,iukquekwwaequyeg.org,dga,3.44644,9,10,20,1,0.9,0.17232,0,0,0,0,0,0,0,0,0,0
9259,qc2w20acm0mw.top,dga,3.375,2,9,16,1,0.22222,0.21094,0,0,0,0,0,1,0,0,0,1
1548,suggestqueries.google.com,legit,3.46347,10,13,25,0,0.76923,0.13854,7,5,4,3,19,7,2,0,0,9
5512,rimpqxcxysjr.com,dga,3.5,2,13,16,1,0.15385,0.21875,0,0,0,0,0,1,0,0,0,1
9868,tfqqnk.dyndns.org,dga,3.45482,1,14,17,1,0.07143,0.20322,2,1,0,0,3,4,3,4,3,14
9148,akvxdzmteigkuywr.com,dga,4.12193,5,14,20,1,0.35714,0.2061,1,0,0,0,1,1,0,0,0,1
6584,aocednfflbeenlkf.com,dga,3.44644,6,13,20,1,0.46154,0.17232,4,0,0,0,4,5,0,0,0,5
6940,vfwsgtwnxkahslxjv.tw,dga,3.68418,1,18,20,1,0.05556,0.18421,0,0,0,0,0,0,0,0,0,0
6396,gaqydah.com,dga,3.27761,3,7,11,1,0.42857,0.29796,0,0,0,0,0,0,0,0,0,0
4757,vcs-va.tiktokv.com,legit,3.35021,4,11,18,0,0.36364,0.18612,2,5,4,3,14,1,0,0,0,1
1912,b.yahoodns.net,legit,3.37878,4,8,14,0,0.5,0.24134,2,1,0,1,4,2,1,0,0,3
2595,1.courier-sandbox-push-apple.com.akadns.net,legit,4.20465,13,22,43,0,0.59091,0.09778,13,9,9,9,40,9,4,1,0,14
182,apple.com.akadns.net,legit,3.54644,6,11,20,0,0.54545,0.17732,10,9,9,9,37,5,3,1,0,9
8181,g2ouomcm82cq.net,dga,3.5,4,8,16,1,0.5,0.21875,1,0,0,0,1,1,0,0,0,1
1376,mxptint.net,legit,2.84535,2,8,11,0,0.25,0.25867,3,0,0,0,3,2,0,0,0,2
6069,0u8ygywuoicm.top,dga,3.625,5,8,16,1,0.625,0.22656,1,0,0,0,1,1,0,0,0,1
7424,dpbimmtreckh.com,dga,3.57782,3,12,16,1,0.25,0.22361,1,0,0,0,1,2,0,0,0,2
655,d.agkn.com,legit,3.12193,2,6,10,0,0.33333,0.31219,2,0,0,0,2,0,0,0,0,0
9619,tgaznxbqqojrl.com,dga,3.85217,3,13,17,1,0.23077,0.2266,0,0,0,0,0,0,0,0,0,0
4411,e6913.dscx.akamaiedge.net,legit,3.86347,8,10,25,0,0.8,0.15454,7,5,5,3,20,5,0,0,0,5
754,ssp.yahoo.com,legit,3.02699,4,7,13,0,0.57143,0.23285,2,0,0,1,3,0,0,0,0,0
270,wd.microsoft.com,legit,3.32782,4,10,16,0,0.4,0.20799,7,8,7,6,28,2,0,0,0,2
7224,64uguomguc20.top,dga,3.45282,5,6,16,1,0.83333,0.2158,0,0,0,0,0,1,0,0,0,1
5135,opfulminatdevotam.com,dga,3.74899,8,12,21,1,0.66667,0.17852,5,0,0,0,5,6,0,0,0,6
9736,felbwfohdgkc.ru,dga,3.77356,3,11,15,1,0.27273,0.25157,0,0,0,0,0,1,0,0,0,1
8334,lykyfyx.com,dga,3.02717,1,9,11,1,0.11111,0.2752,0,0,0,0,0,0,0,0,0,0
6746,kdaxlcidhx.com,dga,3.37878,3,10,14,1,0.3,0.24134,0,0,0,0,0,0,0,0,0,0
710,tools.google.com,legit,2.8994,6,8,16,0,0.75,0.18121,3,5,4,3,15,1,0,0,0,1
8084,ijkqyxincohn.com,dga,3.5,4,11,16,1,0.36364,0.21875,2,0,0,0,2,2,0,0,0,2
5527,swedishdomestic.su,dga,3.39215,6,11,18,1,0.54545,0.18845,5,0,0,0,5,7,1,0,0,8
9189,somowga.com,dga,2.84535,4,6,11,1,0.66667,0.25867,0,0,0,0,0,1,0,0,0,1
7844,y8qga0qgaoy4.top,dga,3.375,4,8,16,1,0.5,0.21094,0,0,0,0,0,0,0,0,0,0
2861,taboola.map.fastly.net,legit,3.48171,7,12,22,0,0.58333,0.15826,7,1,0,0,8,5,0,0,0,5
1811,pi.ispot.tv,legit,2.73216,3,6,11,0,0.5,0.24838,1,0,0,0,1,1,0,0,0,1
1612,microsoft.com-c-3.edgekey.net,legit,3.88334,8,15,29,0,0.53333,0.13391,9,11,8,5,33,6,2,1,0,9
1234,xy.fbcdn.net,legit,3.25163,1,9,12,0,0.11111,0.27097,2,1,0,0,3,1,0,0,0,1
8983,kgoopwpvulqjol.com,dga,3.50326,5,12,18,1,0.41667,0.19463,1,1,0,0,2,0,0,0,0,0
5622,tuldejmxyuvy.ru,dga,3.45656,4,10,15,1,0.4,0.23044,0,0,0,0,0,1,0,0,0,1
1015,eu-1-id5-sync.com,legit,3.69012,4,7,17,0,0.57143,0.21707,0,0,0,0,0,0,0,0,0,0
5035,odxaecfeuddeces.ddns.net,dga,3.28416,8,14,24,1,0.57143,0.13684,5,1,0,0,6,8,3,3,2,16
826,image2.pubmatic.com,legit,3.57662,7,9,19,0,0.77778,0.18824,5,1,0,0,6,5,1,0,0,6
3353,associates-amazon.com,legit,3.36804,9,10,21,0,0.9,0.16038,6,1,3,2,12,7,2,0,0,9
9798,bscggv.com.hn,dga,3.2389,1,10,13,1,0.1,0.24915,2,2,1,0,5,2,2,1,0,5
1262,classroom.google.com,legit,3.14145,7,11,20,0,0.63636,0.15707,3,6,4,3,16,4,1,0,0,5
1176,force.com,legit,2.72548,3,5,9,0,0.6,0.30283,1,0,0,0,1,2,0,0,0,2
7210,scmunwbfyryjwsdsx.com,dga,3.78494,2,18,21,1,0.11111,0.18024,1,0,0,0,1,0,0,0,0,0
5417,hiifitfjutr.dynserv.com,dga,3.969,6,15,23,1,0.4,0.17257,3,1,1,0,5,5,5,5,4,19
4539,fortinet.net,legit,2.85539,4,7,12,0,0.57143,0.23795,2,0,0,0,2,5,1,0,0,6
8777,gndxeysr.co.ke,dga,3.52164,3,9,14,1,0.33333,0.25155,2,1,0,0,3,2,1,0,0,3
1399,gsp64-ssl.ls-apple.com.akadns.net,legit,3.83608,6,19,33,0,0.31579,0.11624,10,9,9,9,37,5,3,1,0,9
6787,oqqdwhvwf.su,dga,3.25163,2,9,12,1,0.22222,0.27097,0,0,0,0,0,0,0,0,0,0
4429,idms-apple.com.akadns.net,legit,3.78347,7,14,25,0,0.5,0.15134,10,9,9,9,37,5,3,1,0,9
6741,avhvi.co.id,dga,2.91398,4,5,11,1,0.8,0.26491,2,1,0,0,3,1,1,0,0,2
4587,mrodevicemgr.live.com.akadns.net,legit,3.85141,10,18,32,0,0.55556,0.12036,10,8,7,8,33,9,3,1,0,13
9892,skiskiqukaywkiis.org,dga,3.28418,7,12,20,1,0.58333,0.16421,0,0,0,0,0,1,0,0,0,1
3798,spotify.map.fastly.net,legit,3.57262,5,14,22,0,0.35714,0.16239,6,1,0,0,7,4,0,0,0,4
4526,fksnk.com,legit,2.9477,1,7,9,0,0.14286,0.32752,0,0,0,0,0,0,0,0,0,0
8315,lojrmozmkowmsvth.net,dga,3.74644,4,15,20,1,0.26667,0.18732,1,0,0,0,1,0,0,0,0,0
5900,xyiedfutouqi.com,dga,3.625,7,8,16,1,0.875,0.22656,2,0,0,0,2,1,0,0,0,1
8624,galudus.info,dga,3.4183,5,6,12,1,0.83333,0.28486,1,0,0,0,1,0,0,0,0,0
1986,beap.gemini.yahoo.com,legit,3.55852,9,9,21,0,1.0,0.16945,7,0,0,1,8,7,0,0,0,7
255,twitter.com,legit,3.02717,3,7,11,0,0.42857,0.2752,2,0,0,0,2,3,1,0,0,4
7187,nezugcpawcqqldhzj.com,dga,3.97542,4,16,21,1,0.25,0.18931,0,0,0,0,0,1,0,0,0,1
1263,rkdms.com,legit,2.9477,1,7,9,0,0.14286,0.32752,0,0,0,0,0,0,0,0,0,0
1473,cdn.segment.com,legit,3.24022,3,10,15,0,0.3,0.21601,5,3,1,0,9,3,1,0,0,4
8632,sodeovcuniywf.im,dga,3.75,6,9,16,1,0.66667,0.23438,0,0,0,0,0,2,0,0,0,2
2763,attn.tv,legit,2.12809,1,5,7,0,0.2,0.30401,1,0,0,0,1,1,0,0,0,1
2344,gocm.c.appier.net,legit,3.45482,5,9,17,0,0.55556,0.20322,6,2,1,0,9,1,0,0,0,1
7834,bughpxfq.sg,dga,3.27761,1,9,11,1,0.11111,0.29796,0,0,0,0,0,0,0,0,0,0
6634,vipococy.info,dga,3.02699,5,7,13,1,0.71429,0.23285,1,0,0,0,1,1,0,0,0,1
1736,datadoghq-browser-agent.com,legit,3.95823,8,16,27,0,0.5,0.1466,9,3,0,0,12,6,2,0,0,8
3432,track.capitaloneshopping.com,legit,3.84237,9,17,28,0,0.52941,0.13723,10,1,0,0,11,9,4,0,0,13
9583,lxncnsfox.org,dga,3.2389,2,10,13,1,0.2,0.24915,0,0,0,0,0,1,0,0,0,1
609,i.liadm.com,legit,2.91398,4,5,11,0,0.8,0.26491,2,0,0,0,2,0,0,0,0,0
3038,westus2.cloudapp.azure.com,legit,3.87314,9,13,26,0,0.69231,0.14897,11,4,3,4,22,3,1,0,0,4
3880,cookiebot.com,legit,2.93121,6,6,13,0,1.0,0.22548,2,0,0,0,2,1,0,0,0,1
2637,auction-load.unityads.unity3d.com,legit,3.77048,12,16,33,0,0.75,0.11426,7,0,0,0,7,4,2,1,1,8
4191,s.seedtag.com,legit,3.2389,4,7,13,0,0.57143,0.24915,4,0,0,0,4,3,0,0,0,3
1919,config.skype.com,legit,3.625,4,10,16,0,0.4,0.22656,2,1,0,0,3,2,1,0,0,3
5984,bndxbjgpidkp.com,dga,3.625,2,13,16,1,0.15385,0.22656,1,0,0,0,1,1,0,0,0,1
9393,xaldfjrkdkbvxybud.pw,dga,3.78418,2,17,20,1,0.11765,0.18921,0,0,0,0,0,0,0,0,0,0
2489,demandbase.com,legit,3.23593,5,8,14,0,0.625,0.23114,2,0,0,0,2,7,1,0,0,8
1303,redditstatic.com,legit,3.32782,5,10,16,0,0.5,0.20799,7,0,0,0,7,9,1,0,0,10
8170,christobelstrudwick.net,dga,3.88205,6,16,23,1,0.375,0.16878,2,0,0,0,2,6,2,0,2,10
9850,faabdlacaadkkkno.net,dga,3.3037,7,12,20,1,0.58333,0.16518,1,0,0,0,1,3,0,0,0,3
6571,wnqwgenansnan.com,dga,3.16925,4,12,17,1,0.33333,0.18643,2,0,0,0,2,4,2,4,3,13
5613,ceikolux.ru,dga,3.27761,5,5,11,1,1.0,0.29796,1,0,0,0,1,1,0,0,0,1
6550,64moygq86ce4.top,dga,3.625,3,7,16,1,0.42857,0.22656,1,0,0,0,1,1,0,0,0,1
143,activity.windows.com,legit,3.58418,6,12,20,0,0.5,0.17921,2,0,0,0,2,5,0,0,0,5
9540,wadowlkzmc8pdorplc.cn,dga,3.6897,3,16,21,1,0.1875,0.1757,2,0,0,0,2,1,0,0,0,1
1132,disc601.prod.do.dsp.mp.microsoft.com,legit,3.55495,7,20,36,0,0.35,0.09875,11,12,10,9,42,4,2,0,0,6
8427,edacwatl.com,dga,3.25163,4,7,12,1,0.57143,0.27097,2,0,0,0,2,3,0,0,0,3
4260,td.doubleclick.net,legit,3.50326,5,11,18,0,0.45455,0.19463,6,0,0,0,6,4,0,0,0,4
1470,stripe.network,legit,3.37878,4,9,14,0,0.44444,0.24134,1,0,0,0,1,2,0,0,0,2
7689,cookiecriticizefinanceheat.com,dga,3.50775,14,15,30,1,0.93333,0.11692,9,0,0,0,9,11,2,1,0,14
7178,blankbeachcakedescribecommit.com,dga,3.75393,11,20,32,1,0.55,0.11731,6,1,0,0,7,15,1,0,0,16
7171,oqbqbwavexoze31irbtgqh24b68pyf22dtf12.org,dga,4.44268,7,23,41,1,0.30435,0.10836,0,0,0,0,0,1,0,0,0,1
1768,pull-f5-tt02.fcdn.us.tiktokv.com,legit,4.0625,5,18,32,0,0.27778,0.12695,6,7,7,4,24,2,0,0,0,2
8563,rvovlmnb.eu,dga,3.27761,3,7,11,1,0.42857,0.29796,0,0,0,0,0,0,0,0,0,0
2453,t-ring.msedge.net,legit,3.33718,4,10,17,0,0.4,0.1963,5,2,1,0,8,5,2,0,0,7
6826,venice-laser.sg,dga,3.45656,5,8,15,1,0.625,0.23044,5,2,0,0,7,9,1,0,0,10
8789,zfrajsn.cc,dga,3.12193,1,8,10,1,0.125,0.31219,1,0,0,0,1,1,0,0,0,1
5142,kwbtmpqqopfotrng.eu,dga,3.82687,4,14,19,1,0.28571,0.20141,0,0,0,0,0,0,0,0,0,0
7554,xcpxgavyegzfzrtrhir.com,dga,3.969,4,18,23,1,0.22222,0.17257,0,0,0,0,0,0,0,0,0,0
6483,aoggldpeyryvjwp.com,dga,3.82687,4,14,19,1,0.28571,0.20141,0,0,0,0,0,0,0,0,0,0
8529,ilijrwcppewp.biz,dga,3.28064,4,11,16,1,0.36364,0.20504,2,0,0,0,2,0,0,0,0,0
9244,dbtqwtodmcm.ir,dga,3.37878,2,11,14,1,0.18182,0.24134,0,0,0,0,0,0,0,0,0,0
1471,m.stripe.network,legit,3.5,4,10,16,0,0.4,0.21875,1,0,0,0,1,2,0,0,0,2
9416,mkqmwgb.tv,dga,3.12193,0,9,10,1,0.0,0.31219,0,0,0,0,0,0,0,0,0,0
7137,hanefli.com,dga,3.45943,4,6,11,1,0.66667,0.31449,1,0,0,0,1,2,0,0,0,2
621,contextual.media.net,legit,3.54644,8,10,20,0,0.8,0.17732,6,1,0,0,7,4,1,0,0,5
8386,bpjumrukqfqtmpacc.net,dga,3.82089,4,16,21,1,0.25,0.18195,0,0,0,0,0,1,0,0,0,1
8447,zrjjgf.net,dga,3.12193,1,8,10,1,0.125,0.31219,0,0,0,0,0,0,0,0,0,0
9846,uoofvpoeurvmonxu.eu,dga,3.1953,10,8,19,1,1.25,0.16817,3,0,0,0,3,1,0,0,0,1
3708,detectportal.prod.cloudops.mozgcp.net,legit,3.75339,10,23,37,0,0.43478,0.10144,10,7,6,4,27,6,1,0,0,7
7648,bmhwwvjvbeir.com,dga,3.5,3,12,16,1,0.25,0.21875,0,0,0,0,0,1,0,0,0,1
5838,oftenminute.net,dga,2.95591,6,8,15,1,0.75,0.19706,5,1,0,0,6,4,0,0,0,4
8995,dftsxwnypw.com,dga,3.6645,1,12,14,1,0.08333,0.26175,0,0,0,0,0,0,0,0,0,0
2859,byteoversea.net,legit,3.24022,6,8,15,0,0.75,0.21601,4,0,0,0,4,5,3,0,0,8
582,indexww.com,legit,3.27761,3,7,11,0,0.42857,0.29796,1,0,0,0,1,3,0,0,0,3
7089,bgtdvyumimxpfnwsgi.tw,dga,3.91613,3,17,21,1,0.17647,0.18648,1,0,0,0,1,1,0,0,0,1
6157,kupquuoxq.cc,dga,2.85539,4,7,12,1,0.57143,0.23795,0,0,0,0,0,0,0,0,0,0
2452,oktacdn.com,legit,3.0958,3,7,11,0,0.42857,0.28144,3,1,0,0,4,3,0,0,0,3
8186,vgyvwxcbvd.com,dga,3.32486,1,12,14,1,0.08333,0.23749,0,0,0,0,0,0,0,0,0,0
4080,usabilla.com,legit,3.25163,5,6,12,0,0.83333,0.27097,1,0,0,0,1,1,0,0,0,1
9012,fodlwsnmsfpmaugag.com,dga,3.6897,5,15,21,1,0.33333,0.1757,1,0,0,0,1,1,0,0,0,1
1355,sandbox.push.apple.com,legit,3.75444,6,13,22,0,0.46154,0.17066,6,4,3,2,15,3,1,0,0,4
6513,nkafjrygg.com,dga,3.54659,2,10,13,1,0.2,0.27281,0,0,0,0,0,0,0,0,0,0
7120,purypuq.com,dga,3.0958,3,7,11,1,0.42857,0.28144,0,0,0,0,0,0,0,0,0,0
7148,uykjlsyagxq.com,dga,3.77356,3,11,15,1,0.27273,0.25157,0,0,0,0,0,0,0,0,0,0
1286,c2shb.pubgw.yahoo.com,legit,3.65376,5,12,21,0,0.41667,0.17399,1,0,0,1,2,0,0,0,0,0
3445,t.skimresources.com,legit,3.36609,6,11,19,0,0.54545,0.17716,4,0,0,0,4,3,1,0,0,4
7168,3utls6pjnk1s1dsmh8.biz,dga,4.15239,2,14,22,1,0.14286,0.18874,1,0,0,0,1,0,0,0,0,0
6350,gqwigiysswicioqm.org,dga,3.28418,6,13,20,1,0.46154,0.16421,1,0,0,0,1,1,0,0,0,1
209,securepubads.g.doubleclick.net,legit,3.89807,10,17,30,0,0.58824,0.12994,10,0,0,0,10,6,0,0,0,6
730,agave.myanalytics.cdn.office.net,legit,3.80423,10,18,32,0,0.55556,0.11888,10,6,5,3,24,6,0,0,0,6
5525,ahfiufdo.ddns.net,dga,3.45482,5,10,17,1,0.5,0.20322,2,1,0,0,3,4,4,3,2,13
8510,16afirmn7nm0y2ixmpg.ddns.net,dga,4.13754,4,17,28,1,0.23529,0.14777,2,1,0,0,3,4,3,3,2,12
423,beacons4.gvt2.com,legit,3.73452,4,9,17,0,0.44444,0.21968,3,1,0,0,4,6,1,0,0,7
7039,lalineob.ru,dga,3.27761,5,5,11,1,1.0,0.29796,2,0,0,0,2,3,1,0,0,4
7873,xnfmrlmnnbrwujdel.su,dga,3.68418,3,16,20,1,0.1875,0.18421,0,0,0,0,0,2,0,0,0,2
7817,puzugyq.info,dga,3.4183,4,7,12,1,0.57143,0.28486,0,0,0,0,0,0,0,0,0,0
827,a.akamaiedge.net,legit,3.07782,8,6,16,0,1.33333,0.19236,5,5,5,3,18,4,0,0,0,4
7151,structurekurt.be,dga,2.98346,5,10,16,1,0.5,0.18647,2,0,0,0,2,2,1,0,0,3
2038,i.w55c.net,legit,2.92193,2,4,10,0,0.5,0.29219,0,0,0,0,0,0,0,0,0,0
8988,bbqyttnmmfvf.ru,dga,3.37356,1,13,15,1,0.07692,0.2249,0,0,0,0,0,0,0,0,0,0
2936,secure-dcr.imrworldwide.com,legit,3.5599,8,16,27,0,0.5,0.13185,3,0,0,0,3,5,0,0,0,5
5535,vfribpwvb.tv,dga,3.02206,1,10,12,1,0.1,0.25184,0,0,0,0,0,1,0,0,0,1
2451,cdn.pdst.fm,legit,3.0958,0,9,11,0,0.0,0.28144,4,2,1,0,7,2,0,0,0,2
1702,va6-bid.adsrvr.org,legit,3.46132,4,10,18,0,0.4,0.1923,4,0,0,0,4,0,0,0,0,0
508,l.googleusercontent.com,legit,3.44726,8,13,23,0,0.61538,0.14988,10,8,4,3,25,7,3,0,0,10
4078,view.cdnbasket.net,legit,3.57243,5,11,18,0,0.45455,0.19847,3,1,0,0,4,3,0,0,0,3
8059,lbhpxozpvvohmfizpojxfexgq.com,dga,3.90937,6,22,29,1,0.27273,0.13481,0,0,0,0,0,0,0,0,0,0
1061,upload2.fp.measure.office.com,legit,3.74541,11,13,29,0,0.84615,0.12915,11,4,4,3,22,6,0,0,0,6
2126,1655932307.rsc.cdn77.org,legit,3.85539,1,8,24,0,0.125,0.16064,3,1,0,0,4,1,0,0,0,1
4566,msedgeextensions.sf.tlu.dl.delivery.mp.microsoft.com,legit,3.9737,14,31,52,0,0.45161,0.07642,18,10,8,7,43,15,2,0,0,17
3889,mnz-efz.ms-acdc.office.com,legit,3.53641,6,15,26,0,0.4,0.13602,5,4,4,3,16,3,0,0,0,3
5143,puzyjoq.com,dga,3.27761,3,7,11,1,0.42857,0.29796,0,0,0,0,0,0,0,0,0,0
569,dis.criteo.com,legit,3.23593,5,7,14,0,0.71429,0.23114,4,0,0,0,4,4,0,0,0,4
9355,wqxevwwpyuwvfbqw.eu,dga,3.21584,4,14,19,1,0.28571,0.16925,0,0,0,0,0,0,0,0,0,0
2359,a-0003.a-msedge.net,legit,3.43162,5,6,19,0,0.83333,0.18061,4,2,1,0,7,3,0,0,0,3
9664,jqttmngganto.sc,dga,3.32323,2,12,15,1,0.16667,0.22155,1,0,0,0,1,1,0,0,0,1
3964,i5.walmartimages.com,legit,3.64644,7,10,20,0,0.7,0.18232,4,1,0,0,5,5,0,0,0,5
934,aax-us-east.amazon-adsystem.com,legit,3.63099,11,15,31,0,0.73333,0.11713,10,2,3,3,18,8,0,0,0,8
1678,paypal.com,legit,2.92193,3,6,10,0,0.5,0.29219,0,0,0,0,0,0,0,0,0,0
9921,28p3s56oiskfedvuar.ru,dga,4.1066,6,9,21,1,0.66667,0.19555,1,0,0,0,1,3,0,0,0,3
7580,exyp.ms,dga,2.80735,1,5,7,1,0.2,0.40105,0,0,0,0,0,0,0,0,0,0
8368,wdqtcwokvbbjxu.ru,dga,3.73452,3,13,17,1,0.23077,0.21968,0,0,0,0,0,0,0,0,0,0
7438,limenwehed.com,dga,3.32486,5,8,14,1,0.625,0.23749,3,0,0,0,3,2,0,0,0,2
3523,pushlycdn.com,legit,3.54659,2,10,13,0,0.2,0.27281,3,1,0,0,4,1,0,0,0,1
1148,login.windows.net,legit,3.33718,5,10,17,0,0.5,0.1963,2,0,0,0,2,2,0,0,0,2
399,doubleverify.com,legit,3.75,6,9,16,0,0.66667,0.23438,3,0,0,0,3,4,2,0,0,6
4511,slate.com,legit,3.16993,3,5,9,0,0.6,0.35221,2,0,0,0,2,3,1,0,0,4
9428,examplebeingspaceclaimpersuade.com,dga,3.79998,14,19,34,1,0.73684,0.11176,7,1,0,0,8,11,2,0,0,13
9602,uiowcjcfeuyy.com,dga,3.32782,6,9,16,1,0.66667,0.20799,0,0,0,0,0,0,0,0,0,0
844,dscg.akamaiedge.net,legit,3.43162,7,10,19,0,0.7,0.18061,6,5,5,3,19,4,0,0,0,4
6297,lyvylud.com,dga,3.0958,2,8,11,1,0.25,0.28144,0,0,0,0,0,0,0,0,0,0
9649,xmbq.com.pe,dga,3.0958,2,7,11,1,0.28571,0.28144,2,2,1,0,5,2,2,1,0,5
871,msauth.net,legit,3.12193,3,6,10,0,0.5,0.31219,0,0,0,0,0,0,0,0,0,0
6876,skxsiyeoya.net,dga,3.37878,5,8,14,1,0.625,0.24134,0,0,0,0,0,1,0,1,0,2
3879,dt-external-521234871.us-west-2.elb.amazonaws.com,legit,4.42564,11,20,49,0,0.55,0.09032,9,1,3,3,16,8,2,0,0,10
7597,xddvkedycygktsm.in,dga,3.68354,2,15,18,1,0.13333,0.20464,1,0,0,0,1,2,0,0,0,2
8515,souukgnpmpomysye.biz,dga,3.72193,6,13,20,1,0.46154,0.1861,1,0,0,0,1,1,0,0,0,1
5495,ngjkyhvdmyaeccjlgh.com,dga,3.78875,3,18,22,1,0.16667,0.17222,0,0,0,0,0,1,0,0,0,1
1139,odr.mookie1.com,legit,3.10689,6,6,15,0,1.0,0.20713,2,0,0,0,2,0,0,1,0,1
2508,hubapi.com,legit,3.32193,4,5,10,0,0.8,0.33219,2,1,0,0,3,0,0,0,0,0
3190,ctfassets.net,legit,2.81507,3,9,13,0,0.33333,0.21654,1,0,0,0,1,3,1,0,0,4
8322,yxfunuexuy.com,dga,3.18201,5,8,14,1,0.625,0.22729,0,0,0,0,0,0,0,0,0,0
9256,dirhxjsuv.com,dga,3.70044,3,9,13,1,0.33333,0.28465,0,0,0,0,0,1,0,0,0,1
6692,hacides.net,dga,3.27761,4,6,11,1,0.66667,0.29796,1,0,0,0,1,3,0,0,0,3
1406,deff.nelreports.net,legit,3.30056,5,12,19,0,0.41667,0.17371,1,0,0,0,1,5,0,0,0,5
1459,uksouth.cloudapp.azure.com,legit,3.79622,10,13,26,0,0.76923,0.14601,8,4,3,4,19,1,0,0,0,1
9088,xw8w8ktnveos5vomyf.cn,dga,3.91613,3,14,21,1,0.21429,0.18648,0,0,0,0,0,2,0,0,0,2
7785,obcdjvmfpsverll.ru,dga,3.83659,3,14,18,1,0.21429,0.21314,2,0,0,0,2,2,1,0,0,3
7436,cyixetf32m49gycvd30crp62bqcsl58hzivhz.biz,dga,4.6378,4,26,41,1,0.15385,0.11312,1,0,0,0,1,1,0,0,0,1
3463,guce.oath.com,legit,3.2389,5,6,13,0,0.83333,0.24915,3,0,0,0,3,2,0,0,0,2
1198,img-prod-cms-rt-microsoft-com.akamaized.net,legit,3.96129,12,24,43,0,0.5,0.09212,11,14,13,11,49,7,2,0,0,9
9051,wmhttupxoqwipdqqjb.com,dga,3.78875,4,17,22,1,0.23529,0.17222,0,0,0,0,0,0,0,0,0,0
5755,ufhinnjmnf.com,dga,3.18201,3,10,14,1,0.3,0.22729,1,0,0,0,1,1,0,0,0,1
977,pull-flv-l10-va01.tiktokcdn.com,legit,4.02662,5,17,31,0,0.29412,0.12989,4,6,9,9,28,2,0,0,0,2
8938,ttmrcphqcwfbnqts.eu,dga,3.78714,2,16,19,1,0.125,0.19932,0,0,0,0,0,0,0,0,0,0
4332,pix.cdnwidget.com,legit,3.61687,4,11,17,0,0.36364,0.21276,5,2,0,0,7,3,0,0,0,3
7982,cafdilwi.ru,dga,3.27761,4,6,11,1,0.66667,0.29796,0,0,0,0,0,1,0,0,0,1
3620,audio-ak-spotify-com.akamaized.net,legit,3.97351,14,15,34,0,0.93333,0.11687,6,5,6,6,23,6,1,0,0,7
6986,rttbfacfmk.com,dga,3.23593,2,11,14,1,0.18182,0.23114,0,0,0,0,0,1,0,0,0,1
2549,www.dropbox.com,legit,3.13957,3,10,15,0,0.3,0.2093,2,0,0,0,2,1,0,0,0,1
639,gateway.instagram.com,legit,3.63041,7,12,21,0,0.58333,0.17288,7,0,0,0,7,8,1,0,0,9
7963,xgysaw.tv,dga,3.16993,1,7,9,1,0.14286,0.35221,0,0,0,0,0,0,0,0,0,0
107,measure.office.com,legit,3.35021,8,8,18,0,1.0,0.18612,6,4,4,3,17,6,0,0,0,6
6093,maximilliananastacia.net,dga,3.15727,11,12,24,1,0.91667,0.13155,5,1,0,0,6,7,1,0,0,8
3441,www-msn-com.a-0003.a-msedge.net,legit,3.73567,6,14,31,0,0.42857,0.12051,5,4,3,1,13,5,1,0,0,6
3670,scss.adobesc.com,legit,2.95282,4,10,16,0,0.4,0.18455,4,0,0,0,4,2,0,0,0,2
8044,holafogu.ru,dga,3.0958,5,5,11,1,1.0,0.28144,0,0,0,0,0,1,0,1,0,2
8960,itbuentageonveu.ddns.net,dga,3.47018,9,13,24,1,0.69231,0.14459,7,3,0,0,10,10,4,3,2,19
4099,videoevents.outbrain.com,legit,3.77206,10,12,24,0,0.83333,0.15717,6,1,0,0,7,5,1,0,0,6
7088,qxeuvyfwckkifoqgh.su,dga,3.92193,5,14,20,1,0.35714,0.1961,0,0,0,0,0,0,0,0,0,0
1744,walmart.com,legit,3.0958,3,7,11,0,0.42857,0.28144,1,0,0,0,1,2,0,0,0,2
770,iphone-ld.origin-apple.com.akadns.net,legit,3.97231,12,19,37,0,0.63158,0.10736,13,9,9,9,40,10,4,1,0,15
5917,jvpvmjjkzrrqlvnv.biz,dga,3.48418,1,18,20,1,0.05556,0.17421,0,0,0,0,0,0,0,0,0,0
252,casalemedia.com,legit,3.1899,7,7,15,0,1.0,0.21266,2,0,0,0,2,5,0,0,0,5
5766,fobivuzinef.eu,dga,3.23593,7,6,14,1,1.16667,0.23114,1,0,0,0,1,2,1,0,0,3
4037,ag.gbc.criteo.com,legit,3.29277,5,9,17,0,0.55556,0.19369,3,0,0,0,3,3,0,0,0,3
9672,ycjsrcnhhydl.info,dga,3.61687,2,14,17,1,0.14286,0.21276,0,0,0,0,0,0,0,0,0,0
5031,xmambdaytivtt.biz,dga,3.33718,4,12,17,1,0.33333,0.1963,3,0,0,0,3,3,0,0,0,3
7996,gorisdumagw.com,dga,3.50689,5,9,15,1,0.55556,0.23379,1,0,0,0,1,4,1,0,0,5
1137,b-api.facebook.com,legit,3.46132,7,8,18,0,0.875,0.1923,4,1,1,0,6,2,0,0,0,2
2258,36-courier.push.apple.com,legit,3.86347,8,11,25,0,0.72727,0.15454,9,4,3,2,18,4,0,0,0,4
2317,array611.prod.do.dsp.mp.microsoft.com,legit,3.65853,8,20,37,0,0.4,0.09888,12,12,10,9,43,5,2,0,0,7
3253,in2-prod-east-us2-23fa330.trafficmanager.net,legit,4.12093,12,19,44,0,0.63158,0.09366,12,6,2,3,23,10,2,0,0,12
3762,www-bing-com.dual-a-0001.a-msedge.net,legit,4.03691,9,16,37,0,0.5625,0.10911,7,4,2,0,13,7,2,0,0,9
4688,usc-word-edit.officeapps.live.com,legit,4.02093,11,17,33,0,0.64706,0.12185,10,5,4,3,22,7,0,0,0,7
9641,cewomsecg.com,dga,2.87314,4,8,13,1,0.5,0.22101,2,0,0,0,2,4,0,0,0,4
1368,clarium.io,legit,3.12193,5,4,10,0,1.25,0.31219,0,0,0,0,0,3,0,0,0,3
6373,dprmvux.fr,dga,3.12193,1,8,10,1,0.125,0.31219,1,0,0,0,1,0,0,0,0,0
5393,myguoswaseiwauyi.org,dga,3.52193,9,10,20,1,0.9,0.1761,1,0,0,0,1,2,0,0,0,2
2175,pull-flv-l16-gcp01.tiktokcdn.com.atomile.com,legit,4.14411,9,24,44,0,0.375,0.09418,10,10,13,11,44,7,2,1,0,10
5046,oxreecwuoh.ddns.net,dga,3.57662,6,11,19,1,0.54545,0.18824,3,1,0,0,4,6,3,2,2,13
2830,teams-mira-afd.trafficmanager.net,legit,3.61154,11,18,33,0,0.61111,0.10944,11,3,1,3,18,10,1,0,0,11
2662,adclick.g.doubleclick.net,legit,3.62347,7,15,25,0,0.46667,0.14494,6,0,0,0,6,4,0,0,0,4
1559,ocsp.rootca1.amazontrust.com,legit,3.49917,9,15,28,0,0.6,0.12497,10,1,3,3,17,5,0,0,0,5
6259,fklngawwqbfkj.biz,dga,3.61687,2,14,17,1,0.14286,0.21276,0,0,0,0,0,0,0,0,0,0
3043,array603.prod.do.dsp.mp.microsoft.com,legit,3.71259,8,20,37,0,0.4,0.10034,12,12,10,9,43,5,2,0,0,7
1499,i1.ytimg.com,legit,3.08496,3,6,12,0,0.5,0.25708,1,0,0,0,1,1,0,0,0,1
908,main.endpoint.ingress.rapid7.com,legit,3.75,10,17,32,0,0.58824,0.11719,10,1,0,0,11,7,3,0,0,10
7825,pwrncfcvdmzamomxqnh.com,dga,3.79509,3,19,23,1,0.15789,0.165,1,0,0,0,1,2,0,0,0,2
8924,irkscnopqleb.in,dga,3.64022,4,10,15,1,0.4,0.24268,1,0,0,0,1,1,0,0,0,1
4669,lnkd.demdex.net,legit,3.00624,3,10,15,0,0.3,0.20042,2,0,0,0,2,3,0,0,0,3
6039,mckgayoaqwcasgak.org,dga,3.38418,6,13,20,1,0.46154,0.16921,0,0,0,0,0,2,0,0,0,2
5836,ilmrmxu270u4kvm2qra.ddns.net,dga,4.20897,5,16,28,1,0.3125,0.15032,3,1,0,0,4,5,4,3,2,14
6213,crmnsewvd.com,dga,3.39275,2,10,13,1,0.2,0.26098,2,0,0,0,2,2,1,0,0,3
1998,webpkgcache.com,legit,3.45656,4,10,15,0,0.4,0.23044,0,0,0,0,0,2,0,0,0,2
2526,dprodmgd105.aa-rt.sharepoint.com,legit,4.06955,8,17,32,0,0.47059,0.12717,6,2,1,0,9,3,1,0,0,4
8091,luoqhnaaoaul.com,dga,3.15564,8,7,16,1,1.14286,0.19723,0,0,0,0,0,0,0,0,0,0
7752,iuokmsiugkeq.info,dga,3.45482,8,8,17,1,1.0,0.20322,0,0,0,0,0,1,0,3,2,6
832,sync.crwdcntrl.net,legit,3.30827,1,15,18,0,0.06667,0.18379,3,0,0,0,3,0,0,0,0,0
3943,h.parrable.com,legit,3.37878,4,8,14,0,0.5,0.24134,2,0,0,0,2,3,0,0,0,3
4209,c.riskified.com,legit,3.32323,5,8,15,0,0.625,0.22155,1,0,0,0,1,3,1,0,0,4
7118,ytfraa.ie,dga,2.9477,4,4,9,1,1.0,0.32752,1,0,0,0,1,1,0,0,0,1
2690,prod-mediate-events.applovin.com,legit,3.89032,11,17,32,0,0.64706,0.12157,14,6,3,1,24,6,3,0,0,9
9263,emuesyqkeaiiigwc.org,dga,3.74644,9,10,20,1,0.9,0.18732,2,0,0,0,2,3,0,0,0,3
4846,assets.nflxext.com,legit,3.46132,4,12,18,0,0.33333,0.1923,2,0,0,0,2,3,1,0,0,4
4229,ios.prod.cloud.netflix.com,legit,3.77736,8,14,26,0,0.57143,0.14528,8,7,6,4,25,2,1,0,0,3
6769,ftjixnbrsckucr.net,dga,3.72548,3,14,18,1,0.21429,0.20697,1,0,0,0,1,0,0,0,0,0
8867,genknqfqbex.com,dga,3.50689,3,11,15,1,0.27273,0.23379,2,0,0,0,2,3,3,2,1,9
5861,axmnytrgrdr.com,dga,3.45656,2,12,15,1,0.16667,0.23044,0,0,0,0,0,0,0,0,0,0
3046,msua06.manage.microsoft.com,legit,3.78212,9,13,27,0,0.69231,0.14008,9,9,7,8,33,6,0,0,0,6
5015,jhhokenniuywfnmm.eu,dga,3.57662,6,12,19,1,0.5,0.18824,1,0,0,0,1,2,0,0,0,2
6092,bmpivjuuyp.tw,dga,3.39275,3,9,13,1,0.33333,0.26098,1,0,0,0,1,0,0,0,0,0
3324,avcdn.net,legit,2.9477,2,6,9,0,0.33333,0.32752,2,1,0,0,3,1,0,0,0,1
3496,dualstack.tls13.taboola.map.fastly.net,legit,3.84046,10,21,38,0,0.47619,0.10106,8,1,0,0,9,6,0,0,0,6
2475,fluidpreview.office.net,legit,3.67531,9,12,23,0,0.75,0.1598,5,4,4,3,16,3,0,0,0,3
309,ade.googlesyndication.com,legit,3.68386,10,13,25,0,0.76923,0.14735,9,5,4,3,21,9,3,2,1,15
6507,qycfvfephpli.com,dga,3.625,3,12,16,1,0.25,0.22656,2,0,0,0,2,0,0,0,0,0
1241,cloudsearch.googleapis.com,legit,3.74833,10,14,26,0,0.71429,0.14417,9,9,6,5,29,5,0,0,0,5
2610,www.msftncsi.com,legit,3.20282,2,12,16,0,0.16667,0.20018,1,0,0,0,1,1,0,0,0,1
1672,betweendigital.com,legit,3.68354,7,10,18,0,0.7,0.20464,2,0,0,0,2,6,1,0,0,7
3630,sendgrid.net,legit,3.08496,3,8,12,0,0.375,0.25708,2,0,0,0,2,4,0,0,0,4
5387,fayifybfn.cd,dga,3.02206,2,9,12,1,0.22222,0.25184,0,0,0,0,0,0,0,0,0,0
6733,nkojukpvfchfos.net,dga,3.72548,4,13,18,1,0.30769,0.20697,0,0,0,0,0,0,0,0,0,0
9626,unions-providers.cn,dga,3.57662,6,11,19,1,0.54545,0.18824,4,1,0,0,5,5,3,0,0,8
8216,buxvifup.ru,dga,3.02717,4,6,11,1,0.66667,0.2752,0,0,0,0,0,0,0,0,0,0
1565,taskassist-pa.clients6.google.com,legit,3.81321,10,18,33,0,0.55556,0.11555,8,6,4,3,21,7,3,0,0,10
229,sentry.io,legit,3.16993,3,5,9,0,0.6,0.35221,3,1,0,0,4,2,1,0,0,3
292,safebrowsing.apple,legit,3.72548,6,11,18,0,0.54545,0.20697,2,0,0,0,2,2,1,0,0,3
4582,comcast.net,legit,3.0958,3,7,11,0,0.42857,0.28144,2,2,0,0,4,5,1,0,0,6
7303,pyrfpsoiptcux.com,dga,3.57247,4,12,17,1,0.33333,0.21015,0,0,0,0,0,0,0,0,0,0
4834,epdg.epc.geo.mnc260.mcc310.pub.3gppnetwork.org,legit,4.00147,8,24,46,0,0.33333,0.08699,3,0,0,0,3,4,0,0,0,4
9185,nfnyybxzcx.com,dga,3.23593,1,12,14,1,0.08333,0.23114,0,0,0,0,0,0,0,0,0,0
39,preapp.prod.partner.netflix.net,legit,3.43422,8,19,31,0,0.42105,0.11078,10,5,3,2,20,6,1,0,0,7
9177,coclelcbfdmfboel.com,dga,3.04644,5,14,20,1,0.35714,0.15232,2,0,0,0,2,3,0,0,0,3
8366,usuautemomministerio.com,dga,3.40727,12,11,24,1,1.09091,0.14197,6,0,0,0,6,11,3,0,0,14
2338,spotim.market,legit,3.39275,4,8,13,0,0.5,0.26098,1,0,0,0,1,1,0,0,0,1
8372,fnrrixuuxcpq.com,dga,3.5,4,11,16,1,0.36364,0.21875,0,0,0,0,0,1,0,0,0,1
4754,usage.trackjs.com,legit,3.61687,5,10,17,0,0.5,0.21276,5,1,0,0,6,3,1,0,0,4
5171,qhsuvxcug.com,dga,3.39275,3,9,13,1,0.33333,0.26098,0,0,0,0,0,1,0,0,0,1
9936,sitescoverage.ad,dga,3.45282,7,8,16,1,0.875,0.2158,6,1,0,0,7,9,2,0,0,11
4168,gos-gsp.io,legit,2.72193,3,5,10,0,0.6,0.27219,0,0,0,0,0,0,0,0,0,0
4763,discordapp.net,legit,3.52164,4,9,14,0,0.44444,0.25155,3,1,0,0,4,3,0,0,0,3
3283,espncdn.com,legit,3.0958,2,8,11,0,0.25,0.28144,3,1,0,0,4,2,0,0,0,2
9168,cddlldgooncb.com,dga,2.98346,3,12,16,1,0.25,0.18647,3,1,0,0,4,2,0,0,0,2
7821,rwbhzxwxsnc.cc,dga,3.18201,0,13,14,1,0.0,0.22729,0,0,0,0,0,0,0,0,0,0
5262,kpvzmlypyy.com,dga,3.18201,1,12,14,1,0.08333,0.22729,0,0,0,0,0,0,0,0,0,0
654,chat.google.com,legit,3.1899,5,8,15,0,0.625,0.21266,3,5,4,3,15,2,1,0,0,3
6744,wwgcgmeocwiywcii.org,dga,3.10869,6,13,20,1,0.46154,0.15543,0,0,0,0,0,0,0,0,0,0
4774,omappapi.com,legit,2.68872,5,6,12,0,0.83333,0.22406,4,2,0,0,6,2,0,0,0,2
6872,xsvstubrrerm.com,dga,3.45282,3,12,16,1,0.25,0.2158,3,0,0,0,3,3,0,0,0,3
3717,yahoodisplay873773666324.s.moatpixel.com,legit,4.22757,10,15,40,0,0.66667,0.10569,6,0,0,1,7,4,0,0,0,4
419,messaging.engagement.office.com,legit,3.47438,11,17,31,0,0.64706,0.11208,8,6,4,3,21,7,3,0,0,10
4818,geo.prod.do.dsp.trafficmanager.net,legit,3.75264,10,19,34,0,0.52632,0.11037,12,7,4,5,28,7,3,0,0,10
249,weather.microsoft.com,legit,3.59447,7,12,21,0,0.58333,0.17117,9,8,7,6,30,5,1,1,1,8
9415,ecigasuiwcymao.net,dga,3.72548,8,9,18,1,0.88889,0.20697,1,0,0,0,1,4,0,5,4,13
7055,zbotydrjlj.com,dga,3.52164,2,11,14,1,0.18182,0.25155,0,0,0,0,0,0,0,0,0,0
408,i.instagram.com,legit,3.37356,5,8,15,0,0.625,0.2249,5,0,0,0,5,6,0,0,0,6
8106,xjzxhuuwehtusjrqsjbtqg.info,dga,4.0323,6,20,27,1,0.3,0.14934,1,0,0,0,1,0,0,0,0,0
8528,qiokiwmaul.ddns.net,dga,3.82687,6,11,19,1,0.54545,0.20141,3,1,0,0,4,5,3,2,1,11
4888,temu.com,legit,2.75,3,4,8,0,0.75,0.34375,1,0,0,0,1,2,0,0,0,2
9931,rsyekpkofk.com,dga,3.32486,3,10,14,1,0.3,0.23749,1,0,0,0,1,0,0,0,0,0
4879,webcast22-ws-useast2a.tiktokv.com,legit,3.84713,9,17,33,0,0.52941,0.11658,6,6,4,3,19,6,0,0,0,6
3951,w183.akamai.net,legit,3.45656,5,5,15,0,1.0,0.23044,3,3,4,3,13,2,0,0,0,2
6566,cdeepqvtjorviihs.eu,dga,3.78714,7,11,19,1,0.63636,0.19932,1,0,0,0,1,2,0,0,0,2
8461,horokgic.ru,dga,3.0958,4,6,11,1,0.66667,0.28144,2,0,0,0,2,2,0,0,0,2
1723,filedownload.lenovo.com,legit,3.46423,9,12,23,0,0.75,0.15062,6,0,0,0,6,3,0,0,0,3
9774,znqsqpcn.dyndns.org,dga,3.40582,1,16,19,1,0.0625,0.17925,2,1,0,0,3,4,3,4,3,14
9778,facebcbdlmfodkbf.com,dga,3.30869,4,15,20,1,0.26667,0.16543,1,0,0,0,1,2,0,0,0,2
6112,txdokpyrqtrhtlwt.eu,dga,3.72161,3,15,19,1,0.2,0.19587,0,0,0,0,0,0,0,0,0,0
8834,sudxcjtklplyupxn.eu,dga,3.68188,4,14,19,1,0.28571,0.19378,1,0,0,0,1,1,0,0,0,1
798,siteintercept.qualtrics.com,legit,3.70805,9,16,27,0,0.5625,0.13734,6,0,0,0,6,8,1,1,0,10
2070,region1.google-analytics.com,legit,3.85182,10,14,28,0,0.71429,0.13756,6,5,4,3,18,6,1,0,0,7
4611,ad.sxp.smartclip.net,legit,3.68418,4,13,20,0,0.30769,0.18421,5,0,0,0,5,2,0,0,0,2
8591,hpodlk.com,dga,3.12193,2,7,10,1,0.28571,0.31219,0,0,0,0,0,0,0,0,0,0
593,trc.taboola.com,legit,3.05656,5,8,15,0,0.625,0.20377,3,0,0,0,3,2,0,0,0,2
7807,pupedo.info,dga,3.0958,5,5,11,1,1.0,0.28144,1,0,0,0,1,1,0,0,0,1
2557,cdn.permutive.com,legit,3.61687,5,10,17,0,0.5,0.21276,4,2,1,0,7,4,0,0,0,4
9787,tvoertiviklrlnj.biz,dga,3.57662,5,13,19,1,0.38462,0.18824,2,0,0,0,2,2,0,0,0,2
645,espresso-pa.clients6.google.com,legit,3.76855,10,16,31,0,0.625,0.12157,9,6,4,3,22,4,3,0,0,7
8240,banlifoj.ru,dga,3.45943,4,6,11,1,0.66667,0.31449,1,0,0,0,1,1,0,0,0,1
6563,tdtdsfebcdox.xyz,dga,3.45282,2,13,16,1,0.15385,0.2158,2,0,0,0,2,0,0,0,0,0
9380,ecdbmffmoabffbac.co.uk,dga,3.2999,6,14,22,1,0.42857,0.15,3,1,0,0,4,3,1,0,0,4
8416,xdnutcgrlbdkqakwy.pw,dga,4.02193,2,17,20,1,0.11765,0.2011,1,0,0,0,1,1,0,0,0,1
5435,yjmhurcro2wt10o41hafyhe.ddns.net,dga,4.28891,6,19,32,1,0.31579,0.13403,5,2,0,0,7,4,4,3,2,13
893,polka.typekit.com,legit,3.49923,5,10,17,0,0.5,0.20584,1,0,0,0,1,1,0,0,0,1
1853,mv.outbrain.com,legit,3.50689,5,8,15,0,0.625,0.23379,3,0,0,0,3,2,0,0,0,2
8276,frhtm39gqgwbyhze51jwm29f42p32j26jra27m29.ru,dga,4.3907,3,23,43,1,0.13043,0.10211,1,0,0,0,1,1,0,0,0,1
7354,pupyteg.com,dga,3.27761,3,7,11,1,0.42857,0.29796,1,0,0,0,1,1,0,0,0,1
5990,isesautquibusveritate.com,dga,3.61288,12,12,25,1,1.0,0.14452,7,0,0,0,7,10,4,0,0,14
7519,aqheawakic.ddns.net,dga,3.57662,6,11,19,1,0.54545,0.18824,4,1,0,0,5,6,3,2,2,13
3447,prmutv.co,legit,3.16993,2,6,9,0,0.33333,0.35221,1,0,0,0,1,0,0,0,0,0
314,lh3.google.com,legit,3.03915,4,7,14,0,0.57143,0.21708,2,5,4,3,14,1,0,0,0,1
565,eus.rubiconproject.com,legit,3.66353,8,12,22,0,0.66667,0.16652,7,2,0,0,9,4,2,0,0,6
1622,sync.adotmob.com,legit,3.32782,4,10,16,0,0.4,0.20799,2,0,0,0,2,0,0,0,0,0
867,quantcount.com,legit,3.09307,5,8,14,0,0.625,0.22093,3,0,0,0,3,2,0,0,0,2
6381,vatgowoh.ru,dga,3.27761,4,6,11,1,0.66667,0.29796,1,0,0,0,1,1,0,0,0,1
5198,henriettajosephson.net,dga,3.39081,8,13,22,1,0.61538,0.15413,4,0,0,0,4,6,0,0,0,6
6204,dpwbaekxkrvvvtmsa.tw,dga,3.68418,3,16,20,1,0.1875,0.18421,0,0,0,0,0,0,0,0,0,0
7246,njozeabqvduhhqswtwltsizeup.biz,dga,4.14839,8,21,30,1,0.38095,0.13828,1,0,0,0,1,2,0,0,0,2
7797,yfsd2v4taro9.net,dga,3.875,3,9,16,1,0.33333,0.24219,2,0,0,0,2,2,0,0,0,2
9497,jixqwubsijwdspudo.su,dga,3.44644,6,13,20,1,0.46154,0.17232,1,0,0,0,1,1,0,0,0,1
9398,ylylutfow.cc,dga,3.08496,2,9,12,1,0.22222,0.25708,0,0,0,0,0,0,0,0,0,0
2556,winatp-gw-neu.microsoft.com,legit,3.98619,8,15,27,0,0.53333,0.14764,8,8,7,6,29,5,0,0,0,5
5625,sijoysssar.com,dga,3.09307,4,9,14,1,0.44444,0.22093,0,0,0,0,0,2,0,0,0,2
1607,roaming1.live.com.akadns.net,legit,3.89629,9,14,28,0,0.64286,0.13915,11,6,7,8,32,8,4,1,0,13
1944,amazonalexa.com,legit,3.10689,7,7,15,0,1.0,0.20713,4,1,3,2,10,4,0,0,0,4
8117,5x7fwte2gdmdox5fgj7.ddns.net,dga,3.87878,3,18,28,1,0.16667,0.13853,3,1,0,0,4,5,3,3,2,13
3234,prod-m-node-1111.ssp.advertising.com,legit,3.95397,8,18,36,0,0.44444,0.10983,8,2,1,0,11,7,3,0,0,10
1326,secure.insightexpressai.com,legit,3.76397,10,15,27,0,0.66667,0.13941,7,0,0,0,7,8,2,0,0,10
1483,edgeassetservice.azureedge.net,legit,3.39742,13,15,30,0,0.86667,0.11325,10,4,2,3,19,10,3,1,0,14
8360,kwlczsyzmf.com,dga,3.37878,1,12,14,1,0.08333,0.24134,0,0,0,0,0,0,0,0,0,0
5309,seddiluerepeccaindocte.com,dga,3.6095,11,14,26,1,0.78571,0.13883,6,0,0,0,6,10,1,0,0,11
3875,forms.hsforms.com,legit,2.89542,3,12,17,0,0.25,0.17032,1,0,0,0,1,1,0,0,0,1
6375,ezrvlch.net,dga,3.27761,2,8,11,1,0.25,0.29796,0,0,0,0,0,0,0,0,0,0
9225,aakckgmmacwuiowu.org,dga,3.38418,8,11,20,1,0.72727,0.16921,1,0,0,0,1,2,0,0,0,2
7278,awyobguiwcymao.info,dga,3.57662,8,10,19,1,0.8,0.18824,1,0,0,0,1,1,0,5,4,10
5695,ivsemlyxehgrdkkl.eu,dga,3.78714,5,13,19,1,0.38462,0.19932,1,0,0,0,1,2,0,0,0,2
1802,a.audrte.com,legit,3.25163,5,5,12,0,1.0,0.27097,2,0,0,0,2,1,0,0,0,1
3284,popin.cc,legit,2.5,2,5,8,0,0.4,0.3125,2,0,0,0,2,1,0,0,0,1
7884,whivwwgxdifj.com,dga,3.57782,3,12,16,1,0.25,0.22361,0,0,0,0,0,0,0,0,0,0
8587,narraturveresitverapecu.com,dga,3.5562,11,15,27,1,0.73333,0.13171,6,0,0,0,6,10,4,0,0,14
6209,spendelse.net,dga,2.77736,4,8,13,1,0.5,0.21364,2,0,0,0,2,5,0,0,0,5
6613,emuawiwmumqwicqq.org,dga,3.40869,7,12,20,1,0.58333,0.17043,1,0,0,0,1,2,0,0,0,2
5628,fcbbvsgclmpo.ru,dga,3.64022,2,12,15,1,0.16667,0.24268,0,0,0,0,0,0,0,0,0,0
3549,pull-flv-l1-sg01.tiktokcdn.com,legit,4.08173,4,18,30,0,0.22222,0.13606,4,6,9,9,28,2,0,0,0,2
7811,eofngtdyuhkrlcwj.eu,dga,4.0374,5,13,19,1,0.38462,0.21249,1,0,0,0,1,0,0,0,0,0
7714,vsojbhtdeoxvxpqopguy.com,dga,4.00163,6,17,24,1,0.35294,0.16673,0,0,0,0,0,1,0,0,0,1
4858,st2-v3-dc.splashtop.com,legit,3.79509,3,14,23,0,0.21429,0.165,2,0,0,0,2,3,0,0,0,3
1481,presence.services.sfb.trafficmanager.net,legit,3.65515,12,24,40,0,0.5,0.09138,14,5,2,4,25,11,5,2,0,18
4333,www.mozilla.org,legit,3.1899,4,9,15,0,0.44444,0.21266,1,0,0,0,1,1,0,0,0,1
4676,locationhistoryaggregates-pa.googleapis.com,legit,3.85072,17,23,43,0,0.73913,0.08955,13,6,4,4,27,12,5,2,1,20
1096,trace.mediago.io,legit,3.375,8,6,16,0,1.33333,0.21094,5,0,0,0,5,4,1,0,0,5
5215,gsrbgwecdgjidgdc.eu,dga,3.36609,4,14,19,1,0.28571,0.17716,1,0,0,0,1,1,0,0,0,1
1024,api-global.netflix.com,legit,3.87966,7,12,22,0,0.58333,0.17635,4,1,0,0,5,2,0,0,0,2
3119,dscg1.akamai.net,legit,3.57782,5,8,16,0,0.625,0.22361,4,3,4,3,14,2,0,0,0,2
9430,cirgizwshjvdyndzlnvivd.ru,dga,3.83327,4,20,25,1,0.2,0.15333,0,0,0,0,0,1,1,1,0,3
6894,asikwili.ddns.net,dga,3.33718,5,10,17,1,0.5,0.1963,3,1,0,0,4,6,4,3,2,15
4547,mobile-webview.gmail.com,legit,3.57393,9,12,24,0,0.75,0.14891,2,0,0,0,2,2,0,0,0,2
9506,teachers-pike.cm,dga,3.57782,5,9,16,1,0.55556,0.22361,4,0,0,0,4,4,2,0,0,6
8220,christimfitculpam.com,dga,3.61781,6,14,21,1,0.42857,0.17228,3,0,0,0,3,6,2,0,2,10
2076,cloud.unity3d.com,legit,3.49923,5,9,17,0,0.55556,0.20584,3,3,2,1,9,2,0,0,0,2
1506,beacons5.gvt3.com,legit,3.73452,4,9,17,0,0.44444,0.21968,3,1,0,0,4,6,1,0,0,7
855,platform.twitter.com,legit,3.52193,5,13,20,0,0.38462,0.1761,5,0,0,0,5,6,1,0,0,7
4494,l.sharethis.com,legit,3.50689,4,9,15,0,0.44444,0.23379,1,0,0,0,1,4,0,0,0,4
1942,udc-neb.kampyle.com,legit,3.82687,5,11,19,0,0.45455,0.20141,2,0,0,0,2,3,0,0,0,3
7397,dietspraybecomesentencecelebrate.com,dga,3.63425,14,21,36,1,0.66667,0.10095,11,2,0,0,13,14,4,1,0,19
3999,ip1.ads.stickyadstv.com.akadns.net,legit,3.76042,8,20,34,0,0.4,0.1106,10,6,7,7,30,7,3,1,0,11
1538,app.pendo.io,legit,2.85539,5,5,12,0,1.0,0.23795,4,1,0,0,5,2,0,0,0,2
6087,lctmufr.com,dga,3.0958,2,8,11,1,0.25,0.28144,0,0,0,0,0,0,0,0,0,0
5551,vguklczukp.com,dga,3.37878,3,10,14,1,0.3,0.24134,0,0,0,0,0,0,0,0,0,0
1594,api2.amplitude.com,legit,3.61437,7,8,18,0,0.875,0.2008,6,1,0,0,7,3,0,0,0,3
2351,beacon-nf.rubiconproject.com,legit,3.78039,9,16,28,0,0.5625,0.13501,6,2,0,0,8,7,2,0,0,9
7161,lygyvar.com,dga,3.27761,2,8,11,1,0.25,0.29796,0,0,0,0,0,1,0,0,0,1
599,stocks-data-service.apple.com,legit,3.85731,9,16,29,0,0.5625,0.13301,13,6,4,3,26,8,2,1,0,11
2626,x3-policy-maker.goguardian.com,legit,4.12323,10,15,30,0,0.66667,0.13744,4,1,0,0,5,5,0,0,0,5
6611,nwkotstqkjckrknew.pw,dga,3.48418,2,17,20,1,0.11765,0.17421,1,0,0,0,1,2,0,0,0,2
5639,fqicuftc.net,dga,3.08496,3,8,12,1,0.375,0.25708,1,0,0,0,1,1,0,0,0,1
8585,hxxxuxygroxf.biz,dga,3.2744,3,12,16,1,0.25,0.20465,1,0,0,0,1,0,0,0,0,0
2921,ovc.gslb.rocket-cdn.com,legit,3.76227,4,15,23,0,0.26667,0.16358,3,1,0,0,4,2,0,0,0,2
5027,pksnprwyupqtsii.net,dga,3.57662,4,14,19,1,0.28571,0.18824,1,0,0,0,1,1,0,0,0,1
1110,identity.nel.measure.office.net,legit,3.67115,12,15,31,0,0.8,0.11842,10,5,4,3,22,12,1,0,0,13
4672,w3-reporting-nel.reddit.com,legit,3.88416,7,15,27,0,0.46667,0.14386,4,0,0,0,4,9,1,0,0,10
967,sensor.cloud.tenable.com,legit,3.65727,8,13,24,0,0.61538,0.15239,9,3,3,2,17,6,0,0,0,6
9500,validity-estonia.com,dga,3.78418,8,10,20,1,0.8,0.18921,4,0,0,0,4,5,1,0,0,6
2263,43-courier.push.apple.com,legit,3.86347,8,11,25,0,0.72727,0.15454,9,4,3,2,18,4,0,0,0,4
8619,jupreora.ru,dga,2.84535,5,5,11,1,1.0,0.25867,3,0,0,0,3,3,0,0,0,3
3920,a29.us.akamai.net,legit,3.33718,7,5,17,0,1.4,0.1963,5,3,4,3,15,2,0,0,0,2
1343,google-bidout-d.openx.net,legit,3.65366,9,12,25,0,0.75,0.14615,5,4,3,2,14,2,0,0,0,2
4814,com.ssl.sc.omtrdc.net,legit,3.2728,3,14,21,0,0.21429,0.15585,1,2,1,0,4,2,1,0,0,3
4012,playerserver.walkme.com,legit,3.62118,7,14,23,0,0.5,0.15744,3,1,1,0,5,4,4,1,0,9
1413,lfodown01-b.cloudsink.net,legit,4.02347,6,14,25,0,0.42857,0.16094,5,3,3,2,13,2,0,0,0,2
5700,jorugmup.ru,dga,2.84535,4,6,11,1,0.66667,0.25867,0,0,0,0,0,1,0,0,0,1
15,prod.ftl.netflix.com,legit,3.68418,4,13,20,0,0.30769,0.18421,4,3,2,1,10,2,1,0,0,3
4383,public.servenobid.com,legit,3.82089,7,12,21,0,0.58333,0.18195,5,1,1,0,7,5,2,1,0,8
5994,fumxaqmx.com,dga,3.02206,3,8,12,1,0.375,0.25184,0,0,0,0,0,0,0,0,0,0
2479,normandy.cdn.mozilla.net,legit,3.63684,6,15,24,0,0.4,0.15154,5,2,1,0,8,6,1,0,0,7
2145,a1168.z.akamai.net,legit,3.35021,6,5,18,0,1.2,0.18612,3,3,4,3,13,2,0,0,0,2
8221,ynmiapgokhspic.pw,dga,3.69012,4,12,17,1,0.33333,0.21707,4,0,0,0,4,2,0,0,0,2
7202,abbdldkfnennmbfe.eu,dga,3.28663,5,13,19,1,0.38462,0.17298,1,0,0,0,1,2,0,0,0,2
3240,gysm.yahoodns.net,legit,3.49923,4,11,17,0,0.36364,0.20584,2,1,0,1,4,2,1,0,0,3
9955,iqeyygyoyksyuwcu.org,dga,3.44145,6,13,20,1,0.46154,0.17207,0,0,0,0,0,0,0,0,0,0
6755,lkktwgrtjddl.net,dga,3.32782,1,14,16,1,0.07143,0.20799,0,0,0,0,0,1,0,0,0,1
6905,kaoq82suwmkq.net,dga,3.75,4,9,16,1,0.44444,0.23438,0,0,0,0,0,1,0,0,0,1
9417,oddkjazqpo.com,dga,3.32486,4,9,14,1,0.44444,0.23749,0,0,0,0,0,1,0,0,0,1
5411,gakepadainqu.ddns.net,dga,3.52257,7,12,21,1,0.58333,0.16774,4,1,0,0,5,5,3,3,2,13
7031,survive-founder.net,dga,3.57662,7,10,19,1,0.7,0.18824,2,0,0,0,2,5,0,0,0,5
4010,acctcdn.msftauth.net,legit,3.38418,4,14,20,0,0.28571,0.16921,4,2,1,0,7,3,0,0,0,3
4079,page.cdnbasket.net,legit,3.46132,5,11,18,0,0.45455,0.1923,5,2,0,0,7,4,0,0,0,4
6885,bctpxuru.dj,dga,3.27761,2,8,11,1,0.25,0.29796,0,0,0,0,0,0,0,0,0,0
8337,islumoww.com,dga,3.08496,4,7,12,1,0.57143,0.25708,0,0,0,0,0,1,0,0,0,1
8996,lafccnccaakcafnf.de,dga,2.86032,5,13,19,1,0.38462,0.15054,0,0,0,0,0,2,0,0,0,2
1780,a1948.z.akamai.net,legit,3.46132,6,5,18,0,1.2,0.1923,3,3,4,3,13,2,0,0,0,2
7323,impiovquestumconcordia.com,dga,3.76718,11,14,26,1,0.78571,0.14489,5,1,0,0,6,5,2,0,0,7
4831,global.xiaomi.net,legit,3.49923,7,8,17,0,0.875,0.20584,2,0,0,0,2,2,0,0,0,2
2551,cloud.tanium.com,legit,3.375,6,8,16,0,0.75,0.21094,5,3,2,1,11,3,0,0,0,3
1431,raindrop-a.wbx2.com,legit,3.82687,5,10,19,0,0.5,0.20141,3,0,0,0,3,3,0,0,0,3
9405,rprirsoypnfuhwm.biz,dga,3.78714,4,14,19,1,0.28571,0.19932,1,0,0,0,1,1,0,0,0,1
4413,su.addthis.com,legit,3.37878,4,8,14,0,0.5,0.24134,2,0,0,0,2,3,0,0,0,3
5703,chkwxyxjpmtg.ru,dga,3.77356,1,13,15,1,0.07692,0.25157,0,0,0,0,0,0,0,0,0,0
7117,j26lsj36pycrg23n40hsa67kri55g33cxh64k67n50.com,dga,4.41227,3,22,46,1,0.13636,0.09592,1,0,0,0,1,1,0,0,0,1
8936,qfof3hm434s21te4ungb5hq.ddns.net,dga,4.14032,4,18,32,1,0.22222,0.12938,4,1,0,0,5,5,3,3,2,13
4230,aadcdn.msauthimages.net,legit,3.56704,8,13,23,0,0.61538,0.15509,7,3,1,0,11,4,0,0,0,4
2054,duosecurity.com,legit,3.50689,6,8,15,0,0.75,0.23379,1,0,0,0,1,4,0,0,0,4
5272,ringdaily.net,dga,3.39275,4,8,13,1,0.5,0.26098,1,0,0,0,1,2,2,0,0,4
5607,jivvhvuhnusjmert.eu,dga,3.43162,6,12,19,1,0.5,0.18061,2,0,0,0,2,1,0,0,0,1
8021,xwkvuz.md,dga,3.16993,1,7,9,1,0.14286,0.35221,0,0,0,0,0,0,0,0,0,0
4588,splashtop.com,legit,3.2389,3,9,13,0,0.33333,0.24915,1,0,0,0,1,2,0,0,0,2
8409,weamufor.ru,dga,3.0958,5,5,11,1,1.0,0.28144,2,0,0,0,2,3,0,0,0,3
8483,pozweisu.ru,dga,3.27761,5,5,11,1,1.0,0.29796,0,0,0,0,0,2,0,0,0,2
2532,semanticlocation-pa.googleapis.com,legit,3.7016,14,17,34,0,0.82353,0.10887,13,7,4,4,28,12,3,2,1,18
4728,sdkconfig.ad.intl.xiaomi.com,legit,3.70897,9,15,28,0,0.6,0.13246,8,1,0,0,9,5,1,0,0,6
8692,ytgzlqutsrj.mooo.com,dga,3.62193,5,13,20,1,0.38462,0.1811,2,0,0,0,2,0,1,2,1,4
5396,okndlffaabmflbam.com,dga,3.30869,5,14,20,1,0.35714,0.16543,1,0,0,0,1,2,0,0,0,2
9625,xvsuyytednnpgxkcuppi.nu,dga,3.72945,5,17,23,1,0.29412,0.16215,5,0,0,0,5,4,0,0,0,4
4455,api-glb-ause1b.smoot.apple.com,legit,3.87291,10,14,30,0,0.71429,0.1291,9,5,3,2,19,2,0,0,0,2
1373,uidapi.com,legit,3.12193,5,4,10,0,1.25,0.31219,2,1,0,0,3,0,0,0,0,0
7301,xeogeiva.ru,dga,3.27761,6,4,11,1,1.5,0.29796,1,0,0,0,1,1,0,0,0,1
8411,yqtoxfjwpfn.com,dga,3.64022,2,12,15,1,0.16667,0.24268,0,0,0,0,0,0,0,0,0,0
4217,twilio.com,legit,2.92193,4,5,10,0,0.8,0.29219,1,0,0,0,1,0,0,0,0,0
7165,faitemcumagistris.com,dga,3.55852,8,12,21,1,0.66667,0.16945,3,0,0,0,3,7,2,0,0,9
5162,kdnuubhltkc.net,dga,3.37356,3,11,15,1,0.27273,0.2249,1,0,0,0,1,1,0,0,0,1
9364,whichhouse.net,dga,3.32486,5,8,14,1,0.625,0.23749,4,0,0,0,4,2,0,0,0,2
8835,2oik60ywagaw.net,dga,3.75,5,7,16,1,0.71429,0.23438,0,0,0,0,0,0,0,0,0,0
3251,gue1-spclient.spotify.com,legit,4.00386,7,14,25,0,0.5,0.16015,4,1,0,0,5,2,1,0,0,3
3560,us-sandbox-courier-4.push-apple.com.akadns.net,legit,4.18064,14,23,46,0,0.6087,0.09088,13,9,9,9,40,9,4,1,0,14
5546,mygsjh.dynserv.com,dga,3.72548,2,14,18,1,0.14286,0.20697,3,1,1,0,5,4,5,5,4,18
6723,eupbmftocahaypzbmmvbyjffah.com,dga,3.8314,7,22,30,1,0.31818,0.12771,0,0,0,0,0,1,0,0,0,1
9671,emcaoamikieswymy.org,dga,3.58418,8,11,20,1,0.72727,0.17921,3,0,0,0,3,5,0,0,0,5
2988,fcmatch.google.com,legit,3.30827,5,11,18,0,0.45455,0.18379,4,5,4,3,16,3,0,0,0,3
7502,apveedbinahe.ddns.net,dga,3.36804,7,12,21,1,0.58333,0.16038,6,1,0,0,7,7,4,3,2,16
4063,v4.a.prd.aadg.akadns.net,legit,3.33604,6,12,24,0,0.5,0.139,5,4,4,3,16,2,1,0,0,3
7328,rhcxclbchhuoxlchc.me,dga,3.14145,3,16,20,1,0.1875,0.15707,0,0,0,0,0,0,0,0,0,0
6666,pqdzoty.dynserv.com,dga,3.82687,3,14,19,1,0.21429,0.20141,3,1,1,0,5,4,5,5,4,18
3911,auth.services.adobe.com,legit,3.76227,9,11,23,0,0.81818,0.16358,8,2,1,1,12,6,2,1,0,9
6992,cxktgt3rs2enghs.ddns.net,dga,3.65727,2,18,24,1,0.11111,0.15239,4,1,0,0,5,5,3,3,2,13
5201,bjubwzd.com.bo,dga,3.18201,3,9,14,1,0.33333,0.22729,3,2,1,0,6,2,2,1,0,5
1587,brand-display.com,legit,3.85217,4,11,17,0,0.36364,0.2266,2,0,0,0,2,5,1,0,0,6
611,fna.fbcdn.net,legit,3.02699,2,9,13,0,0.22222,0.23285,2,1,0,0,3,1,0,0,0,1
7442,oekvhelhmuboge.com,dga,3.41938,7,10,18,1,0.7,0.18997,1,0,0,0,1,2,0,0,0,2
145,time.g.aaplimg.com,legit,3.30827,6,9,18,0,0.66667,0.18379,6,0,0,0,6,1,0,0,0,1
4772,cdn.jivox.com,legit,3.2389,3,8,13,0,0.375,0.24915,2,2,1,0,5,1,0,0,0,1
4934,api.tappx.com,legit,3.02699,4,7,13,0,0.57143,0.23285,5,2,1,0,8,1,0,0,0,1
6785,towekqcvnxyaebwm.eu,dga,3.89241,6,12,19,1,0.5,0.20486,0,0,0,0,0,0,0,0,0,0
948,pull-w5-va01.tiktokcdn.com,legit,4.16198,5,14,26,0,0.35714,0.16008,4,6,9,9,28,2,0,0,0,2
8143,alonefancy.net,dga,3.18201,5,8,14,1,0.625,0.22729,2,0,0,0,2,3,1,0,0,4
3233,adtilt.com,legit,3.12193,3,6,10,0,0.5,0.31219,2,0,0,0,2,1,0,0,0,1
310,snapchat.com,legit,3.25163,3,8,12,0,0.375,0.27097,2,0,0,0,2,1,1,0,0,2
8124,lawuewadq.ddns.net,dga,3.35021,5,11,18,1,0.45455,0.18612,3,1,0,0,4,5,3,3,2,13
7593,5nunypah1tc0evwlaje.ddns.net,dga,4.06611,6,17,28,1,0.35294,0.14522,3,1,0,0,4,5,4,3,2,14
2844,libra16-platform-useast5.us.tiktokv.com,legit,4.23362,11,20,39,0,0.55,0.10855,11,6,4,3,24,9,0,0,0,9
5429,feagichi.ru,dga,3.27761,5,5,11,1,1.0,0.29796,2,0,0,0,2,2,0,0,0,2
5736,obckbdboabbfaalb.co,dga,2.82585,6,12,19,1,0.5,0.14873,0,0,0,0,0,0,0,0,0,0
5871,gzgqnrsmtu.com,dga,3.52164,2,11,14,1,0.18182,0.25155,0,0,0,0,0,0,0,0,0,0
954,cloudflareinsights.com,legit,4.00489,7,14,22,0,0.5,0.18204,4,3,2,1,10,6,0,0,0,6
1055,pull-flv-l16-gcp01.tiktokcdn.com,legit,4.07782,4,19,32,0,0.21053,0.12743,4,6,9,9,28,2,0,0,0,2
3461,prod1.naturallanguageeditorservice.osi.office.net.akadns.net,legit,4.01038,23,30,60,0,0.76667,0.06684,15,11,10,7,43,17,5,1,0,23
7456,tbqwlsnobayitv.com,dga,3.83659,4,13,18,1,0.30769,0.21314,0,0,0,0,0,1,0,0,0,1
4628,widget.trustpilot.com,legit,3.72565,6,13,21,0,0.46154,0.17741,6,1,0,0,7,3,0,0,0,3
8818,1v5d56clsd1hg4sv1fg.ddns.net,dga,3.82486,1,18,28,1,0.05556,0.1366,2,1,0,0,3,4,3,3,2,12
9330,saxmeuix.cc,dga,3.0958,4,6,11,1,0.66667,0.28144,0,0,0,0,0,0,0,0,0,0
1147,accountcapabilities-pa.googleapis.com,legit,3.7942,16,18,37,0,0.88889,0.10255,11,6,4,4,25,9,0,0,0,9
1140,cdn.mozilla.net,legit,3.50689,4,9,15,0,0.44444,0.23379,3,2,1,0,6,2,0,0,0,2
1626,cf.iadsdk.apple.com,legit,3.57662,5,11,19,0,0.45455,0.18824,7,4,3,2,16,1,0,0,0,1
5032,slut-fans.sh,dga,3.18872,2,8,12,1,0.25,0.26573,0,0,0,0,0,2,1,0,0,3
682,gcp.api.snapchat.com,legit,3.37095,5,12,20,0,0.41667,0.16855,5,2,1,0,8,1,1,0,0,2
6567,jqseenipxeywhen.com,dga,3.72161,6,12,19,1,0.5,0.19587,2,0,0,0,2,3,0,0,0,3
6072,answerbornbikefirmlecture.com,dga,3.89246,10,18,29,1,0.55556,0.13422,3,0,0,0,3,7,2,0,0,9
8674,bmfmldfaobaabblb.online,dga,3.2575,7,15,23,1,0.46667,0.14163,0,0,0,0,0,0,0,0,0,0
1862,tiktokcdn.com.c.worldfcdn.com,legit,3.4661,5,20,29,0,0.25,0.11952,5,9,9,6,29,5,2,1,0,8
3434,s.ntv.io,legit,2.75,2,4,8,0,0.5,0.34375,2,0,0,0,2,0,0,0,0,0
3374,global.px.quantserve.com,legit,4.05351,7,14,24,0,0.5,0.1689,4,1,1,0,6,4,2,1,0,7
9966,sapmltcyqtvddcy.com,dga,3.57662,2,16,19,1,0.125,0.18824,1,0,0,0,1,1,0,0,0,1
697,cdn.optimizely.com,legit,3.61437,5,11,18,0,0.45455,0.2008,4,2,1,0,7,4,0,0,0,4
8284,dsfoy8vf44er5ydg3w.net,dga,4.00489,3,13,22,1,0.23077,0.18204,2,0,0,0,2,1,0,0,0,1
6372,lysyvur.com,dga,3.27761,2,8,11,1,0.25,0.29796,0,0,0,0,0,0,0,0,0,0
3378,beta.clever.com,legit,3.32323,5,8,15,0,0.625,0.22155,4,0,0,0,4,6,1,0,0,7
2520,resetdigital.co,legit,3.50689,6,8,15,0,0.75,0.23379,4,0,0,0,4,6,2,0,0,8
2205,va.us.criteo.com,legit,3.45282,6,7,16,0,0.85714,0.2158,5,0,0,0,5,3,0,0,0,3
995,pull-q5-gcp01.tiktokcdn.com,legit,4.06026,4,16,27,0,0.25,0.15038,4,6,9,9,28,2,0,0,0,2
6498,fqymiuswxj.com,dga,3.6645,3,10,14,1,0.3,0.26175,2,0,0,0,2,1,0,0,0,1
368,res-1.cdn.office.net,legit,3.54644,5,10,20,0,0.5,0.17732,8,6,5,3,22,5,1,0,0,6
1179,serving-sys.com,legit,3.5899,3,10,15,0,0.3,0.23933,3,1,1,1,6,3,3,1,0,7
4285,pixel.everesttech.net,legit,3.3321,7,12,21,0,0.58333,0.15867,6,0,0,0,6,8,4,0,0,12
7173,rockshow.net,dga,3.4183,3,8,12,1,0.375,0.28486,1,0,0,0,1,0,0,0,0,0
5245,miwtozdpve.com,dga,3.52164,4,9,14,1,0.44444,0.25155,1,0,0,0,1,2,0,0,0,2
5113,zeybpfzywxdxnht.com,dga,3.93214,2,16,19,1,0.125,0.20695,0,0,0,0,0,0,0,0,0,0
5182,udsatun.com,dga,3.27761,4,6,11,1,0.66667,0.29796,2,0,0,0,2,1,0,0,0,1
5870,fndobmnbmcfeaabb.com,dga,3.18418,5,14,20,1,0.35714,0.15921,1,0,0,0,1,2,0,0,0,2
2892,sync.aralego.com,legit,3.5,5,9,16,0,0.55556,0.21875,3,0,0,0,3,3,0,0,0,3
358,firebaselogging-pa.googleapis.com,legit,3.77548,13,17,33,0,0.76471,0.11441,9,6,4,4,23,8,1,0,0,9
4964,azure.net,legit,2.9477,4,4,9,0,1.0,0.32752,1,0,0,1,2,1,0,0,0,1
3772,www.youtube-nocookie.com,legit,3.56977,10,11,24,0,0.90909,0.14874,3,0,0,0,3,2,0,0,0,2
4017,mountain.com,legit,3.08496,5,6,12,0,0.83333,0.25708,4,0,0,0,4,2,0,0,0,2
542,ntp.msn.com,legit,2.91398,1,8,11,0,0.125,0.26491,3,0,0,0,3,0,0,0,0,0
1365,code.createjs.com,legit,3.29277,6,9,17,0,0.66667,0.19369,8,0,0,0,8,6,1,0,0,7
7749,kuausgkqeweykeyk.org,dga,3.38418,7,12,20,1,0.58333,0.16921,1,0,0,0,1,0,0,0,0,0
6,windowsupdate.com,legit,3.73452,6,10,17,0,0.6,0.21968,3,0,0,0,3,5,1,0,0,6
2397,cm.smadex.com,legit,3.02699,3,8,13,0,0.375,0.23285,2,0,0,0,2,2,0,0,0,2
5721,h14bvmsatkrhtm29dxdxf52iuk27mwb58pze51.ru,dga,4.57061,5,23,41,1,0.21739,0.11148,1,0,0,0,1,1,0,0,0,1
8584,gkkisk.net,dga,2.84644,2,7,10,1,0.28571,0.28464,0,0,0,0,0,1,0,0,0,1
2740,symcd.com,legit,2.72548,1,7,9,0,0.14286,0.30283,1,0,0,0,1,0,0,0,0,0
568,ingress.rapid7.com,legit,3.72548,5,10,18,0,0.5,0.20697,7,1,0,0,8,4,3,0,0,7
3485,a767.dspw65.akamai.net,legit,3.69785,6,8,22,0,0.75,0.16808,5,3,4,3,15,3,0,0,0,3
9545,vocyrem.com,dga,2.91398,3,7,11,1,0.42857,0.26491,1,0,0,0,1,2,0,0,0,2
6947,hvijksxxhe.kz,dga,3.2389,2,10,13,1,0.2,0.24915,0,0,0,0,0,0,0,0,0,0
5336,cawefdir.com,dga,3.4183,4,7,12,1,0.57143,0.28486,0,0,0,0,0,1,0,0,0,1
3051,iterable.com,legit,3.4183,5,6,12,0,0.83333,0.28486,4,0,0,0,4,5,1,0,0,6
8754,hwbwymu.cl,dga,3.12193,1,8,10,1,0.125,0.31219,0,0,0,0,0,0,0,0,0,0
9844,m03no2cvcvq2a4g.ddns.net,dga,3.97018,3,14,24,1,0.21429,0.16542,2,1,0,0,3,4,3,3,2,12
3260,ams.gcc.teams.microsoft.com,legit,3.36564,7,16,27,0,0.4375,0.12465,11,8,7,6,32,5,0,0,0,5
9958,sedpentextnossremissio.com,dga,3.45565,9,16,26,1,0.5625,0.13291,7,1,0,0,8,9,1,0,0,10
9756,earnestinemalandra.net,dga,3.1867,9,12,22,1,0.75,0.14485,7,0,0,0,7,13,3,0,0,16
470,global.aa-rt.sharepoint.com,legit,3.88416,9,14,27,0,0.64286,0.14386,5,0,0,0,5,3,0,0,0,3
4617,platform.dbankcloud.com,legit,3.79509,6,15,23,0,0.4,0.165,5,3,2,1,11,5,0,0,0,5
2278,native.sharethrough.com,legit,3.79509,8,13,23,0,0.61538,0.165,6,0,0,0,6,6,1,0,0,7
993,admanmedia.com,legit,2.98523,6,7,14,0,0.85714,0.21323,3,0,0,0,3,3,0,0,0,3
6543,mabavic.info,dga,3.25163,5,6,12,1,0.83333,0.27097,2,0,0,0,2,2,0,0,0,2
2283,aadrm.com,legit,2.72548,3,5,9,0,0.6,0.30283,1,0,0,0,1,0,0,0,0,0
9396,gxxxbedntkhg.pw,dga,3.45656,1,13,15,1,0.07692,0.23044,3,0,0,0,3,3,0,0,0,3
6137,tnpvntvxnkkkh.ru,dga,3.15564,1,14,16,1,0.07143,0.19723,1,0,0,0,1,0,0,0,0,0
4030,fa000000005.resources.office.net,legit,3.45282,9,11,32,0,0.81818,0.1079,7,4,4,3,18,4,1,0,0,5
5394,eqacmemop.ddns.net,dga,3.46132,5,11,18,1,0.45455,0.1923,3,1,0,0,4,6,3,2,1,12
3615,wknd.ai,legit,2.80735,2,4,7,0,0.5,0.40105,0,0,0,0,0,1,0,0,0,1
6533,dffefklcffldffke.com,dga,2.83935,3,16,20,1,0.1875,0.14197,0,0,0,0,0,0,0,0,0,0
9091,nmhthxfbvgowjnue.eu,dga,3.82687,5,13,19,1,0.38462,0.20141,0,0,0,0,0,0,0,0,0,0
5674,drf32htm59b48dya17pzo51gvesoxk17nwgwm49.org,dga,4.72244,5,23,43,1,0.21739,0.10982,1,0,0,0,1,2,0,0,0,2
8553,iktbpvjyvlupusrq.eu,dga,3.78714,5,13,19,1,0.38462,0.19932,1,1,0,0,2,0,0,0,0,0
236,ocws.officeapps.live.com,legit,3.57393,8,13,24,0,0.61538,0.14891,8,5,4,3,20,4,0,0,0,4
8365,withinmanner.net,dga,3.125,5,10,16,1,0.5,0.19531,3,0,0,0,3,6,0,0,0,6
4065,www.tm.v4.a.prd.aadg.akadns.net,legit,3.50997,6,17,31,0,0.35294,0.11322,6,4,4,3,17,2,1,0,0,3
7862,fodohwo.com,dga,2.73216,4,6,11,1,0.66667,0.24838,0,0,0,0,0,0,0,0,0,0
6044,vicoheaq.ru,dga,3.45943,5,5,11,1,1.0,0.31449,3,0,0,0,3,3,0,0,0,3
7355,soldierinitiative.ps,dga,3.44145,9,10,20,1,0.9,0.17207,4,0,0,0,4,8,3,0,0,11
4917,datatables.net,legit,2.98523,5,8,14,0,0.625,0.21323,4,0,0,0,4,4,0,0,0,4
3001,st1.zoom.us,legit,2.91398,3,5,11,0,0.6,0.26491,2,0,0,0,2,2,0,0,0,2
5025,woundfinger.ws,dga,3.52164,4,9,14,1,0.44444,0.25155,4,0,0,0,4,4,1,0,0,5
3997,trustpilot.com,legit,3.32486,4,9,14,0,0.44444,0.23749,4,0,0,0,4,1,0,0,0,1
118,pki.goog,legit,2.5,3,4,8,0,0.75,0.3125,0,0,0,0,0,0,0,0,0,0
2638,k.p-n.io,legit,2.75,2,3,8,0,0.66667,0.34375,0,0,0,0,0,0,0,0,0,0
7326,vbabxib.ga,dga,2.64644,3,6,10,1,0.5,0.26464,0,0,0,0,0,0,0,0,0,0
1578,apps-mzstatic-cdn.itunes-apple.com.akadns.net,legit,3.89465,12,26,45,0,0.46154,0.08655,17,11,10,9,47,13,4,1,0,18
9505,yfvnawnvuib.com,dga,3.64022,4,10,15,1,0.4,0.24268,0,0,0,0,0,0,0,0,0,0
6962,6gqw2wycuoaw.net,dga,3.70282,4,9,16,1,0.44444,0.23143,0,0,0,0,0,0,0,0,0,0
3516,gfe.nvidia.com,legit,3.52164,5,7,14,0,0.71429,0.25155,1,0,0,0,1,0,0,0,0,0
9973,pifznzzbl.net,dga,3.18083,2,10,13,1,0.2,0.24468,1,0,0,0,1,0,0,0,0,0
6121,fivpabkunjsiaxvt.eu,dga,3.82687,7,11,19,1,0.63636,0.20141,0,0,0,0,0,1,0,0,0,1
3443,diagnostic.networking.aws.dev,legit,3.81437,9,17,29,0,0.52941,0.13153,5,0,0,0,5,7,1,0,0,8
9209,tomatoeshotel.am,dga,3.03064,7,8,16,1,0.875,0.18942,4,0,0,0,4,6,0,0,0,6
2231,41-courier.push.apple.com,legit,3.86347,8,11,25,0,0.72727,0.15454,9,4,3,2,18,4,0,0,0,4
7248,kawqoukmsikm.net,dga,3.57782,5,10,16,1,0.5,0.22361,1,0,0,0,1,1,0,0,0,1
9493,titanspain.com,dga,3.23593,5,8,14,1,0.625,0.23114,3,0,0,0,3,6,2,0,0,8
3512,cxense.com,legit,2.92193,3,6,10,0,0.5,0.29219,2,0,0,0,2,3,1,0,0,4
8615,hpmkrqnuyj.com,dga,3.6645,2,11,14,1,0.18182,0.26175,0,0,0,0,0,0,0,0,0,0
6557,qafnidof.ru,dga,3.27761,4,6,11,1,0.66667,0.29796,1,0,0,0,1,1,0,0,0,1
5740,udwkpxkbqwwblp.biz,dga,3.41938,2,15,18,1,0.13333,0.18997,0,0,0,0,0,0,0,0,0,0
9494,invphmmiymtvliwo.eu,dga,3.64215,6,12,19,1,0.5,0.19169,3,0,0,0,3,2,0,0,0,2
1974,app.link,legit,2.75,2,5,8,0,0.4,0.34375,2,1,0,0,3,0,0,0,0,0
3021,solvvy.com,legit,2.92193,2,7,10,0,0.28571,0.29219,0,0,0,0,0,0,0,0,0,0
3074,cmp.quantcast.com,legit,3.33718,4,11,17,0,0.36364,0.1963,3,1,0,0,4,4,0,0,0,4
6573,rufaaqabaxxeop.ddns.net,dga,3.74095,8,13,23,1,0.61538,0.16265,3,1,0,0,4,4,3,2,1,10
4715,resources.digital-cloud.medallia.com,legit,3.80092,14,18,36,0,0.77778,0.10558,12,3,2,1,18,7,2,0,0,9
4726,urldefense.com,legit,3.46772,5,8,14,0,0.625,0.24769,2,0,0,0,2,4,1,0,0,5
775,oauth2.googleapis.com,legit,3.72565,9,9,21,0,1.0,0.17741,5,6,4,4,19,3,0,0,0,3
6540,wqufxcci.mu,dga,3.0958,3,7,11,1,0.42857,0.28144,0,0,0,0,0,0,0,0,0,0
6140,gmayqeqoweiuiqka.org,dga,3.58418,9,10,20,1,0.9,0.17921,1,0,0,0,1,1,0,0,0,1
1228,uipglob.semasio.net,legit,3.72161,8,9,19,0,0.88889,0.19587,3,0,0,0,3,5,0,0,0,5
1123,eastus2.cloudapp.azure.com,legit,3.76718,10,12,26,0,0.83333,0.14489,11,5,3,4,23,4,0,0,0,4
2195,onmicrosoft.com,legit,3.10689,5,9,15,0,0.55556,0.20713,6,7,6,5,24,3,0,0,0,3
6131,yqhayjsjsoet.bid,dga,3.625,4,11,16,1,0.36364,0.22656,0,0,0,0,0,1,0,0,0,1
235,clients.config.office.net,legit,3.34268,8,14,25,0,0.57143,0.13371,10,7,4,3,24,5,3,0,0,8
2848,meetings.clients6.google.com,legit,3.51219,9,15,28,0,0.6,0.12544,9,6,4,3,22,5,2,0,0,7
1899,medallia.com,legit,3.08496,5,6,12,0,0.83333,0.25708,2,0,0,0,2,1,0,0,0,1
9866,tugfupmu.ru,dga,2.73216,4,6,11,1,0.66667,0.24838,0,0,0,0,0,0,0,0,0,0
2002,thebrighttag.com,legit,3.45282,4,11,16,0,0.36364,0.2158,1,0,0,0,1,2,0,0,0,2
5063,tpizdqlfihiuojrlojlvlgmswif.org,dga,4.02662,8,22,31,1,0.36364,0.12989,2,0,0,0,2,0,0,0,0,0
105,push.apple.com,legit,3.32486,4,8,14,0,0.5,0.23749,6,4,3,2,15,1,0,0,0,1
8897,bplhbjpfqwvgkqx.com,dga,3.93214,1,17,19,1,0.05882,0.20695,1,0,0,0,1,0,0,0,0,0
4618,web-sdk-us2.aptrinsic.com,legit,4.13366,6,14,25,0,0.42857,0.16535,5,1,0,0,6,5,1,0,0,6
9548,xkuahelvhebytdvj.com,dga,4.02193,5,14,20,1,0.35714,0.2011,0,0,0,0,0,1,0,0,0,1
7469,taguptea.ru,dga,2.91398,5,5,11,1,1.0,0.26491,3,0,0,0,3,3,0,0,0,3
4093,a3cloud.net,legit,3.45943,4,5,11,0,0.8,0.31449,2,3,2,1,8,0,0,0,0,0
7738,yobgdyadhnipgyeweh.com,dga,3.78875,6,15,22,1,0.4,0.17222,1,0,0,0,1,1,0,0,0,1
958,use.fontawesome.com,legit,3.43162,8,9,19,0,0.88889,0.18061,7,0,0,0,7,5,0,0,0,5
4972,disquscdn.com,legit,3.2389,3,9,13,0,0.33333,0.24915,3,1,0,0,4,2,0,0,0,2
6727,thosebright.net,dga,3.32323,4,10,15,1,0.4,0.22155,1,0,0,0,1,2,0,0,0,2
9172,vofymyk.com,dga,2.91398,2,8,11,1,0.25,0.26491,1,0,0,0,1,0,0,0,0,0
6553,milihne.com,dga,3.0958,4,6,11,1,0.66667,0.28144,2,0,0,0,2,2,0,0,0,2
822,youtube-ui.l.google.com,legit,3.5014,10,9,23,0,1.11111,0.15223,3,5,4,3,15,2,0,0,0,2
9078,pocoxoitruupweu.ddns.net,dga,3.68872,9,13,24,1,0.69231,0.1537,3,1,0,0,4,6,3,3,2,14
8380,nfgneauxqrrbvuqv.eu,dga,3.47135,6,12,19,1,0.5,0.1827,1,0,0,0,1,2,0,0,0,2
7829,wuhadduf.com,dga,3.25163,4,7,12,1,0.57143,0.27097,1,0,0,0,1,1,0,0,0,1
9174,umvosqeoya.info,dga,3.5899,7,7,15,1,1.0,0.23933,0,0,0,0,0,0,0,1,0,1
7672,ec64i8e8y0m0.org,dga,3.625,4,5,16,1,0.8,0.22656,0,0,0,0,0,1,0,0,0,1
7198,qm42b62rnaw8nhwh54.biz,dga,3.91398,2,12,22,1,0.16667,0.17791,0,0,0,0,0,0,0,0,0,0
2417,o.ss2.us,legit,2.15564,2,3,8,0,0.66667,0.26946,0,0,0,0,0,0,0,0,0,0
8253,hlbmkrul.so,dga,3.27761,2,8,11,1,0.25,0.29796,0,0,0,0,0,0,0,0,0,0
4021,server.cpmstar.com,legit,3.35021,4,12,18,0,0.33333,0.18612,5,1,1,0,7,6,3,1,0,10
8535,drlgikcevv.com,dga,3.52164,3,10,14,1,0.3,0.25155,1,0,0,0,1,1,0,0,0,1
211,c.bing.com,legit,2.92193,2,6,10,0,0.33333,0.29219,1,0,0,0,1,1,1,0,0,2
8472,sortlandassumeplaceprofit.com,dga,3.88334,10,18,29,1,0.55556,0.13391,5,1,0,0,6,9,3,0,0,12
8405,thumbs-groups.com,dga,3.61687,4,11,17,1,0.36364,0.21276,2,0,0,0,2,0,0,0,0,0
6756,fasihgim.com,dga,3.25163,4,7,12,1,0.57143,0.27097,0,0,0,0,0,2,0,0,0,2
1168,cdn.onenote.net,legit,2.65656,5,8,15,0,0.625,0.1771,5,2,1,0,8,5,1,0,0,6
8803,rajvnmjnxwwkdysebclb.de,dga,4.00182,3,19,23,1,0.15789,0.17399,2,0,0,0,2,2,0,0,0,2
8433,orelagmei.ddns.net,dga,3.57243,6,10,18,1,0.6,0.19847,3,1,0,0,4,8,4,3,2,17
6882,safaotraepso.ddns.net,dga,3.36804,7,12,21,1,0.58333,0.16038,3,1,0,0,4,5,5,3,2,15
3142,ids.cdnwidget.com,legit,3.45482,4,11,17,0,0.36364,0.20322,6,2,0,0,8,3,0,0,0,3
4211,gos-api.gos-gsp.io,legit,2.933,6,8,18,0,0.75,0.16294,2,2,1,0,5,0,0,0,0,0
5478,urckkcffkvqb.in,dga,3.32323,2,12,15,1,0.16667,0.22155,0,0,0,0,0,0,0,0,0,0
8525,jicmpjbyrfvy.biz,dga,3.5,2,13,16,1,0.15385,0.21875,1,0,0,0,1,1,0,0,0,1
4409,cdn.userway.org,legit,3.64022,4,9,15,0,0.44444,0.24268,5,3,1,0,9,3,1,0,0,4
9821,8mcm46o6cu0y.net,dga,3.625,3,7,16,1,0.42857,0.22656,0,0,0,0,0,0,0,0,0,0
6101,qkiramiq.biz,dga,3.02206,4,7,12,1,0.57143,0.25184,3,0,0,0,3,3,0,0,0,3
6266,tzjkypqay.com,dga,3.54659,2,10,13,1,0.2,0.27281,0,0,0,0,0,0,0,0,0,0
4435,erne.co,legit,2.52164,3,3,7,0,1.0,0.36023,1,0,0,0,1,2,0,0,0,2
9141,ewhjbixy.co.kr,dga,3.6645,3,9,14,1,0.33333,0.26175,2,1,0,0,3,1,1,0,0,2
6971,japxozyuwg.com,dga,3.6645,4,9,14,1,0.44444,0.26175,1,0,0,0,1,0,0,0,0,0
4437,scontent-lga3-2.xx.fbcdn.net,legit,3.89629,4,17,28,0,0.23529,0.13915,7,3,0,0,10,5,2,0,0,7
3476,comm-cohort.ess-apple.com.akadns.net,legit,3.84286,10,20,36,0,0.5,0.10675,11,9,9,9,38,7,4,1,0,12
8550,tspmjkjprseqlzovuslyhbiin.info,dga,4.25656,7,22,30,1,0.31818,0.14189,4,0,0,0,4,2,0,0,0,2
7599,glassbrown.net,dga,3.52164,3,10,14,1,0.3,0.25155,1,0,0,0,1,2,1,0,0,3
7621,zutkhv.net,dga,3.12193,2,7,10,1,0.28571,0.31219,0,0,0,0,0,0,0,0,0,0
75,cdn.office.net,legit,3.09307,4,8,14,0,0.5,0.22093,5,6,5,3,19,3,0,0,0,3
1023,pull-flv-f10-gcp01.tiktokcdn.com,legit,4.05423,4,19,32,0,0.21053,0.12669,4,6,9,9,28,2,0,0,0,2
7133,kmkddlbloamcfbbc.com,dga,3.20869,3,16,20,1,0.1875,0.16043,2,0,0,0,2,2,0,0,0,2
8160,cl52kb5pql1bel1tcfyhw8s.ddns.net,dga,4.22641,2,22,32,1,0.09091,0.13208,3,1,0,0,4,6,3,3,2,14
912,mso.msidentity.com,legit,3.35021,5,11,18,0,0.45455,0.18612,4,1,0,0,5,5,1,0,0,6
2506,aws.oath.cloud,legit,3.37878,5,7,14,0,0.71429,0.24134,2,0,0,0,2,1,0,0,0,1
4214,msauthimages.net,legit,3.375,6,9,16,0,0.66667,0.21094,3,1,0,0,4,3,0,0,0,3
7653,iwnerildite.com,dga,3.45656,6,8,15,1,0.75,0.23044,2,0,0,0,2,5,1,0,0,6
7238,kihufxkofayfjt.com,dga,3.68354,5,12,18,1,0.41667,0.20464,1,0,0,0,1,0,0,0,0,0
8517,ilirwufs.com,dga,3.4183,4,7,12,1,0.57143,0.28486,1,0,0,0,1,0,0,0,0,0
2606,swscan.apple.com,legit,3.375,4,10,16,0,0.4,0.21094,5,4,3,2,14,3,0,0,0,3
1535,e673.dscx.akamaiedge.net,legit,3.77206,8,10,24,0,0.8,0.15717,7,5,5,3,20,5,0,0,0,5
3332,us-auth2.samsungosp.com,legit,3.62118,7,12,23,0,0.58333,0.15744,2,0,0,0,2,2,0,0,0,2
572,c1.adform.net,legit,3.54659,3,7,13,0,0.42857,0.27281,2,0,0,0,2,1,0,0,0,1
3610,secureworks.com,legit,3.24022,5,9,15,0,0.55556,0.21601,2,0,0,0,2,4,0,0,0,4
1595,unified.adsafeprotected.com,legit,3.76397,11,14,27,0,0.78571,0.13941,8,1,0,0,9,4,1,0,0,5
8335,hwusrytltsaxwrnbkrxsb.ms,dga,3.72018,2,21,24,1,0.09524,0.15501,1,0,0,0,1,0,0,0,0,0
2823,mzstatic.com.itunes-apple.com.akadns.net,legit,3.88733,12,22,40,0,0.54545,0.09718,16,9,9,9,43,13,4,1,0,18
8206,ayrrjjylr.com,dga,3.02699,2,10,13,1,0.2,0.23285,0,0,0,0,0,0,0,0,0,0
1004,pull-cmaf-l10-sg01.tiktokcdn.com,legit,4.11673,5,18,32,0,0.27778,0.12865,5,6,9,9,29,3,0,0,0,3
6089,eobipydlyw.com,dga,3.52164,4,9,14,1,0.44444,0.25155,0,0,0,0,0,0,0,0,0,0
8704,vilbajik.ru,dga,3.27761,4,6,11,1,0.66667,0.29796,0,0,0,0,0,0,0,0,0,0
5384,domownic.com,dga,2.85539,4,7,12,1,0.57143,0.23795,1,0,0,0,1,3,0,0,0,3
7459,vqffractilvprswkuv.com,dga,3.97057,4,17,22,1,0.23529,0.18048,3,0,0,0,3,3,0,0,0,3
4076,cerebro.edna.yahoo.net,legit,3.39081,9,10,22,0,0.9,0.15413,7,0,0,1,8,5,1,0,0,6
9932,uynsekpsir.com,dga,3.6645,4,9,14,1,0.44444,0.26175,1,0,0,0,1,3,1,1,0,5
610,bzib.nelreports.net,legit,3.47135,5,12,19,0,0.41667,0.1827,1,0,0,0,1,4,0,0,0,4
7633,christophersullivan.net,dga,3.82791,7,15,23,1,0.46667,0.16643,3,0,0,0,3,6,4,0,2,12
7992,tkfllcsdcphrno.info,dga,3.72161,3,15,19,1,0.2,0.19587,0,0,0,0,0,0,0,0,0,0
4518,dfp.bouncex.net,legit,3.50689,4,9,15,0,0.44444,0.23379,3,0,0,0,3,1,1,0,0,2
5241,msuoi0mwm4ew.top,dga,3.45282,5,8,16,1,0.625,0.2158,0,0,0,0,0,1,0,0,0,1
6484,ohohqowoxoevisp.ddns.net,dga,3.60123,8,14,24,1,0.57143,0.15005,3,1,0,0,4,5,3,2,1,11
2308,impression.appsflyer.com,legit,3.68872,7,15,24,0,0.46667,0.1537,8,2,1,0,11,5,3,0,0,8
7715,rsadrtrldxywuwe.com,dga,3.78714,4,14,19,1,0.28571,0.19932,1,0,0,0,1,0,0,0,0,0
1996,lifecycle.office.com,legit,3.04644,7,11,20,0,0.63636,0.15232,6,4,4,3,17,4,0,0,0,4
4290,e11290.dspg.akamaiedge.net,legit,3.79622,8,10,26,0,0.8,0.14601,7,5,5,3,20,5,0,0,0,5
4328,bing.trafficmanager.net,legit,3.5014,7,14,23,0,0.5,0.15223,7,3,1,3,14,7,2,0,0,9
2129,secure-us.imrworldwide.com,legit,3.64237,9,14,26,0,0.64286,0.14009,4,0,0,0,4,5,0,0,0,5
976,fp2e7a.wpc.2be4.phicdn.net,legit,3.79622,5,13,26,0,0.38462,0.14601,3,1,0,0,4,3,0,0,0,3
1151,btlr.sharethrough.com,legit,3.65376,5,14,21,0,0.35714,0.17399,3,0,0,0,3,3,0,0,0,3
2864,indexww.com.akadns.net,legit,3.66353,6,13,22,0,0.46154,0.16652,6,6,7,7,26,7,3,1,0,11
7683,dhdi.com.hn,dga,2.91398,2,7,11,1,0.28571,0.26491,2,2,1,0,5,2,2,1,0,5
9410,dicendoquiintraresuper.com,dga,3.76718,11,14,26,1,0.78571,0.14489,9,1,0,0,10,11,2,0,0,13
8208,cfgetlwtoaq.cc,dga,3.32486,3,10,14,1,0.3,0.23749,1,0,0,0,1,2,0,0,0,2
8901,yacgosossuiaqmqc.org,dga,3.44644,7,12,20,1,0.58333,0.17232,0,1,0,0,1,2,0,0,0,2
7628,bovndxiygrdruvl.biz,dga,3.72161,4,14,19,1,0.28571,0.19587,0,0,0,0,0,1,0,0,0,1
1282,i.clean.gg,legit,2.92193,3,5,10,0,0.6,0.29219,3,0,0,0,3,3,0,0,0,3
7812,hjjvvwg.ug,dga,2.72193,1,8,10,1,0.125,0.27219,0,0,0,0,0,0,0,0,0,0
3252,sync.resetdigital.co,legit,3.72193,6,12,20,0,0.5,0.1861,4,0,0,0,4,6,2,0,0,8
1308,storygize.net,legit,3.39275,4,8,13,0,0.5,0.26098,1,0,0,0,1,2,0,0,0,2
3878,rtb-us-east.linkedin.com,legit,4.00163,7,13,24,0,0.53846,0.16673,6,1,0,0,7,5,0,0,0,5
3376,pixel.sitescout.com,legit,3.51109,7,10,19,0,0.7,0.18479,5,0,0,0,5,6,0,0,0,6
7111,s606cegm0a8q.org,dga,3.625,3,7,16,1,0.42857,0.22656,1,0,0,0,1,1,0,0,0,1
3401,gcc.activity.windows.us,legit,3.64249,6,14,23,0,0.42857,0.15837,3,0,0,0,3,5,0,0,0,5
1755,cdn.shopify.com,legit,3.50689,3,10,15,0,0.3,0.23379,3,2,1,0,6,1,0,0,0,1
741,tribalfusion.com,legit,3.75,6,9,16,0,0.66667,0.23438,2,0,0,0,2,3,1,0,0,4
5803,clkdffflfdlmfcaa.com,dga,2.96596,3,16,20,1,0.1875,0.1483,0,0,0,0,0,1,0,0,0,1
6200,oquwneexabatab.ddns.net,dga,3.55553,8,13,23,1,0.61538,0.15459,4,1,0,0,5,7,3,2,1,13
3219,www.icloud.com,legit,3.03915,4,8,14,0,0.5,0.21708,3,3,2,1,9,1,0,0,0,1
3198,assets.pinterest.com,legit,3.34644,6,12,20,0,0.5,0.16732,10,0,0,0,10,9,5,1,0,15
3540,perfectmarket.com,legit,3.33718,5,11,17,0,0.45455,0.1963,2,0,0,0,2,5,0,0,0,5
4436,dotmetrics.net,legit,3.32486,4,9,14,0,0.44444,0.23749,1,0,0,0,1,3,0,0,0,3
4182,www.newyorker.com,legit,3.14629,4,11,17,0,0.36364,0.18508,1,0,0,0,1,3,0,0,0,3
9240,mariabellaphilomena.net,dga,3.5014,10,12,23,1,0.83333,0.15223,4,0,0,0,4,8,0,0,0,8
6708,wdkliyatkpgbsnmwr.tv,dga,4.02193,2,17,20,1,0.11765,0.2011,2,0,0,0,2,1,0,0,0,1
6192,jezujer.info,dga,3.25163,5,6,12,1,0.83333,0.27097,1,0,0,0,1,1,0,0,0,1
2992,grs.dbankcloud.com,legit,3.72548,4,12,18,0,0.33333,0.20697,4,3,2,1,10,2,0,0,0,2
8431,spokeninkjet.net,dga,3.15564,5,10,16,1,0.5,0.19723,2,0,0,0,2,4,0,0,0,4
9182,ezqz.cz,dga,2.12809,1,5,7,1,0.2,0.30401,0,0,0,0,0,0,0,0,0,0
4337,dp-discovery-na-ext.amazon.com,legit,4.0314,9,16,30,0,0.5625,0.13438,6,1,3,3,13,7,2,0,0,9
708,ci6.googleusercontent.com,legit,3.62347,9,13,25,0,0.69231,0.14494,10,8,4,3,25,7,3,0,0,10
6327,ddqukuwdvyqppvlj.eu,dga,3.43162,4,14,19,1,0.28571,0.18061,1,0,0,0,1,1,0,0,0,1
5427,zoai.ru,dga,2.80735,4,2,7,1,2.0,0.40105,0,0,0,0,0,0,0,0,0,0
7883,kimberleyeglantine.net,dga,3.44286,8,13,22,1,0.61538,0.15649,5,0,0,0,5,8,1,0,0,9
583,acdn.adnxs.com,legit,3.09307,3,9,14,0,0.33333,0.22093,4,2,1,0,7,2,0,0,0,2
8570,apzrvyfqbex.org,dga,3.77356,3,11,15,1,0.27273,0.25157,1,0,0,0,1,1,3,2,1,7
2276,dynatrace.com,legit,3.39275,4,8,13,0,0.5,0.26098,3,0,0,0,3,4,2,0,0,6
9052,xwtzobrmo.com.br,dga,3.20282,3,11,16,1,0.27273,0.20018,2,2,1,0,5,2,2,1,0,5
8024,w6868qwese0a.top,dga,3.5,4,6,16,1,0.66667,0.21875,2,0,0,0,2,2,0,0,0,2
5230,tuwyjyvymuq.eu,dga,3.12809,4,9,14,1,0.44444,0.22344,0,0,0,0,0,0,0,0,0,0
2711,onedscolprdeus05.eastus.cloudapp.azure.com,legit,3.89185,15,21,42,0,0.71429,0.09266,17,5,3,4,29,9,1,0,0,10
2723,ca.slack-edge.com,legit,3.45482,5,9,17,0,0.55556,0.20322,2,2,1,0,5,5,0,0,0,5
769,devicelistenerprod.microsoft.com,legit,3.74173,11,19,32,0,0.57895,0.11693,14,12,9,7,42,11,2,0,0,13
1635,mesu-cdn.apple.com.akadns.net,legit,3.74541,8,16,29,0,0.5,0.12915,12,12,11,10,45,7,3,1,0,11
9847,7d3fspqlctersvk.ddns.net,dga,3.85539,2,18,24,1,0.11111,0.16064,4,1,0,0,5,6,5,2,2,15
5247,ocqucwqyoemgweck.org,dga,3.44644,6,13,20,1,0.46154,0.17232,0,0,0,0,0,2,0,0,0,2
974,googleoptimize.com,legit,3.28104,8,9,18,0,0.88889,0.18228,4,4,3,2,13,3,0,0,0,3
1345,privatelink.msidentity.com,legit,3.90217,8,16,26,0,0.5,0.15008,9,1,0,0,10,10,2,0,0,12
4869,reports.crashlytics.com,legit,3.64249,5,16,23,0,0.3125,0.15837,7,0,0,0,7,6,0,0,0,6
3076,um2.eqads.com,legit,3.39275,4,6,13,0,0.66667,0.26098,2,0,0,0,2,0,0,0,0,0
3014,msua04.manage.microsoft.com,legit,3.78212,9,13,27,0,0.69231,0.14008,9,9,7,8,33,6,0,0,0,6
4342,geistm.com,legit,3.12193,3,6,10,0,0.5,0.31219,2,0,0,0,2,3,1,0,0,4
4710,auth.xboxlive.com,legit,3.73452,6,9,17,0,0.66667,0.21968,1,0,0,0,1,1,0,0,0,1
8874,animamperqcan.com,dga,3.29277,6,10,17,1,0.6,0.19369,3,0,0,0,3,6,0,0,0,6
812,stocks-data-service.lb-apple.com.akadns.net,legit,3.98733,12,24,43,0,0.5,0.09273,17,11,10,10,48,12,5,2,0,19
5358,imvntcscqiir.ru,dga,3.32323,4,10,15,1,0.4,0.22155,1,0,0,0,1,0,0,0,0,0
6911,unfraepiscopivitaeluci.com,dga,3.82525,12,13,26,1,0.92308,0.14712,4,0,0,0,4,6,1,0,0,7
931,sb-ssl.google.com,legit,3.17512,4,10,17,0,0.4,0.18677,2,5,4,3,14,1,0,0,0,1
285,static.doubleclick.net,legit,3.66353,7,13,22,0,0.53846,0.16652,9,0,0,0,9,8,1,0,0,9
5065,madecolor.net,dga,3.39275,5,7,13,1,0.71429,0.26098,4,0,0,0,4,5,0,0,0,5
6446,sexualitylogs.co,dga,3.625,6,9,16,1,0.66667,0.22656,3,0,0,0,3,2,0,0,0,2
3321,c-msn-com-nsatc.trafficmanager.net,legit,3.66791,8,21,34,0,0.38095,0.10788,8,4,1,3,16,10,2,0,0,12
5858,iegceioeppgu.info,dga,3.17512,9,7,17,1,1.28571,0.18677,2,0,0,0,2,1,0,0,0,1
1718,na.gateway.devices.a2z.com,legit,3.82525,9,12,26,0,0.75,0.14712,8,1,0,0,9,7,1,0,0,8
3470,gsp9-ssl.apple.com,legit,3.41938,3,11,18,0,0.27273,0.18997,5,4,3,2,14,1,0,0,0,1
7850,cquqvuedkntdmmryi.com,dga,3.78494,5,15,21,1,0.33333,0.18024,2,0,0,0,2,1,0,0,0,1
4705,gm.demdex.net,legit,2.87314,3,8,13,0,0.375,0.22101,1,0,0,0,1,3,0,0,0,3
9163,lipaheac.ru,dga,3.27761,5,5,11,1,1.0,0.29796,2,0,0,0,2,2,0,0,0,2
8561,elswsbs.ht,dga,2.84644,1,8,10,1,0.125,0.28464,0,0,0,0,0,1,0,0,0,1
9516,78ubkx7dat5ju6elwle.ddns.net,dga,4.03915,6,15,28,1,0.4,0.14426,5,1,0,0,6,7,4,3,2,16
370,agkn.com,legit,3.0,2,5,8,0,0.4,0.375,0,0,0,0,0,0,0,0,0,0
2777,accdn.lpsnmedia.net,legit,3.47135,5,12,19,0,0.41667,0.1827,3,2,1,0,6,3,0,0,0,3
718,ci4.googleusercontent.com,legit,3.62347,9,13,25,0,0.69231,0.14494,10,8,4,3,25,7,3,0,0,10
4196,i3.ytimg.com,legit,3.08496,3,6,12,0,0.5,0.25708,1,0,0,0,1,1,0,0,0,1
6366,nihooxdoqoxo.ddns.net,dga,3.19615,7,12,21,1,0.58333,0.1522,3,1,0,0,4,5,4,3,2,14
4305,ladsp.com,legit,3.16993,2,6,9,0,0.33333,0.35221,2,0,0,0,2,1,0,0,0,1
4711,r.stripe.com,legit,3.25163,3,7,12,0,0.42857,0.27097,1,0,0,0,1,2,0,0,0,2
3255,singular.net,legit,3.4183,4,7,12,0,0.57143,0.28486,1,0,0,0,1,4,1,0,0,5
5810,n10eqg23b68gyhwdxe41bucrpvb28muoxh54p52.net,dga,4.62941,6,22,43,1,0.27273,0.10766,1,0,0,0,1,0,0,0,0,0
3221,netmon-control.dropbox.com,legit,3.53641,7,16,26,0,0.4375,0.13602,5,1,0,0,6,5,1,0,1,7
2681,onedscolprdeus11.eastus.cloudapp.azure.com,legit,3.84423,15,21,42,0,0.71429,0.09153,17,5,3,4,29,9,1,0,0,10
7342,luttherfacsubscripta.com,dga,3.85539,7,16,24,1,0.4375,0.16064,3,0,0,0,3,5,1,1,0,7
2947,array812.prod.do.dsp.mp.microsoft.com,legit,3.71259,8,20,37,0,0.4,0.10034,12,12,10,9,43,5,2,0,0,7
1721,cdn2.smoot.apple.com,legit,3.54644,5,11,20,0,0.45455,0.17732,8,5,3,2,18,2,0,0,0,2
4288,liveintent.com,legit,3.23593,5,8,14,0,0.625,0.23114,5,1,0,0,6,4,1,1,0,6
9129,fvlkgoerhighxoilcpcu.sx,dga,3.91487,6,16,23,1,0.375,0.17021,1,0,0,0,1,1,0,0,0,1
574,live.net,legit,2.75,3,4,8,0,0.75,0.34375,1,0,0,0,1,1,0,0,0,1
259,dl.delivery.mp.microsoft.com,legit,3.75343,7,17,28,0,0.41176,0.13405,10,8,7,7,32,7,1,0,0,8
1940,conferdeploy.net,legit,3.45282,5,10,16,0,0.5,0.2158,5,1,0,0,6,4,1,0,0,5
5067,gbxqsufqbex.com,dga,3.50689,3,11,15,1,0.27273,0.23379,0,0,0,0,0,2,3,2,2,9
6198,o2wu4ewawase.top,dga,3.32782,7,6,16,1,1.16667,0.20799,1,0,0,0,1,2,0,0,0,2
1240,us-east-1.prod.service.minerva.devices.a2z.com,legit,3.98456,15,21,46,0,0.71429,0.08662,18,8,4,3,33,13,5,1,0,19
7217,jjodmbvddzoxmopgeml.com,dga,3.53422,5,17,23,1,0.29412,0.15366,1,0,0,0,1,3,0,0,0,3
8795,kkwneyeoya.info,dga,3.24022,6,8,15,1,0.75,0.21601,0,0,0,0,0,1,0,1,0,2
8574,lspjoozphsqekmm.com,dga,3.53689,4,14,19,1,0.28571,0.18615,1,0,0,0,1,0,0,0,0,0
9397,pwmngzxkee.com,dga,3.52164,3,10,14,1,0.3,0.25155,0,0,0,0,0,0,0,0,0,0
2305,lf16-oversea.goofy-cdn.com,legit,4.00813,7,13,26,0,0.53846,0.15416,7,3,1,0,11,5,3,0,0,8
405,gum.criteo.com,legit,3.23593,5,7,14,0,0.71429,0.23114,3,0,0,0,3,3,0,0,0,3
8722,nvmdqmddytspxblsyy.com,dga,3.72013,1,20,22,1,0.05,0.1691,0,0,0,0,0,1,0,0,0,1
5635,william-elsewhere.wtf,dga,3.46328,7,12,21,1,0.58333,0.16492,5,0,0,0,5,5,2,0,0,7
2592,ttlivecdn.com.c.worldfcdn.com,legit,3.578,5,20,29,0,0.25,0.12338,5,5,3,1,14,6,2,1,0,9
1812,push-rtmp-l16-tt01.tiktokcdn-us.com,legit,4.05472,5,20,35,0,0.25,0.11585,5,6,7,8,26,2,0,0,0,2
1815,fc.namequery.com,legit,3.5,5,9,16,0,0.55556,0.21875,2,0,0,0,2,2,0,0,0,2
9319,njytibdaw.com,dga,3.70044,3,9,13,1,0.33333,0.28465,1,0,0,0,1,1,0,0,0,1
4902,o365auditrealtimeingestion.manage.office.com,legit,3.99946,19,19,44,0,1.0,0.0909,14,5,4,5,28,13,4,1,0,18
3632,b.redcloak.secureworks.com,legit,3.63219,8,15,26,0,0.53333,0.1397,4,1,0,0,5,5,0,0,0,5
3639,southeastasia.cloudapp.azure.com,legit,3.79284,14,15,32,0,0.93333,0.11853,11,5,3,4,23,6,0,0,0,6
6517,xsfyuuytmbva.com,dga,3.625,4,11,16,1,0.36364,0.22656,0,0,0,0,0,0,0,0,0,0
8281,jpffdyeqppqr.biz,dga,3.45282,2,13,16,1,0.15385,0.2158,1,0,0,0,1,0,0,0,0,0
6897,umomafreotubba.ddns.net,dga,3.654,8,13,23,1,0.61538,0.15887,4,1,0,0,5,7,4,3,2,16
2963,gspe85-ssl.ls.apple.com,legit,3.46858,4,13,23,0,0.30769,0.15081,6,4,3,2,15,1,0,0,0,1
2944,cdn4.forter.com,legit,3.37356,3,9,15,0,0.33333,0.2249,4,1,0,0,5,4,1,0,0,5
5767,qivvrqr.nf,dga,2.72193,1,8,10,1,0.125,0.27219,0,0,0,0,0,0,0,0,0,0
6078,zqmyueidka.com,dga,3.6645,5,8,14,1,0.625,0.26175,0,0,0,0,0,0,0,0,0,0
961,vo.msecnd.net,legit,3.2389,3,8,13,0,0.375,0.24915,2,0,0,0,2,3,0,0,0,3
9451,pufuje.info,dga,3.0958,5,5,11,1,1.0,0.28144,0,0,0,0,0,0,0,0,0,0
9613,lufoqupd.ru,dga,3.02717,4,6,11,1,0.66667,0.2752,0,0,0,0,0,0,0,0,0,0
8415,hkfhexwgtgld.space,dga,3.83659,3,14,18,1,0.21429,0.21314,0,0,0,0,0,0,0,0,0,0
9823,pqgyp52kxjsb28dyexc29i45p32eriufrnvet.info,dga,4.57649,8,23,42,1,0.34783,0.10896,1,0,0,0,1,4,1,0,0,5
7935,ibgtfnuctouanngie.tw,dga,3.54644,7,12,20,1,0.58333,0.17732,1,0,0,0,1,1,0,0,0,1
6487,akntepnluqdeyhtqe.com,dga,3.88018,6,14,21,1,0.42857,0.18477,2,0,0,0,2,2,0,0,0,2
5805,2oekmsyka06c.top,dga,3.75,4,8,16,1,0.5,0.23438,0,0,0,0,0,0,0,0,0,0
7024,dfbfllafodcbebfd.com,dga,3.14644,4,15,20,1,0.26667,0.15732,0,0,0,0,0,2,0,0,0,2
4220,browser.sentry-cdn.com,legit,3.69785,4,15,22,0,0.26667,0.16808,7,3,0,0,10,4,2,0,0,6
4924,c.clicktale.net,legit,3.05656,4,9,15,0,0.44444,0.20377,5,0,0,0,5,3,0,0,0,3
8768,variesleeds.sh,dga,3.12809,5,8,14,1,0.625,0.22344,4,0,0,0,4,5,0,0,0,5
771,msidentity.com,legit,3.37878,4,9,14,0,0.44444,0.24134,3,1,0,0,4,5,1,0,0,6
7568,c60ysmg2we06.org,dga,3.625,2,8,16,1,0.25,0.22656,0,0,0,0,0,0,0,0,0,0
2989,www.pinterest.com,legit,3.45482,4,11,17,0,0.36364,0.20322,8,0,0,0,8,6,4,1,0,11
4440,push-rtmp-f5-vr-va01.tiktokcdn.com,legit,4.24173,5,20,34,0,0.25,0.12476,5,6,7,8,26,2,0,0,0,2
3952,mobfox.com,legit,2.64644,3,6,10,0,0.5,0.26464,0,0,0,0,0,0,0,0,0,0
6472,tablewaitadmirebabyblueabuse.com,dga,3.7119,14,17,32,1,0.82353,0.116,8,0,0,0,8,7,1,0,0,8
6135,lminbhongxjok.com,dga,3.57247,4,12,17,1,0.33333,0.21015,3,0,0,0,3,3,0,0,0,3
3229,cylance.com,legit,3.02717,3,7,11,0,0.42857,0.2752,1,0,0,0,1,3,1,1,0,5
5604,crrp.dk,dga,2.52164,0,6,7,1,0.0,0.36023,1,0,0,0,1,0,0,0,0,0
3088,myworkday.com,legit,3.2389,3,9,13,0,0.33333,0.24915,0,0,0,0,0,1,0,0,0,1
6983,omimma.net,dga,2.84644,4,5,10,1,0.8,0.28464,2,0,0,0,2,3,0,0,0,3
7822,marmadukeoutterridge.net,dga,3.52206,10,13,24,1,0.76923,0.14675,6,1,0,0,7,6,1,0,0,7
5645,rngxdqskskgq.com,dga,3.5,1,14,16,1,0.07143,0.21875,0,0,0,0,0,0,0,0,0,0
416,cisco.com,legit,2.41938,3,5,9,0,0.6,0.26882,1,0,0,0,1,2,0,0,0,2
9861,htjpoglyfykwp.org,dga,3.61687,2,14,17,1,0.14286,0.21276,0,1,0,0,1,0,0,0,0,0
6917,efkhkktsoggg.xyz,dga,3.40564,2,13,16,1,0.15385,0.21285,0,0,0,0,0,0,0,0,0,0
2705,msua01.manage.microsoft.com,legit,3.78212,9,13,27,0,0.69231,0.14008,9,9,7,8,33,6,0,0,0,6
7222,i464uc6cu8us.top,dga,3.32782,5,5,16,1,1.0,0.20799,1,0,0,0,1,0,0,0,0,0
6364,yrrpiylynkve.biz,dga,3.45282,3,12,16,1,0.25,0.2158,1,0,0,0,1,1,0,0,0,1
4756,revjet.com,legit,3.12193,3,6,10,0,0.5,0.31219,1,0,0,0,1,2,0,0,0,2
7196,swhpdxpqgrxftdgji.com,dga,4.01137,2,18,21,1,0.11111,0.19102,0,0,0,0,0,0,0,0,0,0
8663,kepelej.net,dga,2.73216,4,6,11,1,0.66667,0.24838,1,0,0,0,1,2,0,0,0,2
3494,sf16-ies-music-va.tiktokcdn.com,legit,4.01808,8,16,31,0,0.5,0.12962,7,6,7,6,26,5,0,0,0,5
2604,pull-flv-f10-va01.tiktokcdn.com.rocket-cdn.com,legit,4.13499,8,26,46,0,0.30769,0.08989,7,10,12,10,39,5,2,1,0,8
951,eu-v20.events.data.microsoft.com,legit,3.99173,10,15,32,0,0.66667,0.12474,12,9,7,6,34,7,1,0,0,8
573,teads.tv,legit,2.75,2,5,8,0,0.4,0.34375,4,0,0,0,4,2,0,0,0,2
3765,firewall-external-1524972847.us-east-1.elb.amazonaws.com,legit,4.45246,15,22,56,0,0.68182,0.07951,10,2,3,3,18,10,1,0,0,11
3551,pdx-col.eum-appdynamics.com,legit,3.8562,7,16,27,0,0.4375,0.14282,6,2,0,0,8,4,1,0,0,5
8428,mnkvaueodskoickzgavz.com,dga,3.77206,8,15,24,1,0.53333,0.15717,2,0,0,0,2,1,0,0,0,1
9286,bffddbffcaceoecd.co,dga,2.83978,5,13,19,1,0.38462,0.14946,2,0,0,0,2,5,0,0,0,5
6847,hadenoz.info,dga,3.25163,5,6,12,1,0.83333,0.27097,2,0,0,0,2,2,0,0,0,2
5490,fusarwafloh.com,dga,3.50689,5,9,15,1,0.55556,0.23379,2,0,0,0,2,1,0,0,0,1
1364,createjs.com,legit,3.25163,4,7,12,0,0.57143,0.27097,5,0,0,0,5,4,1,0,0,5
3364,itunes-cdn.itunes-apple.com.akadns.net,legit,3.83018,12,20,38,0,0.6,0.10079,12,11,10,9,42,8,3,1,0,12
553,unitedstates.smartscreen.microsoft.com,legit,3.64283,12,23,38,0,0.52174,0.09586,17,8,7,6,38,14,1,0,0,15
7065,rtppvhmclshbqtt.biz,dga,3.68188,1,17,19,1,0.05882,0.19378,1,0,0,0,1,0,0,0,0,0
1553,sync.inmobi.com,legit,3.10689,4,9,15,0,0.44444,0.20713,1,0,0,0,1,1,0,0,0,1
5381,atehofygpvrtp.info,dga,3.72548,5,12,18,1,0.41667,0.20697,3,0,0,0,3,2,1,0,0,3
831,ipredictive.com,legit,3.32323,6,8,15,0,0.75,0.22155,5,0,0,0,5,5,0,0,0,5
8107,betbvisobxocbbbci.tw,dga,3.14644,5,14,20,1,0.35714,0.15732,0,0,0,0,0,3,0,0,0,3
1808,aspnetcdn.com,legit,3.39275,3,9,13,0,0.33333,0.26098,2,1,0,0,3,4,0,0,0,4
2082,rp.liadm.com,legit,3.25163,3,7,12,0,0.42857,0.27097,3,0,0,0,3,0,0,0,0,0
6873,e0a8y8agmkqg.top,dga,3.625,4,8,16,1,0.5,0.22656,0,0,0,0,0,0,0,0,0,0
9261,bvskdp.com.gt,dga,3.54659,1,10,13,1,0.1,0.27281,3,2,1,0,6,2,2,1,0,5
3729,array808.prod.do.dsp.mp.microsoft.com,legit,3.65853,8,20,37,0,0.4,0.09888,12,12,10,9,43,5,2,0,0,7
6915,gabwggfqbex.com,dga,3.45656,3,11,15,1,0.27273,0.23044,0,0,0,0,0,1,3,2,1,7
7913,dauuxmwatosliguj.eu,dga,3.72161,9,9,19,1,1.0,0.19587,2,0,0,0,2,1,0,0,0,1
4544,us-east4-gcp.api.sc-gw.com,legit,3.73815,6,13,26,0,0.46154,0.14378,7,3,1,0,11,3,0,0,0,3
994,dscd.akamaiedge.net,legit,3.39189,7,10,19,0,0.7,0.17852,8,5,5,3,21,4,0,0,0,4
1414,chat-e2ee-ig-p42.c10r.facebook.com,legit,4.07968,10,13,34,0,0.76923,0.11999,4,0,0,0,4,3,1,0,0,4
6858,sdkrqljkmiaizeh.com,dga,3.93214,5,13,19,1,0.38462,0.20695,1,0,0,0,1,1,0,0,0,1
5012,dokbuxok.ru,dga,2.91398,4,6,11,1,0.66667,0.26491,0,0,0,0,0,0,0,0,0,0
3607,survata.com,legit,3.27761,4,6,11,0,0.66667,0.29796,2,0,0,0,2,3,0,0,0,3
6901,qiolgmeino.com,dga,3.18201,6,7,14,1,0.85714,0.22729,1,0,0,0,1,1,0,0,0,1
5190,gaxkpo.biz,dga,3.32193,3,6,10,1,0.5,0.33219,0,0,0,0,0,0,0,0,0,0
8701,tonight-liberty.top,dga,3.61635,5,12,19,1,0.41667,0.19033,3,0,0,0,3,4,0,0,0,4
2437,sync.graph.bluecava.com,legit,3.90336,6,14,23,0,0.42857,0.16971,2,0,0,0,2,3,0,0,0,3
2999,cos-rd.com,legit,2.92193,2,6,10,0,0.33333,0.29219,1,0,0,0,1,1,0,0,0,1
1634,init.cedexis-radar.net,legit,3.48171,8,11,22,0,0.72727,0.15826,6,0,0,0,6,9,0,0,0,9
5461,nucasdi.com,dga,3.27761,4,6,11,1,0.66667,0.29796,0,0,0,0,0,2,0,0,0,2
5661,y4mn16a2ufqroj5jkjq2cls.ddns.net,dga,4.39032,4,20,32,1,0.2,0.1372,4,1,0,0,5,4,3,3,2,12
1558,pips.taboola.com,legit,3.32782,6,8,16,0,0.75,0.20799,5,0,0,0,5,2,0,0,0,2
9126,klamdofaadolbllb.net,dga,3.38418,6,13,20,1,0.46154,0.16921,3,0,0,0,3,2,0,0,0,2
3894,wamsm-a-6.prod.infra.webex.com,legit,3.9899,8,15,30,0,0.53333,0.133,6,4,3,2,15,4,2,0,0,6
8541,qksuqosswokscieo.org,dga,3.32193,7,12,20,1,0.58333,0.1661,0,0,0,0,0,1,0,0,0,1
2951,observe.aniview.com,legit,3.57662,8,9,19,0,0.88889,0.18824,4,1,1,0,6,5,2,1,0,8
6177,uxamcijo.dyndns.org,dga,3.82687,5,12,19,1,0.41667,0.20141,3,1,0,0,4,5,4,4,3,16
2219,10-courier.push.apple.com,legit,3.86347,8,11,25,0,0.72727,0.15454,9,4,3,2,18,4,0,0,0,4
63,itunes.apple.com,legit,3.625,6,8,16,0,0.75,0.22656,7,4,3,2,16,4,0,0,0,4
8750,o21hzivjsoyhsetdqbzlsawl68p22d20ivnv.com,dga,4.51531,7,24,40,1,0.29167,0.11288,1,0,0,0,1,2,0,0,0,2
2284,gnpfesdk-pa.googleapis.com,legit,3.84411,8,15,26,0,0.53333,0.14785,6,6,4,4,20,4,0,0,0,4
6552,yiscysvoonagq.co.uk,dga,3.57662,6,11,19,1,0.54545,0.18824,4,1,0,0,5,3,1,0,0,4
6257,basrzer.com.uy,dga,3.52164,4,8,14,1,0.5,0.25155,3,2,1,0,6,4,2,1,0,7
9946,mymoguywuwueaosk.org,dga,3.44644,8,11,20,1,0.72727,0.17232,1,0,0,0,1,1,0,0,0,1
8353,lufenna.com,dga,3.27761,4,6,11,1,0.66667,0.29796,1,0,0,0,1,1,0,0,0,1
6898,xxggoowjswgg.pw,dga,2.7899,2,12,15,1,0.16667,0.18599,1,1,0,0,2,0,0,0,0,0
2865,ioc-gw-prod-us-1a.sentinelone.net,legit,3.93061,11,15,33,0,0.73333,0.11911,10,3,1,0,14,7,4,0,0,11
8042,lymnuqkfuqppylvpi.com,dga,3.6897,4,16,21,1,0.25,0.1757,2,0,0,0,2,0,0,0,0,0
1235,s.mzstatic.com,legit,3.09307,3,9,14,0,0.33333,0.22093,7,0,0,0,7,5,1,0,0,6
3323,sb.l.google.com,legit,3.00624,4,8,15,0,0.5,0.20042,2,5,4,3,14,1,0,0,0,1
8012,rucpfytj.cc,dga,3.02717,1,9,11,1,0.11111,0.2752,0,0,0,0,0,0,0,0,0,0
1675,ads.betweendigital.com,legit,3.78875,8,12,22,0,0.66667,0.17222,5,0,0,0,5,6,1,0,0,7
9629,wnmxnhdcxwdsgcvyh.com,dga,3.59447,1,19,21,1,0.05263,0.17117,1,0,0,0,1,0,0,0,0,0
3914,e28622.a.akamaiedge.net,legit,3.41444,9,6,23,0,1.5,0.14845,5,5,5,3,18,4,0,0,0,4
2687,emea.cc.skype.com,legit,3.13072,5,9,17,0,0.55556,0.18416,2,0,0,0,2,2,0,0,0,2
8560,biuhbuivi.ddns.net,dga,3.35021,6,10,18,1,0.6,0.18612,2,1,0,0,3,4,4,3,2,13
6283,gotxldtutly.mx,dga,3.18201,2,11,14,1,0.18182,0.22729,0,0,0,0,0,0,0,0,0,0
4194,scripts.webcontentassessor.com,legit,3.55591,8,20,30,0,0.4,0.11853,10,2,0,0,12,10,4,0,0,14
5819,sxhmwpryjlcejgug.eu,dga,3.82687,4,14,19,1,0.28571,0.20141,2,0,0,0,2,1,0,0,0,1
120,i.ytimg.com,legit,2.91398,3,6,11,0,0.5,0.26491,1,0,0,0,1,1,0,0,0,1
5330,sfakmecawak.yi.org,dga,3.68354,6,10,18,1,0.6,0.20464,0,0,0,0,0,2,0,0,0,2
3918,uschi7.icloud-content.com,legit,3.73366,8,13,25,0,0.61538,0.14935,9,5,2,1,17,5,2,0,0,7
9150,maxetof.info,dga,3.25163,5,6,12,1,0.83333,0.27097,2,0,0,0,2,2,0,0,0,2
6562,toolbar-cooperative.tel,dga,3.5014,10,11,23,1,0.90909,0.15223,6,0,0,0,6,7,1,0,0,8
3944,behance.net,legit,2.84535,4,6,11,0,0.66667,0.25867,1,0,0,0,1,3,1,1,0,5
1131,nrdp.prod.ftl.netflix.com,legit,3.68386,4,17,25,0,0.23529,0.14735,5,4,3,2,14,2,1,0,0,3
2501,ad.mrtnsvr.com,legit,3.37878,2,10,14,0,0.2,0.24134,3,0,0,0,3,1,0,0,0,1
2244,15-courier.push.apple.com,legit,3.86347,8,11,25,0,0.72727,0.15454,9,4,3,2,18,4,0,0,0,4
3625,ebayimg.com,legit,3.27761,4,6,11,0,0.66667,0.29796,0,0,0,0,0,0,0,0,0,0
6019,rgpwtmkvqgg.su,dga,3.46772,1,12,14,1,0.08333,0.24769,0,0,0,0,0,0,0,0,0,0
5066,cqcesugi0y8y.top,dga,3.75,4,9,16,1,0.44444,0.23438,2,0,0,0,2,3,0,0,0,3
7635,smnfykpqyjqmk.net,dga,3.49923,1,15,17,1,0.06667,0.20584,0,0,0,0,0,0,0,0,0,0
3293,maps.windows.com,legit,3.375,4,10,16,0,0.4,0.21094,4,0,0,0,4,3,0,0,0,3
7608,laoffkfdabceadaf.website,dga,3.55351,9,14,24,1,0.64286,0.14806,4,1,0,0,5,3,0,0,0,3
5609,prrozlundgutmgl.com,dga,3.61635,4,14,19,1,0.28571,0.19033,2,0,0,0,2,1,0,0,0,1
7026,fyytaomqlkc.yi.org,dga,3.68354,4,12,18,1,0.33333,0.20464,1,0,0,0,1,2,0,0,0,2
2395,synchroscript.deliveryengine.adswizz.com,legit,4.12757,11,26,40,0,0.42308,0.10319,11,1,0,0,12,9,2,0,0,11
11,prod.cloud.netflix.com,legit,3.75444,6,13,22,0,0.46154,0.17066,7,6,5,3,21,2,1,0,0,3
1570,a-0001.a-msedge.net,legit,3.43162,5,6,19,0,0.83333,0.18061,4,2,1,0,7,3,0,0,0,3
8931,wsgixtufevrvj.biz,dga,3.85217,4,12,17,1,0.33333,0.2266,0,0,0,0,0,0,0,0,0,0
8970,zutskfusctgnqzt.com,dga,3.57662,3,15,19,1,0.2,0.18824,1,0,0,0,1,0,0,0,0,0
2096,ekr.zdassets.com,legit,3.45282,4,10,16,0,0.4,0.2158,1,0,0,0,1,3,1,0,0,4
1911,sid.storygize.net,legit,3.49923,5,10,17,0,0.5,0.20584,2,0,0,0,2,3,0,0,0,3
3286,mail.onmicrosoft.com,legit,3.38418,7,11,20,0,0.63636,0.16921,7,7,6,5,25,4,0,0,0,4
3813,fitbit.com,legit,2.92193,3,6,10,0,0.5,0.29219,0,0,0,0,0,1,0,0,0,1
8095,dataheatsetholdfinanceguide.com,dga,3.80872,13,17,31,1,0.76471,0.12286,6,0,0,0,6,9,2,1,0,12
3760,ringcentral.com,legit,3.50689,4,10,15,0,0.4,0.23379,5,1,0,0,6,5,4,0,0,9
3266,gameplay.intel.com,legit,3.61437,6,10,18,0,0.6,0.2008,5,0,0,0,5,5,0,1,0,6
6173,nwgsupbxiqyonbou.eu,dga,3.68188,7,11,19,1,0.63636,0.19378,2,0,0,0,2,2,0,0,0,2
1461,prd.aadg.trafficmanager.net,legit,3.52824,8,16,27,0,0.5,0.13068,10,3,1,3,17,6,1,0,0,7
513,in.appcenter.ms,legit,3.37356,4,9,15,0,0.44444,0.2249,9,3,1,0,13,5,2,0,0,7
7953,udduunekre.ddns.net,dga,2.97084,6,11,19,1,0.54545,0.15636,4,1,0,0,5,6,4,3,2,15
303,atm-fp-direct.office.com,legit,3.60539,7,13,24,0,0.53846,0.15022,5,4,4,3,16,5,0,0,0,5
7995,ycqoaoa4a4io.net,dga,3.28064,8,5,16,1,1.6,0.20504,0,0,0,0,0,0,0,0,0,0
6141,town-monetary.tk,dga,3.45282,4,10,16,1,0.4,0.2158,2,0,0,0,2,5,1,0,0,6
3591,static.addtoany.com,legit,3.32636,6,11,19,0,0.54545,0.17507,7,0,0,0,7,7,1,0,0,8
3507,media.yahoo.com,legit,3.1899,7,6,15,0,1.16667,0.21266,2,0,0,1,3,1,0,0,0,1
3884,wise.public.cdn.office.net,legit,3.69026,8,14,26,0,0.57143,0.14193,9,6,5,3,23,5,0,0,0,5
7999,uarmoa.net,dga,3.12193,5,4,10,1,1.25,0.31219,0,0,0,0,0,1,0,0,0,1
7365,pexapeises.ddns.net,dga,3.15557,6,11,19,1,0.54545,0.16608,6,1,0,0,7,7,3,3,2,15
8536,vvcrjplbvwctmtxuhym.com,dga,3.8164,2,20,23,1,0.1,0.16593,2,0,0,0,2,0,0,0,0,0
3218,cnn.com,legit,2.23593,1,5,7,0,0.2,0.31942,0,0,0,0,0,0,0,0,0,0
1046,pull-flv-f77-va01.tiktokcdn.com,legit,4.1313,5,17,31,0,0.29412,0.13327,4,6,9,9,28,2,0,0,0,2
1773,pull-f5-tt02-infra.fcdn.us.gts.ttoverseaus.net,legit,4.11283,10,25,46,0,0.4,0.08941,10,2,3,1,16,7,3,0,0,10
8444,oomfnwmmeplnoij.com,dga,3.30056,6,12,19,1,0.5,0.17371,2,0,0,0,2,1,0,0,0,1
960,api.rlcdn.com,legit,3.39275,3,8,13,0,0.375,0.26098,4,2,1,0,7,1,0,0,0,1
1115,msftstatic.com,legit,3.03915,3,10,14,0,0.3,0.21708,5,0,0,0,5,5,1,0,0,6
3172,tiktokcdn-us.com.atomile.com,legit,3.69951,9,15,28,0,0.6,0.13213,11,8,9,7,35,7,2,1,0,10
8292,nagebof.info,dga,3.08496,5,6,12,1,0.83333,0.25708,2,1,0,0,3,1,0,0,0,1
5996,tamjvrbnysut.ru,dga,3.50689,3,11,15,1,0.27273,0.23379,2,0,0,0,2,3,0,0,0,3
7232,kahprel.eu,dga,3.12193,4,5,10,1,0.8,0.31219,2,0,0,0,2,2,0,0,0,2
4075,edna.yahoo.net,legit,3.09307,6,6,14,0,1.0,0.22093,3,0,0,1,4,2,0,0,0,2
1044,pull-flv-l10-gcp01.tiktokcdn.com,legit,4.01532,4,19,32,0,0.21053,0.12548,4,6,9,9,28,2,0,0,0,2
6834,nuhildim.com,dga,3.25163,4,7,12,1,0.57143,0.27097,0,0,0,0,0,0,0,0,0,0
20,officeapps.live.com,legit,3.51109,7,10,19,0,0.7,0.18479,8,5,3,2,18,4,0,0,0,4
9310,kuwacyoioyk2.org,dga,3.45282,6,8,16,1,0.75,0.2158,0,0,0,0,0,1,0,0,0,1
9858,qkwioogeacmukegi.org,dga,3.54644,9,10,20,1,0.9,0.17732,3,1,0,0,4,3,0,0,0,3
2399,ols.officeapps.live.com,legit,3.5014,8,12,23,0,0.66667,0.15223,8,5,4,3,20,4,0,0,0,4
4655,apple.com-v1.edgesuite.net,legit,3.91719,9,12,26,0,0.75,0.15066,11,7,4,2,24,9,2,1,0,12
3372,ichnaea-web.netflix.com,legit,3.88205,8,12,23,0,0.66667,0.16878,3,0,0,0,3,4,0,0,0,4
5106,parufeufxagufae.ddns.net,dga,3.54248,9,13,24,1,0.69231,0.1476,3,1,0,0,4,5,4,3,2,14
8545,ocltdgpmnef.com,dga,3.50689,3,11,15,1,0.27273,0.23379,0,0,0,0,0,1,0,0,0,1
1180,uiboot.netflix.com,legit,3.57243,7,9,18,0,0.77778,0.19847,2,0,0,0,2,2,0,0,0,2
3041,ox-rtb-us-east1.openx.net,legit,3.67327,7,12,25,0,0.58333,0.14693,4,1,0,0,5,4,0,0,0,4
2046,sync.aniview.com,legit,3.5,5,9,16,0,0.55556,0.21875,1,0,0,0,1,2,0,0,0,2
3120,ib.mookie1.com,legit,3.03915,6,5,14,0,1.2,0.21708,2,0,0,0,2,0,0,1,0,1
3498,qvdt3feo.com,legit,3.4183,3,7,12,0,0.42857,0.28486,0,0,0,0,0,0,0,0,0,0
2393,s3.us-west-2.amazonaws.com,legit,3.71929,7,12,26,0,0.58333,0.14305,7,1,3,3,14,5,1,0,0,6
9524,cegetlacgum.com,dga,3.1899,5,9,15,1,0.55556,0.21266,2,0,0,0,2,5,0,0,0,5
2667,cdnwidget.com,legit,3.39275,3,9,13,0,0.33333,0.26098,3,2,0,0,5,3,0,0,0,3
1157,m.facebook.com,legit,3.03915,5,7,14,0,0.71429,0.21708,2,0,0,0,2,2,0,0,0,2
3420,web.ssp.yahoo.com,legit,3.41042,5,9,17,0,0.55556,0.20061,2,0,0,1,3,0,0,0,0,0
6964,qwldhuxynjuhap.ru,dga,3.69012,4,12,17,1,0.33333,0.21707,1,0,0,0,1,0,0,0,0,0
1253,nav.smartscreen.microsoft.com,legit,3.59835,8,18,29,0,0.44444,0.12408,9,8,7,6,30,6,0,0,0,6
8743,bsjzprkudw.com,dga,3.80735,2,11,14,1,0.18182,0.27195,1,0,0,0,1,0,0,0,0,0
7182,mistakepagejurywalkexperience.com,dga,4.06668,13,19,33,1,0.68421,0.12323,7,1,0,0,8,9,3,1,0,13
6241,fmval.com.mt,dga,3.02206,2,8,12,1,0.25,0.25184,2,2,1,0,5,2,2,1,0,5
7068,soluteproilliopquibus.com,dga,3.59327,11,13,25,1,0.84615,0.14373,5,1,0,0,6,1,1,0,0,2
4658,samsungcloudsolution.com,legit,3.52206,9,14,24,0,0.64286,0.14675,6,3,2,1,12,4,2,1,0,7
5744,kuwukkygqmksssge.org,dga,3.34644,4,15,20,1,0.26667,0.16732,1,0,0,0,1,1,0,0,0,1
6368,xtipyy.hn,dga,2.9477,1,7,9,1,0.14286,0.32752,1,0,0,0,1,1,0,0,0,1
1138,dsx.mp.microsoft.com,legit,3.40869,4,13,20,0,0.30769,0.17043,8,8,7,7,30,2,0,0,0,2
7284,ballvacationgradebodyassociate.com,dga,3.84438,14,19,34,1,0.73684,0.11307,6,0,0,0,6,9,5,2,1,17
9132,ptcoxwjvbw.com,dga,3.37878,2,11,14,1,0.18182,0.24134,1,0,0,0,1,1,0,0,0,1
6924,cisimeqscwawamek.org,dga,3.62193,7,12,20,1,0.58333,0.1811,1,0,0,0,1,3,0,0,0,3
7686,uzwncnf.mooo.com,dga,3.0,5,9,16,1,0.55556,0.1875,2,0,0,0,2,0,1,2,1,4
4516,dejavu.apple.com,legit,3.5,6,8,16,0,0.75,0.21875,5,4,3,2,14,2,0,0,0,2
585,tremorhub.com,legit,3.2389,4,8,13,0,0.5,0.24915,1,0,0,0,1,3,0,0,0,3
4806,device-messaging-na.amazon.com,legit,3.69807,11,15,30,0,0.73333,0.12327,8,2,3,3,16,8,2,0,0,10
7870,cewcqqscqoasyiok.org,dga,3.50869,6,13,20,1,0.46154,0.17543,1,0,0,0,1,2,0,0,0,2
8993,imlqfenansnan.com,dga,3.38158,5,11,17,1,0.45455,0.19892,1,0,0,0,1,3,2,4,3,12
622,us.tiktokv.com,legit,3.23593,4,8,14,0,0.5,0.23114,4,5,4,3,16,1,0,0,0,1
9890,yjqpqlgdgf76e0m.ddns.net,dga,3.97018,2,17,24,1,0.11765,0.16542,2,1,0,0,3,4,3,2,2,11
5147,isvoehitl.ddns.net,dga,3.39215,5,11,18,1,0.45455,0.18845,2,1,0,0,3,6,3,2,1,12
792,gsp10-ssl.apple.com,legit,3.53689,3,11,19,0,0.27273,0.18615,5,4,3,2,14,1,0,0,0,1
354,play.itunes.apple.com,legit,3.65376,7,11,21,0,0.63636,0.17399,7,4,3,2,16,5,0,0,0,5
1555,eas.outlook.com,legit,3.24022,7,6,15,0,1.16667,0.21601,5,0,0,0,5,2,0,0,0,2
6360,rxwgzdmbkbqgtgkrscpvmftlbqh.ru,dga,4.16474,1,28,30,1,0.03571,0.13882,0,0,0,0,0,0,0,0,0,0
1581,s.company-target.com,legit,3.72193,5,12,20,0,0.41667,0.1861,5,2,1,0,8,7,2,1,0,10
5887,yaugsgcymewoiyao.org,dga,3.50869,8,11,20,1,0.72727,0.17543,0,0,0,0,0,0,0,0,0,0
9724,sqyacajelhdhudle.eu,dga,3.47135,7,11,19,1,0.63636,0.1827,1,0,0,0,1,4,0,0,0,4
2176,gspe35-ssl.ls-apple.com.akadns.net,legit,3.83366,7,19,34,0,0.36842,0.11275,10,9,9,9,37,5,3,1,0,9
6499,falucge.com,dga,3.27761,4,6,11,1,0.66667,0.29796,1,0,0,0,1,1,0,0,0,1
5331,cmffmemddbfedfok.info,dga,3.19615,5,15,21,1,0.33333,0.1522,1,0,0,0,1,3,0,0,0,3
8697,aammkomyyswgagsg.org,dga,3.14644,5,14,20,1,0.35714,0.15732,1,0,0,0,1,2,0,0,0,2
6956,c3xz3zrxaildp56paw.ru,dga,3.82089,4,12,21,1,0.33333,0.18195,0,0,0,0,0,0,0,0,0,0
4201,cs.adingo.jp,legit,3.4183,3,7,12,0,0.42857,0.28486,4,0,0,0,4,1,1,0,0,2
1508,prod.remote-settings.prod.webservices.mozgcp.net,legit,3.91796,13,29,48,0,0.44828,0.08162,14,6,4,3,27,11,4,1,0,16
5633,vipiimvoe.ddns.net,dga,3.35021,6,10,18,1,0.6,0.18612,4,1,0,0,5,4,4,3,2,13
6452,twqdklaiex.com,dga,3.80735,4,9,14,1,0.44444,0.27195,0,0,0,0,0,1,0,0,0,1
528,360yield.com,legit,3.58496,3,5,12,0,0.6,0.29875,0,0,0,0,0,1,0,0,0,1
9246,svbihqxlvbgectjxa.me,dga,3.92193,4,15,20,1,0.26667,0.1961,1,0,0,0,1,2,0,0,0,2
4946,ecs-office.s-0005.s-msedge.net,legit,3.64441,7,13,30,0,0.53846,0.12148,7,6,4,2,19,6,0,0,0,6
6642,tunakaq.info,dga,3.25163,5,6,12,1,0.83333,0.27097,0,1,0,0,1,0,0,0,0,0
5504,ugjywfellfju.co.uk,dga,3.46132,5,11,18,1,0.45455,0.1923,2,1,0,0,3,2,1,0,0,3
1651,c.footprint.net,legit,3.1899,4,9,15,0,0.44444,0.21266,4,0,0,0,4,2,1,0,0,3
8338,meafoamkelbcncno.co,dga,3.32636,7,11,19,1,0.63636,0.17507,2,0,0,0,2,3,0,0,0,3
8962,qqdccbpnvveq.ru,dga,3.32323,2,12,15,1,0.16667,0.22155,0,0,0,0,0,1,0,0,0,1
4654,widget.uservoice.com,legit,3.68418,8,10,20,0,0.8,0.18421,6,3,1,0,10,6,2,1,0,9
8844,mametok.info,dga,3.25163,5,6,12,1,0.83333,0.27097,2,1,0,0,3,3,0,0,0,3
7457,lacabuusaxroobw.ddns.net,dga,3.80351,8,14,24,1,0.57143,0.15848,5,1,0,0,6,7,3,3,2,15
1232,mozaws.net,legit,3.32193,3,6,10,0,0.5,0.33219,0,0,0,0,0,0,0,0,0,0
127,api.msn.com,legit,3.0958,3,6,11,0,0.5,0.28144,3,1,1,0,5,0,0,0,0,0
524,ads.pubmatic.com,legit,3.5,5,9,16,0,0.55556,0.21875,7,0,0,0,7,4,1,0,0,5
2421,plista.com,legit,3.32193,3,6,10,0,0.5,0.33219,4,0,0,0,4,3,1,0,0,4
7667,jvgiaaxve.tv,dga,3.02206,4,7,12,1,0.57143,0.25184,0,0,0,0,0,1,0,0,0,1
666,static.hotjar.com,legit,3.33718,5,10,17,0,0.5,0.1963,5,0,0,0,5,6,1,0,0,7
394,ampproject.org,legit,3.37878,4,9,14,0,0.44444,0.24134,4,1,0,0,5,2,1,0,0,3
3068,quantcast.com,legit,3.2389,4,8,13,0,0.5,0.24915,2,1,0,0,3,4,0,0,0,4
5144,vegetableshear.net,dga,3.30272,7,10,18,1,0.7,0.18348,5,0,0,0,5,8,0,0,0,8
8756,cnfplna.tv,dga,3.12193,1,8,10,1,0.125,0.31219,1,0,0,0,1,0,0,0,0,0
4124,consent.cookiebot.com,legit,3.2321,8,11,21,0,0.72727,0.15391,7,3,0,0,10,5,4,0,0,9
6352,lewopuuwumuv.ddns.net,dga,3.53517,7,12,21,1,0.58333,0.16834,3,1,0,0,4,5,3,2,1,11
9771,urbcjvrglmdf.org,dga,3.57782,2,13,16,1,0.15385,0.22361,0,0,0,0,0,0,0,0,0,0
6800,novissimisvenie.com,dga,3.0503,8,10,19,1,0.8,0.16054,2,0,0,0,2,6,0,0,0,6
2148,minutemedia-prebid.com,legit,3.72013,9,11,22,0,0.81818,0.1691,6,0,0,0,6,6,0,0,0,6
4649,fp-as-nocache.azureedge.net,legit,3.8525,10,13,27,0,0.76923,0.14269,5,2,1,2,10,6,0,0,0,6
1025,pull-flv-f77-tt01.fcdn.us.tiktokv.com,legit,4.06717,5,21,37,0,0.2381,0.10992,6,7,7,4,24,2,0,0,0,2
4519,pull-f5-tt01.fcdn.us.tiktokv.com.c.worldfcdn2.com,legit,4.155,7,29,49,0,0.24138,0.0848,8,10,9,5,32,5,2,1,0,8
6068,wzfffmieu.com.ar,dga,3.45282,5,9,16,1,0.55556,0.2158,3,2,1,0,6,3,2,1,0,6
9448,allufowgeh.com,dga,3.52164,5,8,14,1,0.625,0.25155,1,0,0,0,1,1,0,0,0,1
6525,jphcgamcgvluh5rtp3.biz,dga,4.0958,3,16,22,1,0.1875,0.18617,1,0,0,0,1,1,0,0,0,1
791,omnitagjs.com,legit,3.39275,4,8,13,0,0.5,0.26098,1,0,0,0,1,4,1,0,0,5
8138,vuxdeoca.ru,dga,3.27761,5,5,11,1,1.0,0.29796,0,0,0,0,0,2,0,0,0,2
1479,sfb.trafficmanager.net,legit,3.57262,6,14,22,0,0.42857,0.16239,6,3,1,3,13,6,1,0,0,7
1379,protected-by.clarium.io,legit,3.91487,8,12,23,0,0.66667,0.17021,5,1,0,0,6,6,1,0,0,7
9212,rkuqqbkibcjotpuge.me,dga,3.82193,6,13,20,1,0.46154,0.1911,1,0,0,0,1,1,0,0,0,1
7136,qoqbeopi.ru,dga,3.0958,5,5,11,1,1.0,0.28144,1,0,0,0,1,1,1,0,0,2
9155,mgodfoptdhwvevuul.com,dga,3.78494,6,14,21,1,0.42857,0.18024,0,0,0,0,0,1,0,0,0,1
227,ib.adnxs.com,legit,3.4183,3,7,12,0,0.42857,0.28486,3,0,0,0,3,1,0,0,0,1
6103,5ju8wfcdm632e8ilg6ade0k.ddns.net,dga,4.35141,6,16,32,1,0.375,0.13598,4,1,0,0,5,5,3,2,2,12
913,firefox.settings.services.mozilla.com,legit,3.89175,12,21,37,0,0.57143,0.10518,10,2,1,1,14,10,3,1,0,14
1586,media3.giphy.com,legit,3.625,5,8,16,0,0.625,0.22656,1,0,0,0,1,1,0,0,0,1
7510,pnfebt.dyndns.org,dga,3.57247,2,13,17,1,0.15385,0.21015,2,1,0,0,3,4,3,4,3,14
7012,fuukfocat.ddns.net,dga,3.50326,5,11,18,1,0.45455,0.19463,3,1,0,0,4,6,3,2,1,12
4540,at.teads.tv,legit,2.66353,3,6,11,0,0.5,0.24214,6,0,0,0,6,3,0,0,0,3
2795,cl3-cdn-us.origin-apple.com.akadns.net,legit,4.08307,10,20,38,0,0.5,0.10745,14,10,9,9,42,8,3,1,0,12
2476,stackpath.bootstrapcdn.com,legit,3.61334,6,18,26,0,0.33333,0.13897,8,1,0,0,9,6,1,0,0,7
4770,getrockerbox.com,legit,3.32782,5,10,16,0,0.5,0.20799,3,0,0,0,3,3,0,0,0,3
8457,oaoaaloegapiiwnjyp.co,dga,3.43994,11,9,21,1,1.22222,0.16381,3,1,0,0,4,0,0,0,0,0
9514,ymunmmpscbih.xyz,dga,3.57782,2,13,16,1,0.15385,0.22361,0,0,0,0,0,0,0,0,0,0
8837,faddfeeknffablne.com,dga,3.38418,6,13,20,1,0.46154,0.16921,1,0,0,0,1,2,0,0,0,2
3738,fid.agkn.com,legit,3.4183,3,7,12,0,0.42857,0.28486,2,0,0,0,2,0,0,0,0,0
3307,static-forms.klaviyo.com,legit,3.80351,7,14,24,0,0.5,0.15848,6,0,0,0,6,7,1,0,0,8
2135,datadog.pool.ntp.org,legit,3.18418,6,11,20,0,0.54545,0.15921,5,0,0,0,5,2,0,0,0,2
6734,legindulgepape.com,dga,3.57243,7,10,18,1,0.7,0.19847,4,0,0,0,4,4,0,0,0,4
9744,dmyyoibkmo.com,dga,2.98523,4,9,14,1,0.44444,0.21323,0,0,0,0,0,0,0,0,0,0
7690,cfkvptysiokuhird.eu,dga,3.93214,6,12,19,1,0.5,0.20695,0,0,0,0,0,1,0,0,0,1
7390,gxit3vahqrq0c4i.ddns.net,dga,4.08496,4,15,24,1,0.26667,0.17021,2,1,0,0,3,5,4,3,2,14
6932,pufobulowyr.eu,dga,3.32486,6,7,14,1,0.85714,0.23749,1,0,0,0,1,0,0,0,0,0
5719,uomugeoyiekygqag.org,dga,3.38418,9,10,20,1,0.9,0.16921,1,0,0,0,1,2,0,0,0,2
7915,transferredphysiology.co,dga,3.93872,7,16,24,1,0.4375,0.16411,5,0,0,0,5,7,2,0,0,9
1407,conv-a.wbx2.com,legit,3.50689,3,8,15,0,0.375,0.23379,2,1,0,0,3,2,1,0,0,3
2190,pull-c5-va01.tiktokcdn.com.c.bytetcdn.com,legit,4.09233,7,24,41,0,0.29167,0.09981,7,10,12,10,39,6,2,1,0,9
7341,hadabos.info,dga,3.25163,5,6,12,1,0.83333,0.27097,1,0,0,0,1,0,0,0,0,0
5235,vutiqoxiokivq.ddns.net,dga,3.60694,7,13,22,1,0.53846,0.16395,3,1,0,0,4,5,3,3,2,13
1760,dataops.mozgcp.net,legit,3.61437,5,11,18,0,0.45455,0.2008,4,0,0,0,4,2,0,0,0,2
7603,xutyfad.info,dga,3.4183,4,7,12,1,0.57143,0.28486,1,0,0,0,1,0,0,0,0,0
224,adsrvr.org,legit,2.84644,2,7,10,0,0.28571,0.28464,2,0,0,0,2,0,0,0,0,0
8469,qgyeqyqskackmgqm.org,dga,3.38418,3,16,20,1,0.1875,0.16921,0,0,0,0,0,1,0,0,0,1
4491,rtb-csync-geo.usersync-prod-sas.akadns.net,legit,3.88555,9,26,42,0,0.34615,0.09251,10,6,5,3,24,6,4,0,0,10
9290,adinebca.ddns.net,dga,3.17512,5,10,17,1,0.5,0.18677,4,1,0,0,5,7,5,3,2,17
60,www.bing.com,legit,3.02206,2,8,12,0,0.25,0.25184,1,0,0,0,1,1,1,0,0,2
4489,printerconfigurations.googleusercontent.com,legit,3.76617,16,25,43,0,0.64,0.08759,16,8,4,3,31,13,8,3,1,25
1374,prod.uidapi.com,legit,3.24022,6,7,15,0,0.85714,0.21601,5,4,2,1,12,0,1,0,0,1
407,moatads.com,legit,2.91398,4,6,11,0,0.66667,0.26491,4,0,0,0,4,2,0,0,0,2
5679,galef.eu,dga,2.75,4,3,8,1,1.33333,0.34375,1,0,0,0,1,1,0,0,0,1
4173,ugc.bazaarvoice.com,legit,3.53689,8,9,19,0,0.88889,0.18615,2,1,0,0,3,3,0,0,0,3
6792,xudamaecpuri.ddns.net,dga,3.6897,7,12,21,1,0.58333,0.1757,4,2,0,0,6,8,4,3,2,17
9760,eadhypi.dyndns.org,dga,3.57243,4,12,18,1,0.33333,0.19847,5,1,0,0,6,5,4,4,3,16
3707,www.amazon.ca,legit,2.81507,4,7,13,0,0.57143,0.21654,4,1,3,3,11,3,0,0,0,3
2975,client-office365-tas.msedge.net,legit,3.9747,9,15,31,0,0.6,0.12822,12,7,4,2,25,8,1,0,0,9
1436,lynx.cognitivlabs.com,legit,3.82089,5,14,21,0,0.35714,0.18195,3,1,0,0,4,5,1,0,0,6
5555,gyhhcvsocdswdsgqf.cc,dga,3.38418,1,18,20,1,0.05556,0.16921,2,0,0,0,2,0,0,0,0,0
3339,enroll.cisco.com,legit,3.15564,5,9,16,0,0.55556,0.19723,4,0,0,0,4,3,0,0,0,3
9951,wmnoegeopffxzyqukde.com,dga,3.93618,7,15,23,1,0.46667,0.17114,1,0,0,0,1,2,0,0,0,2
7669,southreach.net,dga,3.37878,5,8,14,1,0.625,0.24134,3,0,0,0,3,3,0,0,0,3
6073,uomyecqewumwcmio.org,dga,3.44644,8,11,20,1,0.72727,0.17232,1,0,0,0,1,3,0,0,0,3
1257,p16-sign.tiktokcdn-us.com,legit,3.92386,5,14,25,0,0.35714,0.15695,5,6,7,6,24,3,0,0,0,3
7304,dydrdcavhsgahpp.info,dga,3.78418,4,15,20,1,0.26667,0.18921,1,0,0,0,1,1,0,0,0,1
8664,nhwqbqqmb.com,dga,3.02699,1,11,13,1,0.09091,0.23285,0,0,0,0,0,0,0,0,0,0
7073,nqywjcoeyecmp.ru,dga,3.625,4,11,16,1,0.36364,0.22656,1,0,0,0,1,2,0,0,0,2
6328,rxulsburjcpylo.nu,dga,3.57247,4,12,17,1,0.33333,0.21015,1,0,0,0,1,0,0,0,0,0
1602,sync.tidaltv.com,legit,3.625,3,11,16,0,0.27273,0.22656,2,1,0,0,3,1,0,0,0,1
7701,mujiqict.ru,dga,3.0958,4,6,11,1,0.66667,0.28144,1,0,0,0,1,1,0,0,0,1
7223,runofdu.com,dga,3.0958,4,6,11,1,0.66667,0.28144,1,0,0,0,1,0,0,0,0,0
4006,e8960.e2.akamaiedge.net,legit,3.60533,9,6,23,0,1.5,0.15675,5,5,5,3,18,4,0,0,0,4
9570,rodoripxsqqojsmw.biz,dga,3.68418,5,14,20,1,0.35714,0.18421,1,1,0,0,2,2,0,0,0,2
2655,onedscolprdeus12.eastus.cloudapp.azure.com,legit,3.89185,15,21,42,0,0.71429,0.09266,17,5,3,4,29,9,1,0,0,10
3268,lyr.pubmatic.com,legit,3.625,4,10,16,0,0.4,0.22656,4,0,0,0,4,4,1,0,0,5
1017,pull-w5-gcp01.tiktokcdn.com,legit,4.06026,4,16,27,0,0.25,0.15038,4,6,9,9,28,2,0,0,0,2
7262,kcadocaakfbbbfff.online,dga,3.41444,7,15,23,1,0.46667,0.14845,1,0,0,0,1,1,0,0,0,1
4661,dualstack.reddit.map.fastly.net,legit,3.83307,8,19,31,0,0.42105,0.12365,8,1,0,0,9,9,0,0,0,9
1989,firebaseio.com,legit,3.37878,7,6,14,0,1.16667,0.24134,2,0,0,0,2,3,0,0,0,3
5909,tape-pushed.com,dga,3.64022,5,8,15,1,0.625,0.24268,4,0,0,0,4,2,0,0,0,2
9668,nogfpc.info,dga,2.91398,3,7,11,1,0.42857,0.26491,0,0,0,0,0,0,0,0,0,0
2849,edge.permutive.app,legit,3.35021,7,9,18,0,0.77778,0.18612,5,2,1,0,8,5,0,0,0,5
5934,fxdhcbutfkywuofubltfm.sh,dga,3.80351,4,19,24,1,0.21053,0.15848,1,0,0,0,1,0,0,0,0,0
4241,nebula-cdn.kampyle.com,legit,3.82307,6,13,22,0,0.46154,0.17378,4,2,1,0,7,5,0,0,0,5
5170,ogufsurnofs.com,dga,3.1899,5,9,15,1,0.55556,0.21266,1,0,0,0,1,1,0,0,0,1
9328,rynucalagew.eu,dga,3.37878,6,7,14,1,0.85714,0.24134,1,1,0,0,2,3,0,0,0,3
4557,sync.tubemogul.com,legit,3.61437,5,11,18,0,0.45455,0.2008,1,0,0,0,1,2,0,0,0,2
7256,yrvoxyfqbex.com,dga,3.50689,3,11,15,1,0.27273,0.23379,0,0,0,0,0,1,3,2,1,7
8004,iqdbileqevwdne.biz,dga,3.30827,6,11,18,1,0.54545,0.18379,2,0,0,0,2,3,0,0,0,3
1142,incoming.telemetry.mozilla.org,legit,3.68925,10,17,30,0,0.58824,0.12298,7,1,0,0,8,10,2,0,0,12
4497,api-glb-ause1a.smoot.apple.com,legit,3.8314,11,13,30,0,0.84615,0.12771,9,5,3,2,19,2,0,0,0,2
5966,negociichristianiomnibus.com,dga,3.60113,12,15,28,1,0.8,0.12861,4,0,0,0,4,9,2,0,2,13
240,th.bing.com,legit,3.27761,2,7,11,0,0.28571,0.29796,1,0,0,0,1,1,1,0,0,2
6753,fydrmdqkjeg.yi.org,dga,3.61437,3,13,18,1,0.23077,0.2008,0,0,0,0,0,0,0,0,0,0
268,api.flightproxy.teams.microsoft.com,legit,3.92172,10,21,35,0,0.47619,0.11205,15,10,8,6,39,5,1,0,0,6
4481,send.microad.jp,legit,3.64022,4,9,15,0,0.44444,0.24268,9,4,3,2,18,5,0,0,0,5
1416,cloudops.mozgcp.net,legit,3.68188,5,12,19,0,0.41667,0.19378,4,3,2,1,10,0,0,0,0,0
4820,search16-normal-useast2a.tiktokv.com,legit,4.16257,11,18,36,0,0.61111,0.11563,7,6,4,3,20,8,0,0,0,8
7129,okhimmqqldtw.me.uk,dga,3.57243,4,12,18,1,0.33333,0.19847,1,0,0,0,1,0,0,0,0,0
5828,csblertchaqvnacl.ir,dga,3.68188,4,14,19,1,0.28571,0.19378,2,0,0,0,2,3,1,0,0,4
406,beacons2.gvt2.com,legit,3.61687,4,9,17,0,0.44444,0.21276,3,1,0,0,4,6,1,0,0,7
3577,s.worldfcdn.com,legit,3.37356,2,11,15,0,0.18182,0.2249,3,1,0,0,4,2,0,0,0,2
9049,capitemomiache.ddns.net,dga,3.62118,8,13,23,1,0.61538,0.15744,7,2,0,0,9,11,4,3,2,20
1957,collabrtc.officeapps.live.com,legit,3.74541,9,17,29,0,0.52941,0.12915,9,5,4,3,21,6,0,0,0,6
1489,secure-gl.imrworldwide.com,legit,3.71929,8,15,26,0,0.53333,0.14305,2,0,0,0,2,5,0,0,0,5
1725,pull-flv-l16-tt01.tiktokcdn-us.com,legit,4.02864,5,19,34,0,0.26316,0.11849,5,6,9,9,29,2,0,0,0,2
7465,cfpjio.com.mx,dga,3.08506,3,8,13,1,0.375,0.23731,2,2,1,0,5,2,2,1,0,5
6696,aemcgmgswisoamqs.org,dga,3.40869,6,13,20,1,0.46154,0.17043,1,0,0,0,1,3,0,0,0,3
6969,scwomysdtm.com,dga,3.03915,2,11,14,1,0.18182,0.21708,0,0,0,0,0,1,0,0,0,1
4025,pushmessage.samsung.com,legit,3.37728,7,14,23,0,0.5,0.14684,5,1,0,0,6,4,1,0,0,5
7095,ixtfbpjtcjxqswo.sx,dga,3.57243,2,15,18,1,0.13333,0.19847,0,0,0,0,0,0,0,0,0,0
7528,53w8lyusorptirqfxl.ru,dga,3.97542,4,13,21,1,0.30769,0.18931,2,0,0,0,2,2,0,0,0,2
8822,fcfemenddfabokbn.de,dga,3.28663,5,13,19,1,0.38462,0.17298,1,0,0,0,1,4,0,0,0,4
1383,net.globalredir.akadns.net,legit,3.66123,8,15,26,0,0.53333,0.14082,6,3,4,3,16,6,1,0,0,7
3570,eastus1-0.pushnp.svc.ms,legit,3.63815,4,13,23,0,0.30769,0.15818,4,1,0,0,5,3,0,0,0,3
9334,evassqaprsgccjx.info,dga,3.88418,5,14,20,1,0.35714,0.19421,2,0,0,0,2,1,1,0,0,2
2891,onedscolprdcus08.centralus.cloudapp.azure.com,legit,3.91643,14,25,45,0,0.56,0.08703,19,5,3,4,31,8,3,0,0,11
8737,dreamfish.net,dga,3.54659,4,8,13,1,0.5,0.27281,3,0,0,0,3,4,0,0,0,4
7379,tbwywqfsdcghdbalb.cc,dga,3.64644,1,18,20,1,0.05556,0.18232,0,0,0,0,0,0,0,0,0,0
1533,translate-pa.googleapis.com,legit,3.76397,10,14,27,0,0.71429,0.13941,8,6,4,4,22,9,3,0,0,12
1544,common.online.office.com,legit,3.05875,9,12,24,0,0.75,0.12745,8,5,4,3,20,7,2,0,0,9
7493,linetastecancelparentbalance.com,dga,3.47722,12,19,32,1,0.63158,0.10866,9,2,0,0,11,16,3,1,0,20
2753,dclk-match.dotomi.com,legit,3.42733,5,13,21,0,0.38462,0.16321,4,0,0,0,4,5,0,0,0,5
7676,c39d30i55lypvbtdyh14iyoxm59gsdsd30fsn40.info,dga,4.40195,5,24,44,1,0.20833,0.10004,1,0,0,0,1,0,0,0,0,0
4762,alldcs.outbrain.org,legit,3.72161,6,11,19,0,0.54545,0.19587,4,0,0,0,4,2,0,0,0,2
1704,hubspot.com,legit,3.27761,3,7,11,0,0.42857,0.29796,0,0,0,0,0,0,0,0,0,0
1103,query.ess.apple.com,legit,3.53689,6,10,19,0,0.6,0.18615,8,4,3,2,17,3,1,0,0,4
8109,cluqxkdsholapet.com,dga,3.93214,5,13,19,1,0.38462,0.20695,2,0,0,0,2,2,0,5,5,12
3411,fdv2-t-msedge.net,legit,3.45482,3,10,17,0,0.3,0.20322,3,2,1,0,6,3,0,0,0,3
6485,qirkagei.ru,dga,3.0958,5,5,11,1,1.0,0.28144,1,1,0,0,2,1,0,0,0,1
1719,samsungapps.com,legit,3.1899,4,10,15,0,0.4,0.21266,3,1,0,0,4,2,0,0,0,2
3833,one-mobile-prod.aws.oath.cloud,legit,4.02807,11,14,30,0,0.78571,0.13427,8,3,2,1,14,4,2,0,0,6
1858,connatix.com,legit,3.08496,4,7,12,0,0.57143,0.25708,4,1,0,0,5,4,2,0,0,6
9486,xdngsgn.org,dga,2.84535,1,9,11,1,0.11111,0.25867,1,0,0,0,1,1,0,0,0,1
8812,uagduqqwxowcsfitr.in,dga,3.92193,6,13,20,1,0.46154,0.1961,0,0,0,0,0,1,0,0,0,1
8112,fksmtnububaqnrco.eu,dga,3.78714,6,12,19,1,0.5,0.19932,1,0,0,0,1,1,0,0,0,1
4007,localytics.com,legit,3.18201,4,9,14,0,0.44444,0.22729,3,0,0,0,3,3,0,0,0,3
2616,beyondtrustcloud.com,legit,3.68418,6,13,20,0,0.46154,0.18421,5,3,2,1,11,4,0,0,0,4
3992,img.connatix.com,legit,3.25,5,9,16,0,0.55556,0.20312,5,2,0,0,7,4,3,0,0,7
64,v10.events.data.microsoft.com,legit,3.8404,8,15,29,0,0.53333,0.13243,12,9,7,6,34,7,1,0,0,8
2319,att.net,legit,2.12809,2,4,7,0,0.5,0.30401,1,0,0,0,1,1,0,0,0,1
7142,ivmxxvdvakpugeek.eu,dga,3.43162,7,11,19,1,0.63636,0.18061,1,0,0,0,1,1,0,0,0,1
1711,ak.privatelink.msidentity.com,legit,3.90937,9,17,29,0,0.52941,0.13481,9,2,0,0,11,10,2,0,0,12
8058,populumomregni.com,dga,3.41938,7,10,18,1,0.7,0.18997,1,0,0,0,1,3,0,0,0,3
2665,onedscolprdwus10.westus.cloudapp.azure.com,legit,3.98709,13,23,42,0,0.56522,0.09493,17,4,3,4,28,7,2,0,0,9
5114,lfenxnkmagobodkt.eu,dga,3.82687,6,12,19,1,0.5,0.20141,2,0,0,0,2,2,0,0,0,2
2388,conviva.com,legit,2.91398,4,6,11,0,0.66667,0.26491,2,1,0,0,3,2,1,0,0,3
3336,pull-flv-l1-va01.tiktokcdn.com,legit,4.01506,5,17,30,0,0.29412,0.13384,4,6,9,9,28,2,0,0,0,2
7277,iplhvgnqcnbyhwxsdn.com,dga,4.06148,2,19,22,1,0.10526,0.18461,2,0,0,0,2,1,0,0,0,1
8312,bafodkkfkbaokcfc.co.uk,dga,3.0106,6,14,22,1,0.42857,0.13685,2,1,0,0,3,1,1,0,0,2
6510,dgtluzyrhbthnpgv.com,dga,4.02193,2,17,20,1,0.11765,0.2011,0,0,0,0,0,0,0,0,0,0
626,e2ro.com,legit,2.75,3,3,8,0,1.0,0.34375,1,0,0,0,1,0,0,0,0,0
6270,eolbfddankaafcdb.de,dga,3.26083,6,12,19,1,0.5,0.17162,1,0,0,0,1,2,0,0,0,2
9656,akircfvmqfxvmkm.org,dga,3.57662,3,15,19,1,0.2,0.18824,0,0,0,0,0,0,0,0,0,0
6861,feebxggz.mooo.com,dga,3.14629,6,9,17,1,0.66667,0.18508,2,0,0,0,2,0,1,2,1,4
6014,owcivkjqjhpfhhobk.com,dga,3.65376,4,16,21,1,0.25,0.17399,0,0,0,0,0,0,0,0,0,0
4556,dp-sync.dotomi.com,legit,3.46132,4,11,18,0,0.36364,0.1923,2,0,0,0,2,3,0,0,0,3
1073,pub.3gppnetwork.org,legit,3.57662,4,12,19,0,0.33333,0.18824,1,0,0,0,1,3,0,0,0,3
3354,rootg2.amazontrust.com,legit,3.51603,7,12,22,0,0.58333,0.15982,9,1,3,3,16,4,0,0,0,4
6155,artdhprdei.com,dga,3.52164,4,9,14,1,0.44444,0.25155,1,0,0,0,1,2,0,0,0,2
5841,yurqmueoya.info,dga,3.50689,7,7,15,1,1.0,0.23379,0,0,0,0,0,0,0,1,0,1
233,ggpht.com,legit,2.9477,1,7,9,0,0.14286,0.32752,0,0,0,0,0,0,0,0,0,0
9675,siutepafapraal.ddns.net,dga,3.56704,8,13,23,1,0.61538,0.15509,6,1,0,0,7,7,3,2,1,13
4190,trackedevt.1rx.io,legit,3.61687,5,9,17,0,0.55556,0.21276,2,0,0,0,2,4,1,0,0,5
28,settings-win.data.microsoft.com,legit,3.82453,9,18,31,0,0.5,0.12337,12,8,7,6,33,9,1,0,0,10
8957,iwn40mvoxh54n30b58pxdsc49fqkua37htnvcs.biz,dga,4.6897,5,24,42,1,0.20833,0.11166,1,0,0,0,1,0,0,0,0,0
7945,sufferlisten.net,dga,3.20282,5,10,16,1,0.5,0.20018,5,0,0,0,5,6,1,0,0,7
2791,a47b.com,legit,3.0,2,3,8,0,0.66667,0.375,0,0,0,0,0,0,0,0,0,0
7629,exdawxgu.dynserv.com,dga,3.92193,5,13,20,1,0.38462,0.1961,3,1,1,0,5,4,5,5,4,18
6139,uqlbatsikdawmc.com,dga,3.83659,5,12,18,1,0.41667,0.21314,1,0,0,0,1,2,0,0,0,2
479,crashlytics.com,legit,3.45656,3,11,15,0,0.27273,0.23044,4,0,0,0,4,4,0,0,0,4
7551,axonvonbhmwgjjgjajoc.com,dga,3.50163,6,17,24,1,0.35294,0.1459,1,0,0,0,1,1,0,0,0,1
7192,roomsexecute.mx,dga,3.1899,6,8,15,1,0.75,0.21266,4,0,0,0,4,4,0,0,0,4
7077,nuosxeudbiu.ddns.net,dga,3.30869,7,11,20,1,0.63636,0.16543,2,1,0,0,3,4,3,3,2,12
6944,ylrukzxmrgbeylirsoxrtlr.ru,dga,3.69026,5,20,26,1,0.25,0.14193,1,0,0,0,1,1,0,0,0,1
7679,fnbvvcenrv.com,dga,3.18201,2,11,14,1,0.18182,0.22729,2,0,0,0,2,2,0,0,0,2
9956,vqczfnxsbx.com,dga,3.52164,1,12,14,1,0.08333,0.25155,0,0,0,0,0,0,0,0,0,0
7,netflix.com,legit,3.45943,3,7,11,0,0.42857,0.31449,1,0,0,0,1,2,0,0,0,2
2321,tm.ak.prd.aadg.akadns.net,legit,3.28489,6,14,25,0,0.42857,0.1314,5,4,4,3,16,2,1,0,0,3
9834,erbwpuvstuui.online,dga,3.68188,8,10,19,1,0.8,0.19378,2,0,0,0,2,2,0,0,0,2
7838,fxijcbycli.com,dga,3.32486,3,10,14,1,0.3,0.23749,1,0,0,0,1,0,0,0,0,0
2496,sdk.sharethrough.com,legit,3.68418,5,13,20,0,0.38462,0.18421,3,0,0,0,3,3,0,0,0,3
3472,gcc.loki.delve.office.com,legit,3.38347,8,13,25,0,0.61538,0.13534,6,4,4,3,17,6,1,0,0,7
5203,ekmans.yi.org,dga,3.54659,4,7,13,1,0.57143,0.27281,2,0,0,0,2,3,1,0,0,4
1220,cdn.fastclick.net,legit,3.45482,3,12,17,0,0.25,0.20322,5,3,1,0,9,4,0,0,0,4
5892,ixptusdsholapet.com,dga,3.82687,6,12,19,1,0.5,0.20141,3,0,0,0,3,2,0,5,5,12
1551,bytefcdn-oversea.com,legit,3.88418,6,12,20,0,0.5,0.19421,6,1,0,0,7,6,3,0,0,9
5415,kjnlnpgmjdgiwpeh.eu,dga,3.72161,4,14,19,1,0.28571,0.19587,0,0,0,0,0,0,0,0,0,0
5782,eveningorderly.net,dga,3.35021,6,11,18,1,0.54545,0.18612,3,0,0,0,3,7,1,0,0,8
8745,campaigncostdisappointed.com,dga,3.60113,10,17,28,1,0.58824,0.12861,9,1,0,0,10,8,0,1,0,9
5178,ysjvzspmltnxzmo.net,dga,3.72161,2,16,19,1,0.125,0.19587,0,0,0,0,0,0,0,0,0,0
7334,tkaivcbahufemfaujfbqkrdlbijvvc.com,dga,4.0941,9,24,34,1,0.375,0.12041,0,0,0,0,0,1,0,0,0,1
8069,reminderjason.tk,dga,3.625,5,10,16,1,0.5,0.22656,5,0,0,0,5,9,0,0,0,9
9187,papacasredimuntquamquil.com,dga,3.81008,11,15,27,1,0.73333,0.14111,5,0,0,0,5,6,0,0,0,6
6284,qmbmbyqkltqfbbtxxc.com,dga,3.39081,1,20,22,1,0.05,0.15413,0,0,0,0,0,0,0,0,0,0
5792,qkoomgiccieqyqmw.org,dga,3.44644,6,13,20,1,0.46154,0.17232,2,0,0,0,2,2,0,0,0,2
1628,z.akamai.net,legit,3.02206,5,5,12,0,1.0,0.25184,3,3,4,3,13,2,0,0,0,2
5399,t2euiefmpmtfcl3efs.net,dga,3.57262,6,13,22,1,0.46154,0.16239,0,0,0,0,0,0,0,0,0,0
2139,pdst.fm,legit,2.80735,0,6,7,0,0.0,0.40105,2,0,0,0,2,1,0,0,0,1
5879,nbjjjfhqdstevjl.ru,dga,3.72548,2,15,18,1,0.13333,0.20697,3,0,0,0,3,2,0,0,0,2
4471,apple.com.akamaized.net,legit,3.58835,9,11,23,0,0.81818,0.15602,11,9,9,9,38,6,2,1,0,9
922,portal.fb.com,legit,3.39275,3,8,13,0,0.375,0.26098,1,0,0,0,1,2,0,0,0,2
5508,kycqgawq4y4y.net,dga,3.45282,2,11,16,1,0.18182,0.2158,0,0,0,0,0,0,0,0,0,0
7515,frqbbmhysvynxeln.eu,dga,3.82687,3,15,19,1,0.2,0.20141,0,0,0,0,0,1,0,0,0,1
146,apis.google.com,legit,3.32323,6,7,15,0,0.85714,0.22155,5,6,4,3,18,2,0,0,0,2
7944,sicuoq8egegy.net,dga,3.57782,6,8,16,1,0.75,0.22361,2,0,0,0,2,3,0,0,0,3
4995,rtb.adgrx.com,legit,3.39275,2,9,13,0,0.22222,0.26098,2,0,0,0,2,0,0,0,0,0
9541,oeqpkyhmtjfphaphciej.com,dga,3.77206,6,17,24,1,0.35294,0.15717,1,0,0,0,1,0,0,0,0,0
4538,nativesdks.mparticle.com,legit,3.9183,7,15,24,0,0.46667,0.16326,7,0,0,0,7,7,1,0,0,8
1642,tm.ak.prd.aadg.trafficmanager.net,legit,3.57078,9,19,33,0,0.47368,0.10821,10,5,1,3,19,6,1,0,0,7
598,srv.stackadapt.com,legit,3.46132,4,12,18,0,0.33333,0.1923,4,0,0,0,4,3,0,0,0,3
5333,lordraise.net,dga,3.39275,5,7,13,1,0.71429,0.26098,3,0,0,0,3,4,0,0,0,4
4512,hde.tynt.com,legit,3.25163,2,8,12,0,0.25,0.27097,3,0,0,0,3,1,0,0,0,1
5463,eafpglayxc.com,dga,3.52164,4,9,14,1,0.44444,0.25155,1,0,0,0,1,2,0,0,0,2
3706,krushmedia.com,legit,3.6645,5,8,14,0,0.625,0.26175,2,0,0,0,2,1,0,0,0,1
4181,tag.tapad.com,legit,3.02699,4,7,13,0,0.57143,0.23285,4,0,0,0,4,1,0,0,0,1
6477,nenlodfcdoaadkmb.de,dga,3.40582,6,12,19,1,0.5,0.17925,4,0,0,0,4,2,0,0,0,2
9875,occasioneveniarumomnibus.com,dga,3.55666,13,14,28,1,0.92857,0.12702,3,0,0,0,3,10,2,0,0,12
2946,pixel.onaudience.com,legit,3.58418,9,9,20,0,1.0,0.17921,4,0,0,0,4,4,1,1,0,6
3588,d.akamai.net,legit,3.02206,5,5,12,0,1.0,0.25184,4,3,4,3,14,2,0,0,0,2
4794,traps.paloaltonetworks.com,legit,3.64237,8,16,26,0,0.5,0.14009,5,0,0,0,5,5,2,0,0,7
1144,exchange.mediavine.com,legit,3.55034,9,11,22,0,0.81818,0.16138,5,0,0,0,5,5,2,0,0,7
3017,prod.dcat.dsp.trafficmanager.net,legit,3.74173,8,20,32,0,0.4,0.11693,13,6,3,4,26,9,2,0,0,11
6442,tunicyqokuv.eu,dga,3.46772,6,7,14,1,0.85714,0.24769,1,0,0,0,1,2,0,0,0,2
1971,sync.richaudience.com,legit,3.63041,7,12,21,0,0.58333,0.17288,3,0,0,0,3,4,2,1,0,7
7733,hxhgttbapk.com,dga,3.52164,2,11,14,1,0.18182,0.25155,1,0,0,0,1,0,0,0,0,0
9729,wgm2dn82jefkfbad13.biz,dga,4.0958,3,13,22,1,0.23077,0.18617,2,0,0,0,2,1,0,0,0,1
4584,vip.prod.criteo.net,legit,3.36609,6,10,19,0,0.6,0.17716,7,4,3,2,16,3,1,0,0,4
6494,ugadxypoqyuukxopp.mx,dga,3.40869,6,13,20,1,0.46154,0.17043,2,0,0,0,2,0,0,0,0,0
8758,gkzjist1zwig8jdxol.com,dga,4.00489,4,15,22,1,0.26667,0.18204,1,0,0,0,1,2,1,0,0,3
807,data.pendo.io,legit,3.08506,6,5,13,0,1.2,0.23731,3,0,0,0,3,4,0,0,0,4
4051,wildcard.weather.microsoft.com.edgekey.net,legit,3.99008,13,24,42,0,0.54167,0.095,14,13,10,7,44,11,3,2,1,17
3841,ocsp.apple.com,legit,3.03915,4,8,14,0,0.5,0.21708,6,4,3,2,15,1,0,0,0,1
2900,justpremium.com,legit,3.45656,5,9,15,0,0.55556,0.23044,5,0,0,0,5,4,0,0,0,4
1006,pull-hls-f77-sg01.tiktokcdn.com,legit,4.19582,4,18,31,0,0.22222,0.13535,4,6,9,9,28,2,0,0,0,2
7368,7lo0w0gtwxqvudi.ddns.net,dga,3.97018,4,15,24,1,0.26667,0.16542,3,1,0,0,4,4,4,3,2,13
5881,bnmfladdaccalkff.com,dga,3.30869,4,15,20,1,0.26667,0.16543,1,0,0,0,1,4,0,0,0,4
7581,animarumsunt.com,dga,3.32782,6,9,16,1,0.66667,0.20799,2,0,0,0,2,5,0,0,0,5
8986,hhojxqndkexk.com,dga,3.5,3,12,16,1,0.25,0.21875,0,0,0,0,0,1,0,0,0,1
417,id5-sync.com,legit,3.4183,2,7,12,0,0.28571,0.28486,0,0,0,0,0,0,0,0,0,0
7909,sxnjcvbkiz.com,dga,3.6645,2,11,14,1,0.18182,0.26175,0,0,0,0,0,0,0,0,0,0
1566,media0.giphy.com,legit,3.625,5,8,16,0,0.625,0.22656,1,0,0,0,1,1,0,0,0,1
9450,sourcebalancestringreference.com,dga,3.67923,12,19,32,1,0.63158,0.11498,8,0,0,0,8,10,5,2,0,17
9437,ky4kvctlhvn4md8un6.net,dga,3.87966,2,15,22,1,0.13333,0.17635,0,0,0,0,0,0,0,0,0,0
2680,h.online-metrix.net,legit,3.43162,6,10,19,0,0.6,0.18061,3,0,0,0,3,5,1,0,0,6
7250,canonicascistampercra.com,dga,3.37947,9,15,25,1,0.6,0.13518,8,0,0,0,8,12,1,0,0,13
5364,seogirug.ru,dga,2.91398,5,5,11,1,1.0,0.26491,1,0,0,0,1,1,0,0,0,1
4798,pagead-googlehosted.l.google.com,legit,3.48034,12,16,32,0,0.75,0.10876,9,6,4,3,22,6,0,0,0,6
906,dscb.akamaiedge.net,legit,3.53689,7,10,19,0,0.7,0.18615,6,5,5,3,19,4,0,0,0,4
3960,meeting-container-a.wbx2.com,legit,3.89629,9,14,28,0,0.64286,0.13915,7,1,0,0,8,8,3,0,0,11
2817,libs.outbrain.com,legit,3.61687,6,9,17,0,0.66667,0.21276,5,0,0,0,5,2,0,0,0,2
3587,collector.brandmetrics.com,legit,3.64237,7,17,26,0,0.41176,0.14009,4,0,0,0,4,10,1,0,0,11
1909,clo.footprintdns.com,legit,3.52193,5,13,20,0,0.38462,0.1761,6,2,0,0,8,4,2,0,0,6
6333,ecsrlkxwug.com,dga,3.6645,3,10,14,1,0.3,0.26175,0,0,0,0,0,1,0,0,0,1
8038,okrgujmfnvbf.com,dga,3.625,3,12,16,1,0.25,0.22656,0,0,0,0,0,0,0,0,0,0
445,us-u.openx.net,legit,3.23593,5,6,14,0,0.83333,0.23114,2,0,0,0,2,1,0,0,0,1
2827,init.gc.apple.com,legit,3.45482,5,9,17,0,0.55556,0.20322,6,4,3,2,15,4,0,0,0,4
8606,gfi6elgh1r1to0u.ddns.net,dga,4.00163,5,13,24,1,0.38462,0.16673,2,1,0,0,3,5,3,3,2,13
2310,ak.prd.aadg.akadns.net,legit,3.17013,6,12,22,0,0.5,0.1441,5,4,4,3,16,2,1,0,0,3
9194,sumuwgaheds.com,dga,3.50689,5,9,15,1,0.55556,0.23379,2,0,0,0,2,2,0,0,0,2
2725,ipv6.adrta.com,legit,3.52164,4,7,14,0,0.57143,0.25155,3,0,0,0,3,1,0,0,0,1
3116,ecs.office.trafficmanager.net,legit,3.53851,10,16,29,0,0.625,0.12202,10,5,4,6,25,8,1,0,0,9
5702,hapadis.info,dga,3.25163,5,6,12,1,0.83333,0.27097,2,0,0,0,2,1,0,0,0,1
6643,notefixblackboardquestion.com,dga,4.09936,11,17,29,1,0.64706,0.14136,5,0,0,0,5,8,3,1,0,12
3100,lpcdn.lpsnmedia.net,legit,3.47135,4,13,19,0,0.30769,0.1827,3,2,1,0,6,2,0,0,0,2
451,nel.cloudflare.com,legit,3.46132,6,10,18,0,0.6,0.1923,4,3,3,2,12,5,0,0,0,5
2713,fef.msua01.manage.microsoft.com,legit,3.78437,10,15,31,0,0.66667,0.12208,9,9,7,8,33,6,0,0,0,6
9441,waewciqi.ddns.net,dga,3.38158,5,10,17,1,0.5,0.19892,2,1,0,0,3,4,4,3,2,13
1701,thor.aesir.office.com,legit,3.46328,8,10,21,0,0.8,0.16492,5,4,4,3,16,5,0,0,0,5
4795,us2.endpoint.ingress.rapid7.com,legit,3.9134,9,16,31,0,0.5625,0.12624,10,1,0,0,11,6,3,0,0,9
9508,34densduvoxa.net,dga,3.625,5,8,16,1,0.625,0.22656,1,0,0,0,1,3,0,0,0,3
3850,apnx-match.dotomi.com,legit,3.55852,6,12,21,0,0.5,0.16945,5,0,0,0,5,5,0,0,0,5
5187,ecuhiboieaeovw.biz,dga,3.41938,10,7,18,1,1.42857,0.18997,1,0,0,0,1,2,0,0,0,2
9047,ceuqausaimcqwkma.org,dga,3.68418,8,11,20,1,0.72727,0.18421,3,0,0,0,3,2,0,0,0,2
5897,wnodslwjif7fah5j50u.ddns.net,dga,4.03915,5,17,28,1,0.29412,0.14426,3,1,0,0,4,4,3,3,2,12
834,storecatalogrevocation.storequality.microsoft.com,legit,3.84881,19,27,49,0,0.7037,0.07855,14,8,7,6,35,12,3,2,1,18
8391,lxskwfendifqvuya.eu,dga,3.93214,6,12,19,1,0.5,0.20695,1,0,0,0,1,2,0,0,0,2
9402,zkoal.us,dga,3.0,3,4,8,1,0.75,0.375,0,0,0,0,0,0,0,0,0,0
9632,sizatib.info,dga,3.18872,5,6,12,1,0.83333,0.26573,2,0,0,0,2,3,1,0,0,4
8527,wirelicence.net,dga,2.97356,6,8,15,1,0.75,0.19824,5,1,0,0,6,5,1,1,0,7
7272,dfekamondmodobam.com,dga,3.18418,7,12,20,1,0.58333,0.15921,2,0,0,0,2,3,0,0,0,3
4839,tripadvisor.com,legit,3.50689,5,9,15,0,0.55556,0.23379,1,0,0,0,1,3,0,0,0,3
7005,ofddmemoddfabfkd.com,dga,3.02821,5,14,20,1,0.35714,0.15141,1,0,0,0,1,2,0,0,0,2
5801,yauusoskycmaemuw.org,dga,3.58418,8,11,20,1,0.72727,0.17921,2,0,0,0,2,2,0,0,0,2
1680,aa.online-metrix.net,legit,3.44644,8,9,20,0,0.88889,0.17232,3,0,0,0,3,5,1,0,0,6
2621,c1-excel-15.cdn.office.net,legit,3.59448,6,12,26,0,0.5,0.13825,6,6,5,3,20,4,0,0,0,4
7918,retirementmunich.sg,dga,3.47135,6,12,19,1,0.5,0.1827,5,1,0,0,6,7,1,0,0,8
897,csync.loopme.me,legit,3.24022,4,9,15,0,0.44444,0.21601,2,0,0,0,2,0,0,0,0,0
8932,owpgqgeoya.net,dga,3.37878,5,8,14,1,0.625,0.24134,1,0,0,0,1,1,0,1,0,2
411,tiktokv.com,legit,2.91398,3,7,11,0,0.42857,0.26491,1,4,3,2,10,1,0,0,0,1
449,ssl.google-analytics.com,legit,3.65727,7,14,24,0,0.5,0.15239,4,5,4,3,16,4,0,0,0,4
2952,a.ad.gt,legit,2.23593,2,3,7,0,0.66667,0.31942,2,0,0,0,2,0,0,0,0,0
3304,pubmatic-match.dotomi.com,legit,3.51327,8,14,25,0,0.57143,0.14053,6,0,0,0,6,7,1,0,0,8
5126,qeqohi.info,dga,2.91398,5,5,11,1,1.0,0.26491,0,0,0,0,0,0,0,0,0,0
214,c10r.facebook.com,legit,3.41042,5,8,17,0,0.625,0.20061,2,0,0,0,2,2,0,0,0,2
7190,hafodah.info,dga,2.9183,5,6,12,1,0.83333,0.24319,0,0,0,0,0,0,0,0,0,0
684,lb-apple.com.akadns.net,legit,3.76227,6,13,23,0,0.46154,0.16358,10,9,9,9,37,5,3,1,0,9
6102,dyxvompykmtmpoxtm.com,dga,3.2321,3,17,21,1,0.17647,0.15391,0,0,0,0,0,1,0,0,0,1
8237,qnwddakdgimifkbie.cc,dga,3.64644,5,14,20,1,0.35714,0.18232,1,0,0,0,1,2,0,0,0,2
5671,gpejvsdsholapet.org,dga,3.72161,5,13,19,1,0.38462,0.19587,2,0,0,0,2,2,0,5,5,12
49,googleads.g.doubleclick.net,legit,3.7262,9,15,27,0,0.6,0.13801,10,4,3,3,20,5,0,0,0,5
6326,mckiukqqgmsgaogg.org,dga,3.34145,5,14,20,1,0.35714,0.16707,0,0,0,0,0,0,0,0,0,0
9044,eaekjdtoutmwtpetn.pw,dga,3.48418,6,13,20,1,0.46154,0.17421,2,0,0,0,2,2,0,0,0,2
5239,sofrlwbecnv.tv,dga,3.6645,2,11,14,1,0.18182,0.26175,1,1,0,0,2,2,0,0,0,2
8496,dumpxijhsxliqclx.eu,dga,3.68188,5,13,19,1,0.38462,0.19378,1,0,0,0,1,0,0,0,0,0
2969,e-volution.ai,legit,3.39275,7,4,13,0,1.75,0.26098,2,0,0,0,2,2,2,1,0,5
6735,461knj4xlor64ht7hn.ru,dga,3.78494,2,11,21,1,0.18182,0.18024,1,0,0,0,1,1,0,0,0,1
3986,prdv4a.aadg.msidentity.com,legit,3.92103,7,15,26,0,0.46667,0.15081,7,1,0,0,8,5,1,0,0,6
8364,qrvcd7g2x72b34bbfd.ru,dga,3.78494,1,13,21,1,0.07692,0.18024,1,0,0,0,1,0,0,0,0,0
2194,sync-criteo.ads.yieldmo.com,legit,3.78212,8,15,27,0,0.53333,0.14008,6,0,0,0,6,4,0,0,0,4
9621,gadyros.com,dga,3.27761,3,7,11,1,0.42857,0.29796,2,1,0,0,3,0,0,0,0,0
1967,script.crazyegg.com,legit,3.68188,4,13,19,0,0.30769,0.19378,3,0,0,0,3,2,0,0,0,2
2177,tealiumiq.com,legit,3.39275,6,6,13,0,1.0,0.26098,4,0,0,0,4,3,0,0,0,3
752,clarity.ms,legit,3.32193,2,7,10,0,0.28571,0.33219,0,0,0,0,0,4,0,0,0,4
5807,catherinamasterson.net,dga,3.41309,8,13,22,1,0.61538,0.15514,8,2,0,0,10,11,5,1,1,18
3078,southcentralus1-mediap.svc.ms,legit,4.09936,8,17,29,0,0.47059,0.14136,9,1,0,0,10,4,2,0,0,6
2149,c.bytetcdn.com,legit,3.18201,2,10,14,0,0.2,0.22729,3,1,0,0,4,3,0,0,0,3
7898,trgfjqbchpjs.co.uk,dga,3.83659,2,14,18,1,0.14286,0.21314,3,1,0,0,4,1,1,0,0,2
2701,csm.us.criteo.net,legit,3.33718,5,9,17,0,0.55556,0.1963,5,0,0,0,5,3,0,0,0,3
1454,rqtrk.eu,legit,2.75,2,5,8,0,0.4,0.34375,0,0,0,0,0,0,0,0,0,0
4791,authsvc.teams.microsoft.com,legit,3.62417,8,16,27,0,0.5,0.13423,11,8,7,6,32,5,0,0,0,5
9687,gwyeelr.cx,dga,3.12193,2,7,10,1,0.28571,0.31219,0,0,0,0,0,1,0,0,0,1
9239,iqqickcugacskoaq.org,dga,3.34644,7,12,20,1,0.58333,0.16732,1,0,0,0,1,2,0,0,0,2
6700,ihomineegenumplen.com,dga,3.36804,9,11,21,1,0.81818,0.16038,6,1,0,0,7,7,1,0,0,8
6165,enxnjrmdjkncuyuax.cc,dga,3.54644,4,15,20,1,0.26667,0.17732,1,0,0,0,1,1,0,0,0,1
6420,usu0icucegis.top,dga,3.32782,7,7,16,1,1.0,0.20799,3,0,0,0,3,4,0,0,0,4
3561,msua05.manage.microsoft.com,legit,3.78212,9,13,27,0,0.69231,0.14008,9,9,7,8,33,6,0,0,0,6
7330,jtnzdznrg.com,dga,3.39275,1,11,13,1,0.09091,0.26098,0,0,0,0,0,0,0,0,0,0
990,pull-cmaf-f16-tt01.tiktokcdn.com,legit,4.01532,5,18,32,0,0.27778,0.12548,5,6,9,9,29,3,0,0,0,3
2643,mug.criteo.com,legit,3.23593,5,7,14,0,0.71429,0.23114,3,0,0,0,3,3,0,0,0,3
9474,instruction-towel.com,dga,3.65376,7,12,21,1,0.58333,0.17399,4,0,0,0,4,6,2,1,1,10
8324,ayuigueoya.info,dga,3.24022,9,5,15,1,1.8,0.21601,0,0,0,0,0,0,0,1,0,1
1923,array604.prod.do.dsp.mp.microsoft.com,legit,3.71259,8,20,37,0,0.4,0.10034,12,12,10,9,43,5,2,0,0,7
957,userlocation.googleapis.com,legit,3.73231,12,13,27,0,0.92308,0.13823,12,7,4,4,27,9,4,2,1,16
3817,history.l.google.com,legit,3.48418,6,11,20,0,0.54545,0.17421,3,5,4,3,15,4,1,0,0,5
8061,kui4z1jv5qrsrv1nff.net,dga,4.00489,3,14,22,1,0.21429,0.18204,0,0,0,0,0,0,0,0,0,0
1585,media2.giphy.com,legit,3.625,5,8,16,0,0.625,0.22656,1,0,0,0,1,1,0,0,0,1
657,api2.branch.io,legit,3.37878,5,6,14,0,0.83333,0.24134,3,1,0,0,4,2,0,0,0,2
6041,okcakwiq.net,dga,3.4183,4,7,12,1,0.57143,0.28486,0,0,0,0,0,1,0,0,0,1
2746,us-central1-gcp.api.sc-gw.com,legit,3.97833,6,16,29,0,0.375,0.13718,9,3,1,0,13,3,2,0,0,5
4974,secure.espncdn.com,legit,3.30827,5,11,18,0,0.45455,0.18379,6,1,0,0,7,5,0,0,0,5
6551,kkciwortrh.dynserv.com,dga,3.87966,4,16,22,1,0.25,0.17635,3,1,1,0,5,5,5,5,4,19
4207,pcms.apple.com,legit,3.03915,3,9,14,0,0.33333,0.21708,6,4,3,2,15,1,0,0,0,1
7606,dlrqvb.mooo.com,dga,3.10689,4,9,15,1,0.44444,0.20713,2,0,0,0,2,0,1,2,1,4
2734,theweathernetwork.com,legit,3.40399,7,13,21,0,0.53846,0.16209,3,0,0,0,3,6,1,1,1,9
2886,a1857.z.akamai.net,legit,3.46132,6,5,18,0,1.2,0.1923,3,3,4,3,13,2,0,0,0,2
5851,txxxigsccpuv.biz,dga,3.45282,3,12,16,1,0.25,0.2158,0,0,0,0,0,0,0,0,0,0
1756,oauth.online.office.com,legit,3.53422,10,10,23,0,1.0,0.15366,7,4,4,3,18,5,1,0,0,6
3705,api.cylance.com,legit,3.32323,5,8,15,0,0.625,0.22155,4,1,1,0,6,3,1,1,0,5
5499,uiupvqwydolcduxm.eu,dga,3.72161,7,11,19,1,0.63636,0.19587,1,0,0,0,1,0,0,0,0,0
1021,us.api.endpoint.ingress.rapid7.com,legit,3.79704,11,17,34,0,0.64706,0.11168,11,2,1,0,14,6,3,0,0,9
4253,public.wlhrm-a-2.prod.infra.webex.com,legit,4.17257,9,20,37,0,0.45,0.11277,7,4,3,2,16,4,2,0,0,6
1031,ps.eyeota.net,legit,3.02699,5,6,13,0,0.83333,0.23285,2,0,0,0,2,1,0,0,0,1
6355,knowhelp.net,dga,3.25163,3,8,12,1,0.375,0.27097,0,0,0,0,0,1,0,0,0,1
3584,l-0007.l-msedge.net,legit,3.43162,3,8,19,0,0.375,0.18061,3,2,1,0,6,3,0,0,0,3
9684,ywgmyeosaekuccoo.org,dga,3.52193,8,11,20,1,0.72727,0.1761,2,0,0,0,2,1,0,0,0,1
4868,wamsm-a-1.prod.infra.webex.com,legit,3.9899,8,15,30,0,0.53333,0.133,6,4,3,2,15,4,2,0,0,6
4714,dsct.akamai.net,legit,3.32323,5,8,15,0,0.625,0.22155,4,3,4,3,14,2,0,0,0,2
670,static.ads-twitter.com,legit,3.47718,6,13,22,0,0.46154,0.15805,10,0,0,0,10,8,2,0,0,10
3612,mweb.ck.inmobi.com,legit,3.19716,5,10,18,0,0.5,0.17762,2,0,0,0,2,1,0,0,0,1
2127,azure-devices.net,legit,3.61687,7,8,17,0,0.875,0.21276,4,1,0,1,6,5,0,0,0,5
5224,mnjydtgeyxwcitofonhxtwl.biz,dga,4.13434,5,21,27,1,0.2381,0.15312,3,0,0,0,3,3,0,0,0,3
6060,skaakrmgxwbhrdvu.eu,dga,3.82687,5,13,19,1,0.38462,0.20141,0,0,0,0,0,0,0,0,0,0
8927,rbihiytidxpkiyi.co.uk,dga,3.55376,7,12,21,1,0.58333,0.16923,3,1,0,0,4,2,1,0,0,3
6772,jepemadodiv.eu,dga,3.32486,7,6,14,1,1.16667,0.23749,2,0,0,0,2,2,0,0,0,2
2797,smilewanted.com,legit,3.64022,5,9,15,0,0.55556,0.24268,5,0,0,0,5,5,0,0,0,5
258,exo.nel.measure.office.net,legit,3.56545,11,11,26,0,1.0,0.13713,7,4,4,3,18,8,0,0,0,8
2774,ssl.p.jwpcdn.com,legit,3.32782,1,12,16,0,0.08333,0.20799,3,1,0,0,4,1,0,0,0,1
3425,qq.opendns.com,legit,3.23593,3,9,14,0,0.33333,0.23114,2,1,0,0,3,4,1,1,0,6
7084,ca06sugawq0y.org,dga,3.625,4,8,16,1,0.5,0.22656,0,0,0,0,0,2,0,0,0,2
3890,yieldoptimizer.com,legit,3.57243,7,10,18,0,0.7,0.19847,3,0,0,0,3,4,0,0,0,4
2092,config.teams.trafficmanager.net,legit,3.60663,10,18,31,0,0.55556,0.11634,12,4,1,3,20,11,2,0,0,13
8317,akozcem.co.kr,dga,3.08506,4,7,13,1,0.57143,0.23731,3,1,0,0,4,3,1,0,0,4
2564,di.atlas.samsung.com,legit,3.50869,6,11,20,0,0.54545,0.17543,4,0,0,0,4,5,0,0,0,5
9799,hwubcluq.cc,dga,2.84535,2,8,11,1,0.25,0.25867,0,0,0,0,0,0,0,0,0,0
3050,t-mobile.com,legit,3.25163,4,6,12,0,0.66667,0.27097,1,0,0,0,1,1,0,0,0,1
4216,android-safebrowsing.google.com,legit,3.91018,11,17,31,0,0.64706,0.12613,4,5,4,3,16,5,2,0,0,7
4048,foxnews.com,legit,3.27761,3,7,11,0,0.42857,0.29796,0,0,0,0,0,1,0,0,0,1
2799,pix.pub,legit,2.52164,2,4,7,0,0.5,0.36023,1,0,0,0,1,0,0,0,0,0
9599,increaseeearly.net,dga,3.19161,8,9,18,1,0.88889,0.17731,5,0,0,0,5,6,0,0,0,6
6593,breadgoodbye.net,dga,3.32782,6,9,16,1,0.66667,0.20799,4,1,0,0,5,2,0,0,0,2
1735,ip.goguardian.com,legit,3.49923,7,8,17,0,0.875,0.20584,1,1,0,0,2,2,0,0,0,2
7431,sgkaxjnjih.com,dga,3.6645,3,10,14,1,0.3,0.26175,0,0,0,0,0,0,0,0,0,0
3901,glb.cws.prod.dcat.dsp.trafficmanager.net,legit,3.95869,8,26,40,0,0.30769,0.09897,15,7,4,5,31,9,2,0,0,11
731,wbx2.com,legit,3.0,1,5,8,0,0.2,0.375,0,0,0,0,0,0,0,0,0,0
8103,demyoaoqpnutxhyq.eu,dga,3.72161,7,11,19,1,0.63636,0.19587,0,0,0,0,0,2,0,0,0,2
4884,public.wamsm-a-2.prod.infra.webex.com,legit,4.15217,10,19,37,0,0.52632,0.11222,8,4,3,2,17,5,2,0,0,7
3745,yql.yahoo.com,legit,3.02699,4,7,13,0,0.57143,0.23285,1,0,0,1,2,0,0,0,0,0
195,mesu.apple.com,legit,3.23593,5,7,14,0,0.71429,0.23114,6,4,3,2,15,3,0,0,0,3
9487,lwcyod.net,dga,3.32193,2,7,10,1,0.28571,0.33219,0,0,0,0,0,0,0,0,0,0
237,addons-pa.clients6.google.com,legit,3.86643,9,15,29,0,0.6,0.13333,8,6,4,3,21,5,1,0,0,6
7948,weak-quiz.vn,dga,3.58496,4,6,12,1,0.66667,0.29875,1,0,0,0,1,1,0,0,0,1
5047,dxhhsjmthbsh.info,dga,3.49923,2,14,17,1,0.14286,0.20584,0,0,0,0,0,0,0,0,0,0
5723,kemyjor.info,dga,3.4183,4,7,12,1,0.57143,0.28486,0,0,0,0,0,2,0,0,0,2
1451,video.twimg.com,legit,3.37356,5,8,15,0,0.625,0.2249,1,0,0,0,1,1,0,0,0,1
6631,amicamipsius.com,dga,3.03064,7,8,16,1,0.875,0.18942,4,1,0,0,5,5,0,0,0,5
1843,adnxs.net,legit,2.9477,2,6,9,0,0.33333,0.32752,2,0,0,0,2,1,0,0,0,1
9116,vxvmddsdnhulnp.net,dga,3.53049,2,15,18,1,0.13333,0.19614,2,0,0,0,2,2,0,0,0,2
535,match.prod.bidr.io,legit,3.46132,5,10,18,0,0.5,0.1923,5,4,3,2,14,2,1,0,0,3
2132,1543874144.rsc.cdn77.org,legit,3.60539,1,8,24,0,0.125,0.15022,3,1,0,0,4,1,0,0,0,1
5575,rrcrqyikatrcvcqg.eu,dga,3.47135,4,14,19,1,0.28571,0.1827,2,0,0,0,2,1,0,0,0,1
69,fe.apple-dns.net,legit,3.32782,4,9,16,0,0.44444,0.20799,7,5,3,2,17,3,1,0,0,4
7086,ingihuldot.com,dga,3.52164,5,8,14,1,0.625,0.25155,1,0,0,0,1,1,1,0,0,2
9084,ubofwjepayaqalxixg.com,dga,4.06148,8,13,22,1,0.61538,0.18461,1,0,0,0,1,0,0,0,0,0
6493,usjdwfalbdwp.com,dga,3.75,3,12,16,1,0.25,0.23438,1,0,0,0,1,0,0,0,0,0
6302,sizeexpectconsiderrentpark.com,dga,3.80291,10,19,30,1,0.52632,0.12676,6,2,0,0,8,10,2,0,0,12
1738,gecko16-platform-useast5.us.tiktokv.com,legit,4.20169,11,20,39,0,0.55,0.10774,10,6,4,3,23,10,0,0,0,10
6018,hdkomcghdsvgntkp.eu,dga,3.82687,3,15,19,1,0.2,0.20141,2,0,0,0,2,1,0,0,0,1
5799,peabeoba.ru,dga,2.91398,6,4,11,1,1.5,0.26491,1,0,0,0,1,2,0,0,0,2
6639,igfuykgurm.com,dga,3.37878,4,9,14,1,0.44444,0.24134,0,0,0,0,0,0,0,0,0,0
9491,okmoesexa.ddns.net,dga,3.35021,6,10,18,1,0.6,0.18612,4,1,0,0,5,6,4,3,2,15
9523,charlotteelisabeth.net,dga,3.45943,8,13,22,1,0.61538,0.15725,3,0,0,0,3,6,1,1,0,8
8013,ur74grwle0mdgt12ghahkr5.ddns.net,dga,4.24173,4,20,32,1,0.2,0.13255,3,1,0,0,4,5,3,2,2,12
6230,kjs2i0s41dytmbm.ddns.net,dga,3.85539,2,16,24,1,0.125,0.16064,2,1,0,0,3,4,3,2,2,11
4862,autodiscover.outlook.com,legit,3.60539,11,11,24,0,1.0,0.15022,5,0,0,0,5,4,2,0,0,6
1649,cxcs.cdn.office.net,legit,3.26083,4,12,19,0,0.33333,0.17162,7,6,5,3,21,3,0,0,0,3
8158,uhaciciffunoke.ddns.net,dga,3.70813,8,13,23,1,0.61538,0.16122,4,1,0,0,5,6,4,3,2,15
7866,emwerwiugkeq.info,dga,3.57247,7,9,17,1,0.77778,0.21015,1,0,0,0,1,2,0,3,2,7
8227,wvfuwufqbex.org,dga,3.50689,4,10,15,1,0.4,0.23379,0,0,0,0,0,1,3,2,2,8
9386,nvnzetl18a57awmukrbrnxnrewcxpsjtdy.ru,dga,4.4527,6,26,37,1,0.23077,0.12034,1,0,0,0,1,2,0,0,0,2
8468,ombiabokceogi.ddns.net,dga,3.69785,8,12,22,1,0.66667,0.16808,3,1,0,0,4,6,4,3,2,15
3090,api16-normal-c-useast1a.tiktokv.com,legit,4.09315,11,16,35,0,0.6875,0.11695,9,7,4,3,23,7,0,0,0,7
6788,gatef.eu,dga,2.75,4,3,8,1,1.33333,0.34375,2,0,0,0,2,2,1,0,0,3
9748,0mwa8y024as6.org,dga,3.75,3,6,16,1,0.5,0.23438,0,0,0,0,0,1,0,0,0,1
746,com.cdn.cloudflare.net,legit,3.57262,6,13,22,0,0.46154,0.16239,7,7,5,2,21,6,1,0,0,7
6948,upxfmjrtvmfgndqj.eu,dga,3.82687,3,15,19,1,0.2,0.20141,0,0,0,0,0,1,0,0,0,1
312,elb.amazonaws.com,legit,3.45482,6,9,17,0,0.66667,0.20322,4,1,3,3,11,4,0,0,0,4
1214,armmf.adobe.com,legit,3.1899,5,8,15,0,0.625,0.21266,2,0,0,0,2,2,0,0,0,2
4293,usersync.getpublica.com,legit,3.969,7,14,23,0,0.5,0.17257,6,1,0,0,7,6,2,0,0,8
360,trouter.teams.microsoft.com,legit,3.41175,9,15,27,0,0.6,0.12636,13,8,7,6,34,6,1,0,0,7
4607,discovery.cem.cloud.us,legit,3.57262,7,12,22,0,0.58333,0.16239,6,3,3,2,14,6,2,0,0,8
9842,hotilpbgmlp.com,dga,3.37356,3,11,15,1,0.27273,0.2249,1,0,0,0,1,1,0,0,0,1
9309,oggceagmucwowkcc.org,dga,3.18418,6,13,20,1,0.46154,0.15921,2,0,0,0,2,2,0,0,0,2
1839,prod.infra.webex.com,legit,3.78418,6,11,20,0,0.54545,0.18921,5,3,2,1,11,3,2,0,0,5
32,nrdp-ipv6.prod.ftl.netflix.com,legit,3.94839,5,19,30,0,0.26316,0.13161,4,4,3,2,13,2,1,0,0,3
829,lcdn-locator.apple.com,legit,3.53831,6,13,22,0,0.46154,0.16083,9,5,3,2,19,5,0,0,0,5
9439,24m0ac2g6ges.net,dga,3.625,3,7,16,1,0.42857,0.22656,2,0,0,0,2,3,0,0,0,3
7040,b15giopqxypq5dqa84.cn,dga,3.97542,3,12,21,1,0.25,0.18931,0,0,0,0,0,0,0,0,0,0
106,outlook.com,legit,2.73216,5,5,11,0,1.0,0.24838,3,0,0,0,3,0,0,0,0,0
1800,permutive.com,legit,3.39275,5,7,13,0,0.71429,0.26098,2,0,0,0,2,3,0,0,0,3
5115,xqcarmsfycij.com,dga,3.57782,3,12,16,1,0.25,0.22361,0,0,0,0,0,2,0,0,0,2
2714,clump.dprodmgd105.aa-rt.sharepoint.com,legit,4.18137,9,21,38,0,0.42857,0.11004,8,2,1,0,11,4,1,0,0,5
1966,w181.akamai.net,legit,3.32323,5,5,15,0,1.0,0.22155,3,3,4,3,13,2,0,0,0,2
6026,rutslgfpisbg.com,dga,3.75,3,12,16,1,0.25,0.23438,1,0,0,0,1,1,0,0,0,1
3272,canva.com,legit,2.72548,3,5,9,0,0.6,0.30283,0,0,0,0,0,2,0,0,0,2
7541,purawev.info,dga,3.58496,5,6,12,1,0.83333,0.29875,1,0,0,0,1,1,0,0,0,1
8832,markcashdecidevisitcommit.com,dga,3.6166,10,18,29,1,0.55556,0.12471,3,1,0,0,4,12,1,0,0,13
367,cdn.cookielaw.org,legit,3.57247,6,9,17,0,0.66667,0.21015,5,3,1,0,9,4,1,0,0,5
6916,mropxhxyqxsx.me,dga,3.24022,2,12,15,1,0.16667,0.21601,1,0,0,0,1,0,0,0,0,0
8436,usgquicgeowqaawi.org,dga,3.48418,9,10,20,1,0.9,0.17421,3,0,0,0,3,2,0,0,0,2
6030,yuhgfrnaz.com,dga,3.70044,3,9,13,1,0.33333,0.28465,0,0,0,0,0,0,0,0,0,0
7115,gmsgoaqwogqyomwm.org,dga,3.08418,5,14,20,1,0.35714,0.15421,0,0,0,0,0,1,0,0,0,1
1448,kt-prod.v.aaplimg.com,legit,3.78494,5,12,21,0,0.41667,0.18024,7,3,2,1,13,0,1,0,0,1
5947,ledcbcembdfemaac.eu,dga,3.15557,7,11,19,1,0.63636,0.16608,4,0,0,0,4,6,0,0,0,6
132,storage.live.com,legit,3.625,6,8,16,0,0.75,0.22656,5,1,0,0,6,5,0,0,0,5
5382,beikakok.ru,dga,3.02717,5,5,11,1,1.0,0.2752,0,0,0,0,0,1,0,0,0,1
50,accounts.google.com,legit,3.36609,7,10,19,0,0.7,0.17716,6,5,4,3,18,3,0,0,0,3
1135,clientstream.launchdarkly.com,legit,3.9523,8,19,29,0,0.42105,0.13629,7,1,0,0,8,7,1,0,0,8
9938,vqpcdaqbplswcajm.eu,dga,3.82687,4,14,19,1,0.28571,0.20141,2,0,0,0,2,1,0,0,0,1
2531,usersync.samplicio.us,legit,3.63041,7,12,21,0,0.58333,0.17288,7,1,0,0,8,4,2,0,0,6
4186,t-0009.t-msedge.net,legit,3.28663,3,8,19,0,0.375,0.17298,4,2,1,0,7,3,0,0,0,3
6183,vcmqswqt.com,dga,3.08496,1,10,12,1,0.1,0.25708,0,0,0,0,0,0,0,0,0,0
7903,pomtamenindulgentiarum.com,dga,3.74833,10,15,26,1,0.66667,0.14417,7,1,0,0,8,10,1,0,0,11
8850,soqkqcomakkmwgiw.org,dga,3.44644,5,14,20,1,0.35714,0.17232,2,1,0,0,3,3,1,0,0,4
2525,krk.kargo.com,legit,2.87314,3,8,13,0,0.375,0.22101,0,0,0,0,0,1,0,0,0,1
160,adnxs.com,legit,3.16993,2,6,9,0,0.33333,0.35221,2,0,0,0,2,1,0,0,0,1
2337,pus5-collabhubrtc.officeapps.live.com,legit,4.10082,11,21,37,0,0.52381,0.11083,10,5,4,3,22,6,0,0,0,6
1534,x.dlx.addthis.com,legit,3.41042,3,11,17,0,0.27273,0.20061,3,0,0,0,3,3,0,0,0,3
3733,events.split.io,legit,3.24022,5,8,15,0,0.625,0.21601,5,1,0,0,6,3,1,0,0,4
7790,icvrfwf.nl,dga,3.12193,1,8,10,1,0.125,0.31219,1,0,0,0,1,1,0,0,0,1
2869,nrich.ai,legit,2.75,3,4,8,0,0.75,0.34375,1,0,0,0,1,2,0,0,0,2
3166,edge.bamgrid.com,legit,3.375,5,9,16,0,0.55556,0.21094,4,2,1,0,7,4,0,0,0,4
8791,elheedatfee.ddns.net,dga,3.00869,7,11,20,1,0.63636,0.15043,5,1,0,0,6,7,4,3,2,16
525,passwordsleakcheck-pa.googleapis.com,legit,3.8848,12,21,36,0,0.57143,0.10791,6,6,4,4,20,6,1,0,0,7
2357,idsync.reson8.com,legit,3.49923,4,10,17,0,0.4,0.20584,4,0,0,0,4,3,1,0,0,4
8588,ogcqeykauakwgmue.org,dga,3.58418,8,11,20,1,0.72727,0.17921,0,0,0,0,0,0,0,0,0,0
2590,com.c.worldfcdn2.com,legit,3.24644,3,13,20,0,0.23077,0.16232,4,3,1,0,8,4,1,0,0,5
7172,gigewahoinvuna.ddns.net,dga,3.654,8,13,23,1,0.61538,0.15887,4,1,0,0,5,6,4,3,2,15
6743,ganevu.info,dga,3.27761,5,5,11,1,1.0,0.29796,0,0,0,0,0,2,0,0,0,2
9438,lyxesyn.su,dga,2.92193,2,7,10,1,0.28571,0.29219,1,0,0,0,1,1,0,0,0,1
5431,ekdelnukhmoqekgn.eu,dga,3.36609,7,11,19,1,0.63636,0.17716,0,0,0,0,0,2,0,0,0,2
6405,tucakaqalav.eu,dga,3.09307,7,6,14,1,1.16667,0.22093,0,1,0,0,1,2,0,0,0,2
7090,oorfrwhyvqpo.xyz,dga,3.45282,3,12,16,1,0.25,0.2158,1,0,0,0,1,1,0,0,0,1
1917,hs-analytics.net,legit,3.5,4,10,16,0,0.4,0.21875,2,0,0,0,2,3,0,0,0,3
5030,kycmwawegm46.top,dga,3.75,3,10,16,1,0.3,0.23438,0,0,0,0,0,0,0,0,0,0
1042,pull-hls-l77-va01.tiktokcdn.com,legit,4.15565,5,17,31,0,0.29412,0.13405,4,6,9,9,28,2,0,0,0,2
1475,loadm.exelator.com,legit,3.35021,7,9,18,0,0.77778,0.18612,3,0,0,0,3,4,0,0,0,4
799,ent-api.msn.com,legit,3.50689,4,8,15,0,0.5,0.23379,5,2,1,0,8,1,1,0,0,2
9037,mosergo.com,dga,2.84535,4,6,11,1,0.66667,0.25867,2,1,0,0,3,2,1,0,0,3
9510,leusdmwoby.com,dga,3.52164,4,9,14,1,0.44444,0.25155,2,0,0,0,2,1,0,0,0,1
2355,albtls.t.co,legit,2.91398,2,7,11,0,0.28571,0.26491,2,0,0,0,2,0,0,0,0,0
4086,sonar.prime-video.amazon.dev,legit,3.69951,11,13,28,0,0.84615,0.13213,5,2,3,3,13,6,0,0,0,6
5077,retailers-randy.org,dga,3.61635,6,11,19,1,0.54545,0.19033,5,0,0,0,5,8,2,0,0,10
5666,viafrukaiben.ddns.net,dga,3.6897,7,12,21,1,0.58333,0.1757,3,1,0,0,4,6,3,2,1,12
3514,www.canva.com,legit,2.87314,3,8,13,0,0.375,0.22101,1,0,0,0,1,2,0,0,0,2
1762,ingestion-edge.prod.dataops.mozgcp.net,legit,3.83281,12,21,38,0,0.57143,0.10086,16,6,4,2,28,10,5,1,0,16
5033,qkgogwauessomcqa.org,dga,3.54644,7,12,20,1,0.58333,0.17732,1,0,0,0,1,2,1,0,0,3
3553,apps.powerapps.com,legit,3.0805,5,11,18,0,0.45455,0.17114,5,1,0,0,6,2,0,0,0,2
1777,www.telecommandsvc.microsoft.com,legit,3.76532,8,21,32,0,0.38095,0.11767,12,9,7,6,34,11,2,0,0,13
306,ntp.org,legit,2.80735,1,5,7,0,0.2,0.40105,1,0,0,0,1,0,0,0,0,0
1810,ajax.aspnetcdn.com,legit,3.57243,5,11,18,0,0.45455,0.19847,3,1,0,0,4,4,0,0,0,4
6624,oxqapaaval.ddns.net,dga,3.51109,6,11,19,1,0.54545,0.18479,3,1,0,0,4,4,3,2,1,10
4748,amazon.partners.tremorhub.com,legit,3.71938,9,17,29,0,0.52941,0.12825,7,1,3,2,13,9,1,0,0,10
964,sentinelone.net,legit,2.70689,6,8,15,0,0.75,0.18046,7,1,0,0,8,7,3,0,0,10
3155,classlink.io,legit,3.08496,4,7,12,0,0.57143,0.25708,2,0,0,0,2,3,1,0,0,4
709,tiktokcdn-us.com,legit,3.5,4,10,16,0,0.4,0.21875,4,5,6,5,20,2,0,0,0,2
1801,usc-excel.officeapps.live.com,legit,3.7285,10,15,29,0,0.66667,0.12857,9,5,4,3,21,5,0,0,0,5
334,c.amazon-adsystem.com,legit,3.55852,6,12,21,0,0.5,0.16945,8,1,3,3,15,6,0,0,0,6
5376,pauinimicoeassrediplease.com,dga,3.61058,14,13,28,1,1.07692,0.12895,10,2,0,0,12,11,1,0,0,12
8171,adkobdmlfeelfdef.org,dga,3.40869,6,13,20,1,0.46154,0.17043,1,0,0,0,1,2,0,0,0,2
9164,yuwl.to,dga,2.80735,2,4,7,1,0.5,0.40105,0,0,0,0,0,0,0,0,0,0
7755,oa82om82caki.top,dga,3.32782,6,5,16,1,1.2,0.20799,0,0,0,0,0,2,0,0,0,2
9111,wwwqmismgkgmmaiq.org,dga,3.24644,4,15,20,1,0.26667,0.16232,2,0,0,0,2,3,0,0,0,3
5541,pvgemifox.com,dga,3.39275,4,8,13,1,0.5,0.26098,2,0,0,0,2,3,0,0,0,3
2781,engagefront.theweathernetwork.com,legit,3.59668,11,20,33,0,0.55,0.10899,9,1,0,0,10,9,1,1,1,12
7916,hwavkzltpvg33dwpqn30axlrbwd10a57e31p62.info,dga,4.62941,6,24,43,1,0.25,0.10766,0,0,0,0,0,0,0,0,0,0
442,spo-ring.msedge.net,legit,3.57662,5,11,19,0,0.45455,0.18824,5,2,1,0,8,5,2,0,0,7
8878,kcyxchpaza.com,dga,3.32486,3,10,14,1,0.3,0.23749,0,0,0,0,0,0,0,0,0,0
1656,rtactivate.com,legit,3.18201,5,8,14,0,0.625,0.22729,4,0,0,0,4,5,1,0,0,6
4752,beacon.sojern.com,legit,3.33718,6,9,17,0,0.66667,0.1963,4,1,0,0,5,6,1,0,0,7
8572,skquawyyogogekyo.org,dga,3.34644,7,12,20,1,0.58333,0.16732,1,0,0,0,1,1,0,0,0,1
7865,withguide.net,dga,3.2389,5,7,13,1,0.71429,0.24915,0,0,0,0,0,2,0,0,0,2
2718,ts01-b.cloudsink.net,legit,3.92193,4,11,20,0,0.36364,0.1961,5,3,3,2,13,2,0,0,0,2
1386,cdn.prod.uidapi.com,legit,3.32636,6,10,19,0,0.6,0.17507,7,7,4,2,20,1,1,0,0,2
4959,c1-powerpoint-15.cdn.office.net,legit,3.80018,8,15,31,0,0.53333,0.12259,9,6,5,3,23,5,0,0,0,5
4499,dcs-online-targeting-prd.aws.oath.cloud,legit,4.07299,11,22,39,0,0.5,0.10444,11,0,0,0,11,9,2,0,0,11
5327,whiupqqfxncjmygk.eu,dga,4.0374,4,14,19,1,0.28571,0.21249,0,0,0,0,0,0,0,0,0,0
1968,southcentralus.cloudapp.azure.com,legit,3.86198,12,18,33,0,0.66667,0.11703,14,5,3,4,26,4,2,0,0,6
7049,instanceemployshelterdemand.com,dga,3.82131,10,20,31,1,0.5,0.12327,9,0,0,0,9,13,3,1,0,17
156,azure.com,legit,3.16993,4,4,9,0,1.0,0.35221,1,0,0,1,2,1,0,0,0,1
9015,axcdw0uxu6w4o8y85xy.ddns.net,dga,4.03915,5,15,28,1,0.33333,0.14426,3,1,0,0,4,4,3,2,2,11
5034,vicehughes.pro,dga,3.52164,5,8,14,1,0.625,0.25155,3,1,0,0,4,3,0,0,0,3
4157,gh-g.v1.akaquill.net,legit,3.78418,5,10,20,0,0.5,0.18921,1,2,1,0,4,0,0,0,0,0
7181,w6afa8svsv1vgv7p3rs.ddns.net,dga,3.95021,3,18,28,1,0.16667,0.14108,3,1,0,0,4,4,3,3,2,12
5085,fdmfbujcajrxloiao.su,dga,3.82193,7,12,20,1,0.58333,0.1911,1,0,0,0,1,1,0,0,0,1
5487,kyokwmesayqcgywc.org,dga,3.58418,4,15,20,1,0.26667,0.17921,1,0,0,0,1,1,0,0,0,1
6680,plxclxeooj.com,dga,3.03915,4,9,14,1,0.44444,0.21708,2,0,0,0,2,0,0,0,0,0
1254,mgid.com,legit,2.75,2,5,8,0,0.4,0.34375,0,0,0,0,0,0,0,0,0,0
6896,teatvvhhje.com,dga,3.23593,4,9,14,1,0.44444,0.23114,3,0,0,0,3,3,0,0,0,3
7269,eeqcfehinulw.com,dga,3.57782,6,9,16,1,0.66667,0.22361,1,0,0,0,1,1,0,0,0,1
7787,nefabcdefdaalfob.info,dga,3.30875,8,12,21,1,0.66667,0.15756,1,0,0,0,1,2,0,0,0,2
1226,ad.cpe.dotomi.com,legit,3.17512,6,8,17,0,0.75,0.18677,6,0,0,0,6,3,1,0,0,4
4456,v39-us.gts.ttoverseaus.net,legit,3.56545,7,13,26,0,0.53846,0.13713,6,0,0,0,6,4,3,0,0,7
8307,jeannettemurgatroyd.net,dga,3.44726,8,14,23,1,0.57143,0.14988,4,0,0,0,4,7,0,0,0,7
9162,dujjjlnsbr.im,dga,3.33468,2,10,13,1,0.2,0.25651,0,0,0,0,0,1,0,0,0,1
2123,1925505597.rsc.cdn77.org,legit,3.60539,1,8,24,0,0.125,0.15022,3,1,0,0,4,1,0,0,0,1
123,upload.fp.measure.office.com,legit,3.65505,11,13,28,0,0.84615,0.13054,12,4,4,3,23,6,0,0,0,6
6369,ivmowhqwfyvqcwtr.eu,dga,3.78714,4,14,19,1,0.28571,0.19932,0,0,0,0,0,0,0,0,0,0
5071,ndudjipdngygiabt.com,dga,3.78418,5,14,20,1,0.35714,0.18921,1,0,0,0,1,2,0,0,0,2
1335,accounts.youtube.com,legit,3.40869,8,10,20,0,0.8,0.17043,4,0,0,0,4,3,0,0,0,3
450,nflxso.net,legit,3.12193,2,7,10,0,0.28571,0.31219,0,0,0,0,0,0,0,0,0,0
8542,qysvenjgtk.com,dga,3.80735,2,11,14,1,0.18182,0.27195,1,0,0,0,1,2,0,0,0,2
7114,orijibex1lqhwhqrojg.ddns.net,dga,4.09307,6,19,28,1,0.31579,0.14618,3,1,0,0,4,7,4,3,2,16
2261,cp4.cloudflare.com,legit,3.57243,5,10,18,0,0.5,0.19847,4,3,3,2,12,3,0,0,0,3
9856,ezj16a67ouk27b28ixgvitk67grpqirnuewex.biz,dga,4.42427,11,19,41,1,0.57895,0.10791,1,0,0,0,1,1,0,0,0,1
1682,servicebus.windows.net,legit,3.66353,7,13,22,0,0.53846,0.16652,7,2,1,1,11,6,2,1,0,9
9023,gacqlqeoya.biz,dga,3.52164,5,8,14,1,0.625,0.25155,0,0,0,0,0,1,0,1,0,2
8733,puidbaalfa.ddns.net,dga,3.53689,6,11,19,1,0.54545,0.18615,2,1,0,0,3,4,4,3,2,13
7054,lsrucsmiohuifg.com,dga,3.50326,6,11,18,1,0.54545,0.19463,1,0,0,0,1,1,0,0,0,1
3854,caldav.calendar.yahoo.com,legit,3.44888,9,13,25,0,0.69231,0.13796,4,0,0,1,5,5,0,0,0,5
2874,static.whatsapp.net,legit,3.26083,5,12,19,0,0.41667,0.17162,7,1,0,0,8,5,1,0,0,6
9870,iuuxuyiidkqt.com,dga,3.40564,7,8,16,1,0.875,0.21285,0,0,0,0,0,0,0,0,0,0
5041,fdamcmbdnokecnof.co,dga,3.32636,5,13,19,1,0.38462,0.17507,3,0,0,0,3,3,0,0,0,3
4629,v16-cla.tiktokcdn.com,legit,3.78494,4,12,21,0,0.33333,0.18024,4,6,7,6,23,3,0,0,0,3
9289,mnwarbehuhwqhrwv.eu,dga,3.43162,5,13,19,1,0.38462,0.18061,0,0,0,0,0,2,0,0,0,2
3569,amazon.ca,legit,2.6416,4,4,9,0,1.0,0.29351,3,1,3,2,9,3,0,0,0,3
921,btloader.com,legit,3.4183,4,7,12,0,0.57143,0.28486,3,0,0,0,3,2,0,0,0,2
7942,eniiddmrjchs.in,dga,3.32323,4,10,15,1,0.4,0.22155,1,0,0,0,1,3,0,0,0,3
629,windows.msn.com,legit,3.10689,3,10,15,0,0.3,0.20713,3,0,0,0,3,2,0,0,0,2
5770,humanshoe.net,dga,3.2389,5,7,13,1,0.71429,0.24915,1,0,0,0,1,3,1,0,0,4
5530,idihgoflocw.com,dga,3.32323,5,9,15,1,0.55556,0.22155,2,0,0,0,2,0,0,0,0,0
2229,configv2.unityads.unity3d.com,legit,3.9523,8,16,29,0,0.5,0.13629,5,1,0,0,6,4,1,0,0,5
2456,contactservice.zoom.us,legit,3.66353,8,12,22,0,0.66667,0.16652,10,3,1,1,15,9,3,1,0,13
5860,kussagmqogqwukuy.org,dga,3.44644,6,13,20,1,0.46154,0.17232,1,0,0,0,1,0,0,0,0,0
2105,1810366965.rsc.cdn77.org,legit,3.85539,1,8,24,0,0.125,0.16064,3,1,0,0,4,1,0,0,0,1
8514,huodsiwoo.ddns.net,dga,3.30827,6,10,18,1,0.6,0.18379,4,1,0,0,5,5,4,3,2,14
5915,aykeomiq.biz,dga,3.4183,5,6,12,1,0.83333,0.28486,1,0,0,0,1,2,0,0,0,2
9341,qse460mwiwu4.net,dga,3.625,4,7,16,1,0.57143,0.22656,1,0,0,0,1,1,0,0,0,1
6336,bkcjdwkftapgyl.info,dga,4.0374,3,15,19,1,0.2,0.21249,2,0,0,0,2,1,0,0,0,1
546,www.linkedin.com,legit,3.32782,4,10,16,0,0.4,0.20799,3,0,0,0,3,2,0,0,0,2
128,amazon.com,legit,2.72193,4,5,10,0,0.8,0.27219,3,1,3,2,9,3,0,0,0,3
4049,firetvcaptiveportal.com,legit,3.62118,8,14,23,0,0.57143,0.15744,4,0,0,0,4,7,0,0,0,7
4882,rfihub.net,legit,3.32193,3,6,10,0,0.5,0.33219,0,0,0,0,0,0,0,0,0,0
3455,img.youtube.com,legit,3.37356,6,7,15,0,0.85714,0.2249,1,0,0,0,1,1,0,0,0,1
6887,gr55z572gvxwb2wsbc.net,dga,3.87966,1,14,22,1,0.07143,0.17635,0,0,0,0,0,0,0,0,0,0
7131,lqymhvluciovwp.co.uk,dga,3.72193,5,13,20,1,0.38462,0.1861,3,1,0,0,4,1,1,0,0,2
7266,wogxgroptwet.xyz,dga,3.375,3,12,16,1,0.25,0.21094,1,0,0,0,1,1,0,0,0,1
3033,yahoo.net,legit,2.9477,4,4,9,0,1.0,0.32752,1,0,0,1,2,0,0,0,0,0
3873,iponweb.net,legit,3.0958,4,6,11,0,0.66667,0.28144,1,0,0,0,1,1,0,0,0,1
9214,jewamaj.info,dga,3.25163,5,6,12,1,0.83333,0.27097,2,1,0,0,3,2,0,0,0,2
7479,pyfqensdmq.com,dga,3.52164,2,11,14,1,0.18182,0.25155,1,0,0,0,1,2,0,0,0,2
8872,udadfihi.ddns.net,dga,3.26393,5,10,17,1,0.5,0.192,3,1,0,0,4,4,4,3,2,13
3151,ocws1.live.com.akadns.net,legit,3.84386,7,13,25,0,0.53846,0.15375,7,6,7,8,28,5,3,1,0,9
6382,tumiihatomdouto.ddns.net,dga,3.43872,9,13,24,1,0.69231,0.14328,5,1,0,0,6,7,4,3,2,16
3186,aax-us-pdx.amazon-adsystem.com,legit,3.77775,9,16,30,0,0.5625,0.12593,9,1,3,3,16,6,0,0,0,6
7917,britanniavirginia.net,dga,3.04163,9,11,21,1,0.81818,0.14484,2,0,0,0,2,6,1,0,0,7
7124,teshflpxgtocns.to,dga,3.57247,3,13,17,1,0.23077,0.21015,2,0,0,0,2,3,0,0,0,3
3777,content.prod.cms.msn.com,legit,3.29248,4,16,24,0,0.25,0.13719,11,6,3,2,22,4,3,0,0,7
7699,ujqlkksnszksqbs.biz,dga,3.26083,2,16,19,1,0.125,0.17162,0,0,0,0,0,1,0,0,0,1
7369,lysinex.info,dga,3.25163,4,7,12,1,0.57143,0.27097,1,0,0,0,1,3,1,0,0,4
780,ssbsync.smartadserver.com,legit,3.58928,5,18,25,0,0.27778,0.14357,6,1,1,0,8,6,3,1,0,10
9511,qgubtezfcu.com,dga,3.52164,4,9,14,1,0.44444,0.25155,1,0,0,0,1,1,0,0,0,1
8302,mdfyhhcevwew.net,dga,3.45282,3,12,16,1,0.25,0.2158,1,0,0,0,1,1,0,0,0,1
933,pull-f5-va01.tiktokcdn.com,legit,4.16198,5,14,26,0,0.35714,0.16008,4,6,9,9,28,2,0,0,0,2
4346,cl2-cdn.origin-apple.com.akadns.net,legit,4.00043,9,19,35,0,0.47368,0.1143,12,11,10,9,42,8,3,1,0,12
9818,dyswjzhuso.com,dga,3.52164,3,10,14,1,0.3,0.25155,1,0,0,0,1,0,0,0,0,0
3527,media.pushlycdn.com,legit,3.82687,5,12,19,0,0.41667,0.20141,4,1,0,0,5,2,0,0,0,2
918,www.clarity.ms,legit,3.32486,2,10,14,0,0.2,0.23749,1,0,0,0,1,4,0,0,0,4
3327,r.skimresources.com,legit,3.2211,6,11,19,0,0.54545,0.16953,4,0,0,0,4,3,1,0,0,4
5620,a65nm65vmxqbi6ep7t1.ddns.net,dga,4.03915,4,15,28,1,0.26667,0.14426,2,1,0,0,3,4,3,2,1,10
9650,mxmfxgixlkgionoal.com,dga,3.42733,6,14,21,1,0.42857,0.16321,1,0,0,0,1,1,1,0,0,2
9802,uyveuhyqfvui.pw,dga,3.32323,5,9,15,1,0.55556,0.22155,0,0,0,0,0,1,0,0,0,1
8567,eoyzbrfew.com.bo,dga,3.32782,5,9,16,1,0.55556,0.20799,2,2,1,0,5,2,2,1,0,5
2121,a1736.z.akamai.net,legit,3.46132,6,5,18,0,1.2,0.1923,3,3,4,3,13,2,0,0,0,2
2042,lm.serving-sys.com,legit,3.68354,3,12,18,0,0.25,0.20464,3,1,1,1,6,3,3,1,0,7
3403,a1916.dscg2.akamai.net,legit,3.78875,6,8,22,0,0.75,0.17222,5,3,4,3,15,3,0,0,0,3
9422,beoglovgbwfwufv.info,dga,3.44644,6,13,20,1,0.46154,0.17232,1,1,0,0,2,1,0,0,0,1
5168,scanned-fancy.la,dga,3.28064,4,10,16,1,0.4,0.20504,1,0,0,0,1,4,0,0,0,4
2818,js.intercomcdn.com,legit,3.46132,4,12,18,0,0.33333,0.1923,8,2,0,0,10,6,2,1,0,9
9651,cbwebovdtwrmdtphghq.eu,dga,3.91398,4,17,22,1,0.23529,0.17791,0,0,0,0,0,0,0,0,0,0
1523,setup.fe.apple-dns.net,legit,3.39081,6,12,22,0,0.5,0.15413,9,5,3,2,19,5,1,0,0,6
5773,zqrzdd.dynserv.com,dga,3.57243,2,14,18,1,0.14286,0.19847,4,1,1,0,6,5,5,5,4,19
4146,us-east-1.forester.a2z.com,legit,3.76718,8,11,26,0,0.72727,0.14489,8,1,0,0,9,8,3,0,0,11
648,optimizely.com,legit,3.37878,5,8,14,0,0.625,0.24134,2,0,0,0,2,3,0,0,0,3
5414,ogsuamakwayuqeuq.org,dga,3.54644,9,10,20,1,0.9,0.17732,2,1,0,0,3,3,0,0,0,3
8969,cddmfjsltaykyoga.eu,dga,3.93214,5,13,19,1,0.38462,0.20695,2,0,0,0,2,2,0,0,0,2
7885,kymaaukaqwaiokwg.org,dga,3.38418,8,11,20,1,0.72727,0.16921,1,0,0,0,1,1,0,0,0,1
898,mozilla.org,legit,3.0958,4,6,11,0,0.66667,0.28144,0,0,0,0,0,1,0,0,0,1
510,firebaseremoteconfig.googleapis.com,legit,3.79417,15,18,35,0,0.83333,0.1084,11,8,4,4,27,12,3,0,0,15
3174,esp.aptrinsic.com,legit,3.49923,5,10,17,0,0.5,0.20584,6,1,0,0,7,6,1,0,0,7
4991,xfinity.com,legit,3.27761,3,7,11,0,0.42857,0.29796,1,0,0,0,1,3,0,0,0,3
5491,vvmxpqapcskmvqlje.me,dga,3.54644,3,16,20,1,0.1875,0.17732,1,0,0,0,1,0,0,0,0,0
2380,e4686.dsce9.akamaiedge.net,legit,3.73431,9,9,26,0,1.0,0.14363,8,5,5,3,21,6,0,0,0,6
6605,u0ybg412m0o6uro.ddns.net,dga,4.08496,5,11,24,1,0.45455,0.17021,3,1,0,0,4,4,4,3,2,13
4197,ads.flurry.com,legit,3.52164,3,9,14,0,0.33333,0.25155,3,0,0,0,3,0,0,0,0,0
7358,dabdbbdkfanfdalb.eu,dga,3.0503,5,13,19,1,0.38462,0.16054,0,0,0,0,0,1,0,0,0,1
6104,ucywjwiebxyvorxgco.com,dga,3.75444,6,15,22,1,0.4,0.17066,1,0,0,0,1,2,0,0,0,2
9232,afterstock.net,dga,3.32486,4,9,14,1,0.44444,0.23749,3,0,0,0,3,3,2,0,0,5
422,beacons3.gvt2.com,legit,3.73452,4,9,17,0,0.44444,0.21968,3,1,0,0,4,6,1,0,0,7
4502,triplelift-match.dotomi.com,legit,3.70805,8,16,27,0,0.5,0.13734,7,1,0,0,8,8,0,0,0,8
4098,tag.simpli.fi,legit,3.18083,4,7,13,0,0.57143,0.24468,3,0,0,0,3,2,0,0,0,2
676,bugsnag.com,legit,3.27761,3,7,11,0,0.42857,0.29796,0,0,0,0,0,0,0,0,0,0
7474,onnirusd.com,dga,3.25163,4,7,12,1,0.57143,0.27097,2,0,0,0,2,2,0,0,0,2
5227,ixovevedusxeha.ddns.net,dga,3.53422,8,13,23,1,0.61538,0.15366,4,1,0,0,5,6,5,3,2,16
4962,vast.extremereach.io,legit,3.52193,8,10,20,0,0.8,0.1761,4,1,0,0,5,7,1,0,0,8
1549,ssp.advertising.com,legit,3.78714,5,12,19,0,0.41667,0.19932,6,0,0,0,6,6,2,0,0,8
9331,ladugviw.ru,dga,3.27761,4,6,11,1,0.66667,0.29796,1,0,0,0,1,1,0,0,0,1
9568,kkafwgtpxivchkt.co.uk,dga,3.72565,4,15,21,1,0.26667,0.17741,2,1,0,0,3,1,1,0,0,2
8127,henimlar.com,dga,3.4183,4,7,12,1,0.57143,0.28486,1,0,0,0,1,4,0,0,0,4
2542,amazon.de,legit,2.9477,4,4,9,0,1.0,0.32752,3,1,3,2,9,3,0,0,0,3
8966,lilgajil.ru,dga,2.84535,4,6,11,1,0.66667,0.25867,1,0,0,0,1,0,0,0,0,0
2020,vzwwo.com,legit,2.72548,2,6,9,0,0.33333,0.30283,0,0,0,0,0,0,0,0,0,0
4909,analytics-alv.google.com,legit,3.7406,8,13,24,0,0.61538,0.15586,4,5,4,3,16,4,0,0,0,4
2834,in.applicationinsights.azure.com,legit,3.87893,12,17,32,0,0.70588,0.12122,12,3,2,3,20,10,3,2,1,16
6957,aefbddlbnedkfamc.co.uk,dga,3.60694,6,14,22,1,0.42857,0.16395,4,1,0,0,5,5,1,0,0,6
4871,amazon-tam-match.dotomi.com,legit,3.33398,9,14,27,0,0.64286,0.12348,7,1,3,2,13,8,0,0,0,8
4727,i4.ytimg.com,legit,3.08496,3,6,12,0,0.5,0.25708,1,0,0,0,1,1,0,0,0,1
8654,ozlqiwnansnan.com,dga,3.38158,5,11,17,1,0.45455,0.19892,0,0,0,0,0,2,2,4,3,11
48,ocsp.digicert.com,legit,3.45482,5,10,17,0,0.5,0.20322,5,1,0,0,6,4,0,0,0,4
2572,honey.io,legit,2.75,4,3,8,0,1.33333,0.34375,1,0,0,0,1,2,1,0,0,3
8057,vdlthmsanjykf.com,dga,3.96982,2,14,17,1,0.14286,0.23352,0,0,0,0,0,1,0,0,0,1
9835,chnumtrscovtyx1crk.cn,dga,3.72565,2,17,21,1,0.11765,0.17741,2,0,0,0,2,1,0,0,0,1
7795,c4vucjgexks4ph1i8f.net,dga,4.1867,4,13,22,1,0.30769,0.1903,1,0,0,0,1,1,0,0,0,1
3158,tag.1rx.io,legit,3.12193,3,4,10,0,0.75,0.31219,1,0,0,0,1,1,0,0,0,1
6049,meakugulu.ddns.net,dga,3.46132,6,10,18,1,0.6,0.1923,3,1,0,0,4,5,3,3,2,13
615,beacon.krxd.net,legit,3.50689,4,9,15,0,0.44444,0.23379,3,1,0,0,4,5,1,0,0,6
6229,keeqweonviuvelm.ddns.net,dga,3.65311,8,14,24,1,0.57143,0.15221,3,1,0,0,4,7,3,2,2,14
5306,biw31rutkpwy2voc8s.net,dga,4.27761,4,13,22,1,0.30769,0.19444,0,0,0,0,0,0,0,0,0,0
3004,realtime.services.box.net,legit,3.66928,9,13,25,0,0.69231,0.14677,10,2,1,1,14,8,2,1,0,11
8047,formwisefearoccurcommunicate.com,dga,3.59002,13,18,32,1,0.72222,0.11219,7,1,0,0,8,12,2,0,0,14
8333,spotallow.net,dga,3.2389,4,8,13,1,0.5,0.24915,2,0,0,0,2,1,0,0,0,1
8262,bwfexqgm.com,dga,3.4183,2,9,12,1,0.22222,0.28486,0,0,0,0,0,0,0,0,0,0
3,data.microsoft.com,legit,3.35021,6,10,18,0,0.6,0.18612,8,8,7,6,29,4,0,0,0,4
5000,mortiscontrastatim.com,dga,3.20899,7,14,22,1,0.5,0.14586,8,2,0,0,10,10,3,0,1,14
6891,sdkzkvcd.top,dga,3.25163,1,10,12,1,0.1,0.27097,1,0,0,0,1,0,0,0,0,0
9872,drgjuig.pk,dga,3.12193,2,7,10,1,0.28571,0.31219,0,0,0,0,0,0,0,0,0,0
7794,cickckqekqyaygkq.org,dga,3.24644,4,15,20,1,0.26667,0.16232,1,0,0,0,1,1,0,0,0,1
9965,yevxijrkweizpocay.net,dga,3.97542,7,13,21,1,0.53846,0.18931,0,0,0,0,0,1,0,0,0,1
2365,primis.tech,legit,3.27761,3,7,11,0,0.42857,0.29796,2,0,0,0,2,3,0,0,0,3
4106,jac.yahoosandbox.com,legit,3.48418,7,11,20,0,0.63636,0.17421,1,0,0,1,2,3,1,0,0,4
1332,a2047.dscapi9.akamai.net,legit,3.81977,8,8,24,0,1.0,0.15916,7,4,4,3,18,4,0,0,0,4
7933,dafgicpi.ru,dga,3.27761,4,6,11,1,0.66667,0.29796,2,0,0,0,2,1,0,0,0,1
2756,intercomcdn.com,legit,3.1899,4,10,15,0,0.4,0.21266,7,2,0,0,9,6,2,1,0,9
6819,hhalbbfrtcgvjygmic.com,dga,3.87966,3,18,22,1,0.16667,0.17635,2,1,0,0,3,2,0,0,0,2
3200,ironsrc.mobi,legit,3.08496,4,7,12,0,0.57143,0.25708,2,0,0,0,2,2,0,0,0,2
2188,oca.nflxvideo.net,legit,3.61687,6,9,17,0,0.66667,0.21276,0,0,0,0,0,2,0,0,0,2
8303,qeduka.info,dga,3.45943,5,5,11,1,1.0,0.31449,1,0,0,0,1,1,0,0,0,1
2640,assets.msn.com.edgekey.net,legit,3.40776,7,15,26,0,0.46667,0.13107,7,5,3,1,16,7,3,1,0,11
5856,egmbshqhpm.com,dga,3.32486,2,11,14,1,0.18182,0.23749,0,0,0,0,0,0,0,0,0,0
6923,eo6cyousyomg.top,dga,3.375,6,8,16,1,0.75,0.21094,2,0,0,0,2,1,0,0,0,1
8830,uywmjiyaonjoinph.com,dga,3.58418,7,12,20,1,0.58333,0.17921,2,0,0,0,2,2,0,0,0,2
1557,live.rezync.com,legit,3.50689,4,9,15,0,0.44444,0.23379,3,0,0,0,3,2,0,0,0,2
8193,jcukwaiqiwgmtccuf.net,dga,3.78494,6,14,21,1,0.42857,0.18024,0,0,0,0,0,0,0,0,0,0
254,oneclient.sfx.ms,legit,3.5,4,10,16,0,0.4,0.21875,4,1,0,0,5,4,2,0,0,6
6910,cgmssgbiim.com,dga,2.89629,3,10,14,1,0.3,0.20688,0,0,0,0,0,0,0,0,0,0
5339,fumnwhpyxhoo.pw,dga,3.37356,3,11,15,1,0.27273,0.2249,1,0,0,0,1,0,0,0,0,0
3714,agent-cluster2.prod.us001-prod.arcticwolf.net,legit,4.24153,11,24,45,0,0.45833,0.09426,13,6,3,2,24,8,3,0,0,11
1136,c.2mdn.net,legit,2.92193,1,6,10,0,0.16667,0.29219,1,0,0,0,1,1,0,0,0,1
5629,jbktyxbrgllumrlk.eu,dga,3.57662,3,15,19,1,0.2,0.18824,0,0,0,0,0,0,0,0,0,0
293,licdn.com,legit,2.9477,2,6,9,0,0.33333,0.32752,4,1,0,0,5,2,0,0,0,2
4955,gsacollections-pa.googleapis.com,legit,3.64425,12,17,32,0,0.70588,0.11388,8,6,4,4,22,9,2,1,1,13
1824,c1h-excel-15.cdn.office.net,legit,3.68989,6,13,27,0,0.46154,0.13666,6,6,5,3,20,4,0,0,0,4
1727,ms.applovin.com,legit,3.37356,4,9,15,0,0.44444,0.2249,7,3,2,1,13,1,0,0,0,1
6438,relyingncaa.eu,dga,3.37878,6,7,14,1,0.85714,0.24134,2,0,0,0,2,4,1,0,0,5
281,dataservice.protection.outlook.com,legit,3.79998,14,17,34,0,0.82353,0.11176,15,4,2,1,22,11,5,2,1,19
6075,sontreeballgradeoilbottle.com,dga,3.65954,11,17,29,1,0.64706,0.12619,6,0,0,0,6,5,0,0,0,5
6466,xgqordfxxcdztbavorlj.ru,dga,3.93618,4,18,23,1,0.22222,0.17114,1,0,0,0,1,1,0,0,0,1
5269,swxurddayr.com,dga,3.52164,3,10,14,1,0.3,0.25155,0,0,0,0,0,1,0,0,0,1
9692,antonettephilander.net,dga,3.27761,8,13,22,1,0.61538,0.14898,4,0,0,0,4,9,2,0,0,11
6185,amxcoufqbex.com,dga,3.37356,5,9,15,1,0.55556,0.2249,3,0,0,0,3,3,3,2,2,10
6759,mbeicugibgdtwfdf.eu,dga,3.51109,6,12,19,1,0.5,0.18479,1,0,0,0,1,2,0,0,0,2
434,appsflyer.com,legit,3.54659,3,9,13,0,0.33333,0.27281,3,1,0,0,4,1,0,0,0,1
3373,wns.notify.trafficmanager.net,legit,3.71938,8,18,29,0,0.44444,0.12825,8,3,1,3,15,8,1,0,0,9
3226,www.tiktok.com,legit,2.89629,3,9,14,0,0.33333,0.20688,2,5,4,3,14,1,0,0,0,1
2505,captive.g.aaplimg.com,legit,3.46328,7,11,21,0,0.63636,0.16492,6,0,0,0,6,3,0,0,0,3
6145,joybdieetx.com,dga,3.52164,5,8,14,1,0.625,0.25155,0,0,0,0,0,1,0,0,0,1
2048,omex.cdn.office.net,legit,3.32636,6,10,19,0,0.6,0.17507,6,6,5,3,20,4,0,0,0,4
947,sc-static.net,legit,3.02699,3,8,13,0,0.375,0.23285,5,0,0,0,5,5,1,0,0,6
8905,iz64ir6x66p1szzvvk.cn,dga,3.59447,2,12,21,1,0.16667,0.17117,0,0,0,0,0,0,0,0,0,0
8569,veniemsiasciieuangeos.com,dga,3.41366,13,11,25,1,1.18182,0.13655,2,0,0,0,2,8,0,0,0,8
381,spotify.com,legit,3.27761,3,7,11,0,0.42857,0.29796,1,0,0,0,1,1,0,0,0,1
3222,ka-p.fontawesome.com,legit,3.68418,7,10,20,0,0.7,0.18421,5,0,0,0,5,4,0,0,0,4
1693,heapanalytics.com,legit,3.69012,6,10,17,0,0.6,0.21707,4,0,0,0,4,4,0,0,0,4
5341,nsscttyhifcj.biz,dga,3.5,2,13,16,1,0.15385,0.21875,0,0,0,0,0,1,0,0,0,1
1865,tiktokcdn.com.atomile.com,legit,3.40307,8,14,25,0,0.57143,0.13612,9,9,10,7,35,7,2,1,0,10
3814,data.adxcel-ec2.com,legit,3.43162,6,9,19,0,0.66667,0.18061,5,0,0,0,5,5,0,0,0,5
3148,2o7.net,legit,2.80735,2,2,7,0,1.0,0.40105,0,0,0,0,0,0,0,0,0,0
8949,hcmdxtwobuxd.biz,dga,3.625,3,12,16,1,0.25,0.22656,0,0,0,0,0,0,0,0,0,0
4267,supl.google.com,legit,3.1899,5,8,15,0,0.625,0.21266,3,5,4,3,15,2,0,0,0,2
3306,vap.lijit.com,legit,3.39275,4,7,13,0,0.57143,0.26098,3,0,0,0,3,1,0,0,0,1
471,gr.global.aa-rt.sharepoint.com,legit,3.85656,9,16,30,0,0.5625,0.12855,5,0,0,0,5,3,0,0,0,3
1121,kv801.prod.do.dsp.mp.microsoft.com,legit,3.69381,6,19,34,0,0.31579,0.10864,11,12,10,9,42,3,2,0,0,5
2862,tls13.taboola.map.fastly.net,legit,3.63754,7,15,28,0,0.46667,0.12991,8,1,0,0,9,5,0,0,0,5
1922,hs-banner.com,legit,3.54659,3,8,13,0,0.375,0.27281,1,0,0,0,1,3,0,0,0,3
3809,scdnco.spotify.map.fastly.net,legit,3.77144,6,19,29,0,0.31579,0.13005,9,2,0,0,11,6,0,0,0,6
4630,dbankcloud.asia,legit,3.45656,6,8,15,0,0.75,0.23044,2,3,2,1,8,1,0,0,0,1
4736,cdn.cxense.com,legit,3.03915,3,9,14,0,0.33333,0.21708,5,2,1,0,8,4,1,0,0,5
5974,oy860ukyg6ou.top,dga,3.32782,5,6,16,1,0.83333,0.20799,1,0,0,0,1,0,0,0,0,0
576,cl3.apple.com,legit,3.08506,3,7,13,0,0.42857,0.23731,5,4,3,2,14,1,0,0,0,1
4594,todo-ta-g7g.amazon.com,legit,3.42512,7,10,22,0,0.7,0.15569,5,1,3,3,12,4,0,0,0,4
5865,wqfjqkortwppdivim.cc,dga,3.82193,3,16,20,1,0.1875,0.1911,1,0,0,0,1,1,0,0,0,1
5741,nebfnfcaoklckdll.cc,dga,3.26083,3,15,19,1,0.2,0.17162,0,0,0,0,0,2,0,0,0,2
3949,a2047.w183.akamai.net,legit,3.78494,6,5,21,0,1.2,0.18024,3,3,4,3,13,2,0,0,0,2
8519,kxtkjcvjtepmvvwn.info,dga,3.78494,3,17,21,1,0.17647,0.18024,1,0,0,0,1,1,0,0,0,1
7048,treoforth.vn,dga,3.08496,3,8,12,1,0.375,0.25708,2,0,0,0,2,2,0,0,0,2
7923,werilnud.ru,dga,3.0958,4,6,11,1,0.66667,0.28144,1,0,0,0,1,2,1,0,0,3
7728,qquwsorchctxzyn.biz,dga,3.93214,3,15,19,1,0.2,0.20695,0,0,0,0,0,1,0,0,0,1
2943,tpmn.co.kr,legit,3.12193,1,7,10,0,0.14286,0.31219,2,1,0,0,3,1,1,0,0,2
7956,ewwwykuiwcymao.net,dga,3.50326,6,11,18,1,0.54545,0.19463,1,0,0,0,1,1,0,5,4,10
4997,hgrtb.com,legit,3.16993,1,7,9,0,0.14286,0.35221,0,0,0,0,0,0,0,0,0,0
1120,meetings.googleapis.com,legit,3.55553,9,12,23,0,0.75,0.15459,8,6,4,4,22,6,1,0,0,7
4445,identitytoolkit.googleapis.com,legit,3.7199,12,16,30,0,0.75,0.124,8,7,4,4,23,7,1,0,0,8
264,tlu.dl.delivery.mp.microsoft.com,legit,3.81643,8,19,32,0,0.42105,0.11926,10,8,7,7,32,7,1,0,0,8
7103,eyrhioeuid.com,dga,3.37878,7,6,14,1,1.16667,0.24134,0,0,0,0,0,0,0,0,0,0
8263,preceptaetiamsi.com,dga,3.36609,8,10,19,1,0.8,0.17716,6,0,0,0,6,8,0,0,0,8
5444,gmomggvvnshqopp.biz,dga,3.57662,3,15,19,1,0.2,0.18824,1,0,0,0,1,2,0,0,0,2
5297,suicidenotice.com,dga,3.29277,8,8,17,1,1.0,0.19369,4,1,0,0,5,6,0,0,0,6
8667,hunemdohwit.com,dga,3.50689,5,9,15,1,0.55556,0.23379,0,0,0,0,0,3,0,0,0,3
9827,byqk.pe,dga,2.80735,1,5,7,1,0.2,0.40105,0,0,0,0,0,0,0,0,0,0
9484,pwktjwsgomdm.ru,dga,3.64022,2,12,15,1,0.16667,0.24268,0,0,0,0,0,1,0,0,0,1
859,push-apple.com.akadns.net,legit,3.83327,7,14,25,0,0.5,0.15333,11,9,9,9,38,5,3,1,0,9
8723,nirullo.com,dga,3.0958,4,6,11,1,0.66667,0.28144,1,0,0,0,1,1,0,0,0,1
2924,pm.beyondtrustcloud.com,legit,3.79509,6,15,23,0,0.4,0.165,5,3,2,1,11,4,0,0,0,4
9231,kfcamehmwikh.org,dga,3.625,4,11,16,1,0.36364,0.22656,1,0,0,0,1,2,0,0,0,2
6268,ctbflxsaggcjtagt.eu,dga,3.53689,4,14,19,1,0.28571,0.18615,1,0,0,0,1,1,0,0,0,1
7447,xbpnijmlyjlovvmr.com,dga,3.68418,3,16,20,1,0.1875,0.18421,1,0,0,0,1,1,0,0,0,1
8977,saqoxwkkzyec.mooo.com,dga,3.45853,7,12,21,1,0.58333,0.16469,2,0,0,0,2,1,1,2,1,5
3934,playground.xyz,legit,3.6645,3,10,14,0,0.3,0.26175,3,0,0,0,3,2,0,0,0,2
7247,dqnxqmfrc.com,dga,3.2389,1,11,13,1,0.09091,0.24915,0,0,0,0,0,0,0,0,0,0
3860,apis.mail.yahoo.com,legit,3.28663,8,8,19,0,1.0,0.17298,6,1,0,1,8,2,0,0,0,2
8043,usaaaksumkkyuauu.org,dga,3.0037,10,9,20,1,1.11111,0.15018,1,0,0,0,1,1,0,0,0,1
1814,snat.goguardian.com,legit,3.57662,7,10,19,0,0.7,0.18824,1,1,0,0,2,3,0,0,0,3
6720,3b7xwvsvcbe4udadq6kn14q.ddns.net,dga,4.16391,4,20,32,1,0.2,0.13012,3,1,0,0,4,5,3,3,2,13
7099,worlds-header.in,dga,3.625,5,9,16,1,0.55556,0.22656,4,0,0,0,4,4,0,0,0,4
2083,ipify.org,legit,2.9477,3,5,9,0,0.6,0.32752,1,0,0,0,1,0,0,0,0,0
7513,mfcdcebmcbddacmc.online,dga,3.34446,5,17,23,1,0.29412,0.14541,2,0,0,0,2,3,0,0,0,3
9837,taskplacebottombraincoach.com,dga,3.7285,10,18,29,1,0.55556,0.12857,6,0,0,0,6,9,0,0,0,9
67,graph.microsoft.com,legit,3.57662,5,12,19,0,0.41667,0.18824,8,8,7,6,29,3,0,0,0,3
1545,e13678.dscb.akamaiedge.net,legit,3.95006,8,10,26,0,0.8,0.15193,7,5,5,3,20,5,0,0,0,5
5898,ibwjwhjgaw.com,dga,3.32486,3,10,14,1,0.3,0.23749,0,0,0,0,0,0,0,0,0,0
8275,14st7xs6cn5he2w.ddns.net,dga,3.85539,2,14,24,1,0.14286,0.16064,3,1,0,0,4,5,3,3,2,13
9715,iapyexdeirxqlqqp.co,dga,3.57662,6,12,19,1,0.5,0.18824,1,0,0,0,1,1,0,0,0,1
7845,stomachhuntstaydropprint.com,dga,3.78039,7,20,28,1,0.35,0.13501,8,0,0,0,8,7,1,0,0,8
2905,upload.wikimedia.org,legit,3.68418,9,9,20,0,1.0,0.18421,5,0,0,0,5,1,0,0,0,1
9066,envlybcjdtvtrmarl.net,dga,3.6897,3,17,21,1,0.17647,0.1757,2,0,0,0,2,3,0,0,0,3
9099,fkjr.cz,dga,2.80735,0,6,7,1,0.0,0.40105,0,0,0,0,0,0,0,0,0,0
3671,xiaomi.net,legit,3.12193,5,4,10,0,1.25,0.31219,1,0,0,0,1,2,0,0,0,2
1928,isnssdk.com,legit,3.02717,2,8,11,0,0.25,0.2752,0,0,0,0,0,2,0,0,0,2
59,www.googletagmanager.com,legit,3.40727,8,14,24,0,0.57143,0.14197,6,6,4,6,22,7,0,0,0,7
4701,manage.office.com,legit,3.26393,7,8,17,0,0.875,0.192,6,5,4,5,20,5,0,0,0,5
5229,asoca.com.ve,dga,2.9183,5,5,12,1,1.0,0.24319,2,2,1,0,5,4,2,1,0,7
4444,spoppe-b.azureedge.net,legit,3.62468,8,11,22,0,0.72727,0.16476,5,2,1,2,10,3,0,0,0,3
6244,v6m6kanzgnf4hacyqy.biz,dga,4.00489,3,15,22,1,0.2,0.18204,0,0,0,0,0,2,0,0,0,2
3115,nvidia.com,legit,3.12193,4,5,10,0,0.8,0.31219,0,0,0,0,0,0,0,0,0,0
7616,ytybgfm07xq0idiner1.ddns.net,dga,4.03915,4,18,28,1,0.22222,0.14426,4,1,0,0,5,7,4,2,1,14
9928,hopestaffimpactestimateroof.com,dga,3.56647,12,18,31,1,0.66667,0.11505,11,1,0,0,12,9,3,0,0,12
5738,tvkvottnkftbtjr.net,dga,3.11583,2,16,19,1,0.125,0.16399,0,0,0,0,0,0,0,0,0,0
8634,vonymok.com,dga,2.84535,3,7,11,1,0.42857,0.25867,1,0,0,0,1,1,0,0,0,1
2678,onedscolprdeus14.eastus.cloudapp.azure.com,legit,3.89185,15,21,42,0,0.71429,0.09266,17,5,3,4,29,9,1,0,0,10
3412,beacons.extremereach.io,legit,3.58401,10,11,23,0,0.90909,0.15583,6,1,0,0,7,9,2,0,0,11
2100,symantec.com,legit,3.25163,3,8,12,0,0.375,0.27097,3,0,0,0,3,4,0,0,0,4
6937,ynndfjrcghmm.com,dga,3.45282,1,14,16,1,0.07143,0.2158,0,0,0,0,0,1,0,0,0,1
1348,ipv6.microsoft.com,legit,3.46132,5,10,18,0,0.5,0.1923,6,8,7,6,27,2,0,0,0,2
196,asyncgw.teams.microsoft.com,legit,3.7262,7,17,27,0,0.41176,0.13801,11,8,7,6,32,6,0,0,0,6
6795,vicokomu.info,dga,3.18083,6,6,13,1,1.0,0.24468,2,0,0,0,2,3,0,0,0,3
1539,px.owneriq.net,legit,3.37878,4,8,14,0,0.5,0.24134,1,0,0,0,1,3,1,0,0,4
6610,chwt12kv1ry8c8c.ddns.net,dga,3.88684,1,16,24,1,0.0625,0.16195,2,1,0,0,3,4,3,2,2,11
8036,dyaphokdtinmoiuab.su,dga,3.82193,8,11,20,1,0.72727,0.1911,3,0,0,0,3,2,0,0,0,2
5093,euypqshgelhywcrwjnijvcr.org,dga,4.06026,5,21,27,1,0.2381,0.15038,2,0,0,0,2,3,0,0,0,3
3646,farm.dprodmgd105.aa-rt.sharepoint.com,legit,4.06717,9,20,37,0,0.45,0.10992,7,2,1,0,10,4,1,0,0,5
6922,sntwqnxlyb.de,dga,3.54659,1,11,13,1,0.09091,0.27281,1,0,0,0,1,0,0,0,0,0
1087,citrix.com,legit,2.92193,3,6,10,0,0.5,0.29219,0,0,0,0,0,2,0,0,0,2
9845,ehuxkphpmyenhwxax.tw,dga,3.54644,4,15,20,1,0.26667,0.17732,1,0,0,0,1,1,0,0,0,1
5328,dwsl.co.nz,dga,3.12193,1,7,10,1,0.14286,0.31219,2,1,0,0,3,1,1,0,0,2
8174,dulvmyare41ctf32braxjscuksfqhweua17.info,dga,4.71531,10,23,40,1,0.43478,0.11788,2,0,0,0,2,3,0,0,0,3
5877,ombhoijnxm.cc,dga,3.2389,3,9,13,1,0.33333,0.24915,0,0,0,0,0,1,0,0,0,1
1583,c2shb.ssp.yahoo.com,legit,3.28663,4,11,19,0,0.36364,0.17298,2,0,0,1,3,0,0,0,0,0
9103,lwmpbvwowjxhmduh.eu,dga,3.68188,4,14,19,1,0.28571,0.19378,0,0,0,0,0,0,0,0,0,0
4376,imap.mail.me.com.akadns.net,legit,3.51009,9,13,27,0,0.69231,0.13,10,6,7,8,31,5,3,1,0,9
7332,akexfgyqvw.com,dga,3.80735,3,10,14,1,0.3,0.27195,0,0,0,0,0,0,0,0,0,0
2313,array601.prod.do.dsp.mp.microsoft.com,legit,3.71259,8,20,37,0,0.4,0.10034,12,12,10,9,43,5,2,0,0,7
5784,lpgsjinflwwqmlvkw.tw,dga,3.68418,1,18,20,1,0.05556,0.18421,1,0,0,0,1,1,0,0,0,1
6061,qinmwnmlcaouwliav.net,dga,3.6897,7,13,21,1,0.53846,0.1757,3,0,0,0,3,2,0,0,0,2
559,rapid7.com,legit,3.32193,3,5,10,0,0.6,0.33219,3,1,0,0,4,1,0,0,0,1
5152,m1t5l1bgbt3tynby5l.ru,dga,3.55852,1,14,21,1,0.07143,0.16945,0,0,0,0,0,0,0,0,0,0
2457,prebid-match.dotomi.com,legit,3.67531,7,13,23,0,0.53846,0.1598,6,0,0,0,6,6,0,0,0,6
6854,kulaxyodlmyir.ru,dga,3.5,5,10,16,1,0.5,0.21875,0,0,0,0,0,1,0,0,0,1
452,a.nel.cloudflare.com,legit,3.44644,7,10,20,0,0.7,0.17232,4,3,3,2,12,5,0,0,0,5
1985,js.hs-analytics.net,legit,3.57662,4,12,19,0,0.33333,0.18824,3,0,0,0,3,3,0,0,0,3
2511,expedia.com,legit,3.27761,5,5,11,0,1.0,0.29796,1,0,0,0,1,1,0,0,0,1
6946,gkshnkqtpjvxp.ru,dga,3.75,1,14,16,1,0.07143,0.23438,0,0,0,0,0,0,0,0,0,0
6354,williampassword.sc,dga,3.46132,5,12,18,1,0.41667,0.1923,2,0,0,0,2,3,1,0,0,4
9707,elsvk4kr7tgdole.ddns.net,dga,3.68872,4,16,24,1,0.25,0.1537,4,1,0,0,5,6,4,3,2,15
8724,oehsmrifbkhwyahh.eu,dga,3.72161,6,12,19,1,0.5,0.19587,0,0,0,0,0,1,0,0,0,1
6881,alkvlvpvelvpi.com,dga,3.21953,4,12,17,1,0.33333,0.18938,1,0,0,0,1,2,0,0,0,2
485,typekit.net,legit,2.84535,3,7,11,0,0.42857,0.25867,0,0,0,0,0,1,0,0,0,1
2280,bidtheatre.com,legit,3.52164,5,8,14,0,0.625,0.25155,3,0,0,0,3,3,0,0,0,3
6190,isy42siwmcio.org,dga,3.45282,5,8,16,1,0.625,0.2158,0,0,0,0,0,2,0,0,0,2
5579,fulargaf.com,dga,3.25163,4,7,12,1,0.57143,0.27097,0,0,0,0,0,2,0,0,0,2
3137,naturallanguageeditorservice.osi.office.net.akadns.net,legit,3.89109,22,27,54,0,0.81481,0.07206,13,9,9,7,38,17,4,1,0,22
9458,hlkbabvwxdljbqojsc.co,dga,3.78494,3,17,21,1,0.17647,0.18024,0,0,0,0,0,0,0,0,0,0
2980,onedscolprdcus09.centralus.cloudapp.azure.com,legit,3.91643,14,25,45,0,0.56,0.08703,19,5,3,4,31,8,3,0,0,11
4315,s.update.rubiconproject.com,legit,3.8562,9,15,27,0,0.6,0.14282,9,2,0,0,11,6,3,0,0,9
9001,a8k6sd1d14gxkbkhkxk.ddns.net,dga,3.74987,2,19,28,1,0.10526,0.13392,2,1,0,0,3,4,3,2,2,11
4989,pxl.connexity.net,legit,3.33718,4,11,17,0,0.36364,0.1963,3,2,0,0,5,4,2,0,0,6
6289,thosebeside.net,dga,3.10689,6,8,15,1,0.75,0.20713,2,0,0,0,2,5,0,0,0,5
7900,nuokonxxcu.com,dga,2.89629,5,8,14,1,0.625,0.20688,1,0,0,0,1,1,0,0,0,1
4809,e1324.dscd.akamaiedge.net,legit,3.75327,8,10,25,0,0.8,0.15013,9,5,5,3,22,5,0,0,0,5
4899,pool.admedo.com,legit,2.97356,6,7,15,0,0.85714,0.19824,4,0,0,0,4,1,0,0,0,1
702,ad.smaato.net,legit,3.02699,5,6,13,0,0.83333,0.23285,4,0,0,0,4,2,0,0,0,2
5731,equvkueoya.info,dga,3.50689,8,6,15,1,1.33333,0.23379,0,0,0,0,0,0,0,1,0,1
3679,bitdefender.net,legit,2.97356,5,9,15,0,0.55556,0.19824,2,0,0,0,2,5,0,0,0,5
101,play.googleapis.com,legit,3.47135,7,10,19,0,0.7,0.1827,6,6,4,4,20,4,0,0,0,4
2882,outlook.ms-acdc.office.com,legit,3.6095,9,13,26,0,0.69231,0.13883,8,4,4,3,19,3,0,0,0,3
9967,yqrcrhhtlxbh.com,dga,3.45282,1,14,16,1,0.07143,0.2158,1,0,0,0,1,0,0,0,0,0
1266,samplicio.us,legit,3.25163,5,6,12,0,0.83333,0.27097,4,0,0,0,4,2,0,0,0,2
3274,jsb16-platform-useast5.us.tiktokv.com,legit,4.24973,9,20,37,0,0.45,0.11486,9,6,4,3,22,8,0,0,0,8
9699,ksfkiuezpu.com,dga,3.52164,5,8,14,1,0.625,0.25155,0,0,0,0,0,0,0,0,0,0
4863,webcast16-ws-useast2a.tiktokv.com,legit,3.99122,9,17,33,0,0.52941,0.12095,6,6,4,3,19,6,0,0,0,6
3978,ssc.33across.com,legit,2.82782,3,9,16,0,0.33333,0.17674,2,2,1,0,5,1,0,0,0,1
4622,cl4.g.aaplimg.com,legit,3.21953,4,9,17,0,0.44444,0.18938,4,0,0,0,4,0,0,0,0,0
7273,mzpoqifcm.cc,dga,3.02206,2,9,12,1,0.22222,0.25184,0,0,0,0,0,0,0,0,0,0
6761,nosremischaritatis.com,dga,3.48171,8,13,22,1,0.61538,0.15826,5,0,0,0,5,10,3,1,0,14
4832,kvinit-prod.api.kochava.com,legit,3.75416,9,14,27,0,0.64286,0.13904,7,5,3,1,16,3,2,0,0,5
7239,kdbbfcicmfrxvmbgni.ru,dga,3.6897,3,17,21,1,0.17647,0.1757,1,0,0,0,1,2,0,0,0,2
8533,zryasukgerbwfdh.com,dga,4.14266,4,14,19,1,0.28571,0.21803,2,0,0,0,2,4,0,0,0,4
5036,usecwemser.com,dga,3.03915,5,8,14,1,0.625,0.21708,3,1,0,0,4,4,1,0,0,5
8890,bclaaodbcffeodmm.com,dga,3.20869,6,13,20,1,0.46154,0.16043,0,0,0,0,0,1,0,0,0,1
4273,appnexus.map.fastly.net,legit,3.55553,6,14,23,0,0.42857,0.15459,8,2,0,0,10,4,0,0,0,4
1221,secure.cdn.fastclick.net,legit,3.60539,6,15,24,0,0.4,0.15022,9,3,1,0,13,7,0,0,0,7
5188,gxaa.com.mt,dga,2.91398,3,6,11,1,0.5,0.26491,2,2,1,0,5,2,2,1,0,5
5474,ecikaewkhfudcefny.tw,dga,3.68418,6,13,20,1,0.46154,0.18421,1,0,0,0,1,2,0,0,0,2
1043,ad-delivery.net,legit,3.45656,5,8,15,0,0.625,0.23044,3,0,0,0,3,4,1,0,0,5
257,origin-apple.com.akadns.net,legit,3.93027,9,14,27,0,0.64286,0.14557,11,9,9,9,38,8,3,1,0,12
5827,v83opnlite45r8pqsq.ru,dga,4.01137,4,11,21,1,0.36364,0.19102,2,0,0,0,2,2,0,0,0,2
9245,iheva2183hwhsnibwfw.ddns.net,dga,3.94076,5,17,28,1,0.29412,0.14074,2,1,0,0,3,5,3,3,2,13
3289,munchkin.marketo.net,legit,3.58418,6,12,20,0,0.5,0.17921,3,0,0,0,3,4,0,0,0,4
8247,elhom.mu,dga,2.75,3,4,8,1,0.75,0.34375,0,0,0,0,0,2,0,0,0,2
3663,augloop-prod.trafficmanager.net,legit,3.93775,11,17,31,0,0.64706,0.12702,11,6,3,4,24,6,2,0,0,8
9318,hewafdar.com,dga,3.4183,4,7,12,1,0.57143,0.28486,0,0,0,0,0,1,0,0,0,1
5260,ijfvcuutxpfv.com,dga,3.5,4,11,16,1,0.36364,0.21875,0,0,0,0,0,0,0,0,0,0
1927,api-emea.flightproxy.teams.microsoft.com,legit,3.99644,13,22,40,0,0.59091,0.09991,15,10,7,6,38,6,1,0,0,7
2238,uplynk.com,legit,3.32193,2,7,10,0,0.28571,0.33219,1,0,0,0,1,0,0,0,0,0
2466,office.net.akadns.net,legit,3.42733,7,11,21,0,0.63636,0.16321,7,7,7,5,26,6,1,0,0,7
323,youtubei.googleapis.com,legit,3.74095,11,10,23,0,1.1,0.16265,6,6,4,4,20,4,0,0,0,4
7394,crkbydl.com.do,dga,3.23593,2,10,14,1,0.2,0.23114,3,2,1,0,6,2,2,1,0,5
5958,hxsepytohm.tv,dga,3.39275,2,10,13,1,0.2,0.26098,1,0,0,0,1,1,0,0,0,1
3534,s3.us-east-1.amazonaws.com,legit,3.67141,8,11,26,0,0.72727,0.14121,7,2,3,3,15,6,0,0,0,6
5255,zlafftnrrq.com,dga,3.52164,2,11,14,1,0.18182,0.25155,0,0,0,0,0,1,0,0,0,1
6558,layerremaincontributequote.com,dga,3.76474,13,16,30,1,0.8125,0.12549,8,1,0,0,9,10,1,0,1,12
1149,stripe.com,legit,3.32193,3,6,10,0,0.5,0.33219,1,0,0,0,1,2,0,0,0,2
8749,hostespapeconstprobatum.com,dga,3.63397,9,17,27,1,0.52941,0.13459,9,2,0,0,11,8,2,0,0,10
3204,yahoo.co.jp,legit,2.84535,4,5,11,0,0.8,0.25867,3,1,0,1,5,1,1,0,0,2
7697,frontcompe.net,dga,3.23593,4,9,14,1,0.44444,0.23114,4,1,0,0,5,3,1,0,0,4
2642,files.slack.com,legit,3.37356,4,9,15,0,0.44444,0.2249,3,0,0,0,3,4,0,0,0,4
2852,mwzeom.zeotap.com,legit,3.17512,6,9,17,0,0.66667,0.18677,2,1,0,0,3,2,0,0,0,2
5304,gucq0moqc24y.net,dga,3.75,3,9,16,1,0.33333,0.23438,0,0,0,0,0,0,0,0,0,0
5320,xfndtfxtsbmnc.net,dga,3.29277,1,15,17,1,0.06667,0.19369,0,0,0,0,0,1,0,0,0,1
6846,e8s0kh7xihubmbihcbi03ts.ddns.net,dga,4.03064,6,19,32,1,0.31579,0.12596,3,1,0,0,4,4,3,3,2,12
3400,rl.quantummetric.com,legit,3.58418,6,12,20,0,0.5,0.17921,2,0,0,0,2,4,0,0,0,4
9952,xrnekxfjslilbhlq.eu,dga,3.78714,4,14,19,1,0.28571,0.19932,1,0,0,0,1,1,0,0,0,1
215,ls-apple.com.akadns.net,legit,3.67531,6,13,23,0,0.46154,0.1598,10,9,9,9,37,5,3,1,0,9
8471,mallobndfmaabnac.info,dga,3.30875,7,13,21,1,0.53846,0.15756,2,0,0,0,2,3,0,0,0,3
2440,doh.dns.apple.com,legit,3.45482,4,10,17,0,0.4,0.20322,8,5,3,2,18,4,1,0,0,5
2990,as.jivox.com,legit,3.25163,4,6,12,0,0.66667,0.27097,1,0,0,0,1,1,0,0,0,1
8264,wditogmfnxvtbtfey.su,dga,3.98418,4,15,20,1,0.26667,0.19921,0,0,0,0,0,1,0,0,0,1
9342,ajxzjreoh.md,dga,3.4183,3,8,12,1,0.375,0.28486,1,0,0,0,1,1,0,0,0,1
6154,samiwnehi.com,dga,3.39275,5,7,13,1,0.71429,0.26098,2,0,0,0,2,3,0,0,0,3
1575,media4.giphy.com,legit,3.625,5,8,16,0,0.625,0.22656,1,0,0,0,1,1,0,0,0,1
7741,pnzwrcehinh.com,dga,3.50689,3,11,15,1,0.27273,0.23379,2,0,0,0,2,2,0,0,0,2
478,pinterest.com,legit,3.39275,4,8,13,0,0.5,0.26098,8,0,0,0,8,6,4,1,0,11
7626,abupifigig.ddns.net,dga,3.57662,6,11,19,1,0.54545,0.18824,3,1,0,0,4,4,3,3,2,12
3962,walmartimages.com,legit,3.52806,6,10,17,0,0.6,0.20753,4,1,0,0,5,5,0,0,0,5
6387,alamffnccloafdbk.com,dga,3.30869,5,14,20,1,0.35714,0.16543,2,1,0,0,3,2,0,0,0,2
9970,wirellot.com,dga,3.25163,4,7,12,1,0.57143,0.27097,2,0,0,0,2,2,0,0,0,2
457,1.nflxso.net,legit,3.25163,2,7,12,0,0.28571,0.27097,0,0,0,0,0,0,0,0,0,0
8509,gexfmtlbruqfgpuk.eu,dga,3.68188,5,13,19,1,0.38462,0.19378,1,0,0,0,1,1,0,0,0,1
2800,mm3.akamai.net,legit,2.98523,5,6,14,0,0.83333,0.21323,3,3,4,3,13,2,0,0,0,2
4027,e1329.g.akamaiedge.net,legit,3.57262,8,7,22,0,1.14286,0.16239,5,5,5,3,18,4,0,0,0,4
7894,wpmytjgker.com,dga,3.6645,2,11,14,1,0.18182,0.26175,1,0,0,0,1,1,0,0,0,1
2080,tpsc-uw1.doubleverify.com,legit,4.24386,7,14,25,0,0.5,0.16975,4,0,0,0,4,5,2,0,0,7
3768,uber.com,legit,3.0,3,4,8,0,0.75,0.375,1,0,0,0,1,2,0,0,0,2
1291,ims-prod06.adobelogin.com,legit,4.00386,8,12,25,0,0.66667,0.16015,6,2,1,0,9,3,1,0,0,4
7384,fdcmoaaabfdlcfaa.com,dga,2.96596,7,12,20,1,0.58333,0.1483,0,0,0,0,0,0,0,0,0,0
5823,addkmbdlnabfcbel.website,dga,3.68872,6,17,24,1,0.35294,0.1537,1,0,0,0,1,3,0,0,0,3
1673,api.snapkit.com,legit,3.37356,5,8,15,0,0.625,0.2249,2,1,1,0,4,1,0,0,0,1
3179,instructure.com,legit,3.37356,5,9,15,0,0.55556,0.2249,3,0,0,0,3,4,1,0,0,5
7910,safanwacesd.com,dga,3.32323,5,9,15,1,0.55556,0.22155,2,0,0,0,2,4,0,0,0,4
2381,avs-alexa-14-na.amazon.com,legit,3.61334,9,10,26,0,0.9,0.13897,5,1,3,3,12,4,0,0,0,4
8432,ecrauculur.ddns.net,dga,3.36609,6,11,19,1,0.54545,0.17716,4,1,0,0,5,6,3,2,1,12
5244,cwaeqyeoya.net,dga,3.18201,6,7,14,1,0.85714,0.22729,0,0,0,0,0,0,0,1,0,1
2856,v39.tiktokcdn-us.com,legit,3.82193,4,11,20,0,0.36364,0.1911,5,6,7,6,24,2,0,0,0,2
8361,daekfiqaofboh.ddns.net,dga,3.69785,7,13,22,1,0.53846,0.16808,3,1,0,0,4,4,3,2,2,11
6374,skwamaiugkeq.biz,dga,3.625,6,9,16,1,0.66667,0.22656,2,1,1,0,4,2,0,3,2,7
7921,trdbwyhimvlpxbyl.eu,dga,3.93214,3,15,19,1,0.2,0.20695,0,0,0,0,0,0,0,0,0,0
821,servedby.flashtalking.com,legit,4.24386,6,17,25,0,0.35294,0.16975,5,1,1,0,7,8,3,1,0,12
9466,cdffbofddclblcda.cc,dga,2.75506,2,16,19,1,0.125,0.145,2,0,0,0,2,1,0,0,0,1
6431,withinpower.net,dga,3.24022,5,9,15,1,0.55556,0.21601,2,0,0,0,2,3,0,0,0,3
5768,8nm2d3ecd2uszjzhh2.biz,dga,3.84535,3,13,22,1,0.23077,0.17479,2,0,0,0,2,1,0,0,0,1
5605,avpantpunto.com,dga,3.24022,5,9,15,1,0.55556,0.21601,1,0,0,0,1,1,0,0,0,1
4845,w-x.co,legit,2.58496,1,3,6,0,0.33333,0.43083,0,0,0,0,0,0,0,0,0,0
2839,panther.goguardian.com,legit,3.78875,8,12,22,0,0.66667,0.17222,2,1,0,0,3,3,1,1,0,5
8677,inixwesefo.ddns.net,dga,3.32636,6,11,19,1,0.54545,0.17507,5,1,0,0,6,8,4,3,2,17
6903,yjjekjepikfbpxucpp.com,dga,3.60694,5,16,22,1,0.3125,0.16395,2,0,0,0,2,0,0,0,0,0
5153,temperancejessalyn.net,dga,3.44286,7,14,22,1,0.5,0.15649,5,0,0,0,5,7,2,1,0,10
9985,uutixxdsmufu.pw,dga,3.24022,5,9,15,1,0.55556,0.21601,2,0,0,0,2,1,0,0,0,1
3282,aiv-delivery.net,legit,3.45282,6,8,16,0,0.75,0.2158,2,0,0,0,2,4,1,0,0,5
7990,gnlyv.tn,dga,2.75,0,7,8,1,0.0,0.34375,0,0,0,0,0,0,0,0,0,0
4823,emoji.slack-edge.com,legit,3.68418,7,10,20,0,0.7,0.18421,2,2,1,0,5,5,0,0,0,5
6475,aabodocafnbndcon.info,dga,3.02304,8,12,21,1,0.66667,0.14395,2,1,0,0,3,4,1,0,0,5
6113,kccdebdcakaeakdc.com,dga,2.92821,6,13,20,1,0.46154,0.14641,2,1,0,0,3,3,0,0,0,3
979,static.cloudflareinsights.com,legit,3.92627,9,18,29,0,0.5,0.13539,10,3,3,2,18,11,1,0,0,12
925,winatp-gw-eus.microsoft.com,legit,3.98619,8,15,27,0,0.53333,0.14764,10,8,7,6,31,4,0,0,0,4
5091,iuayqogummwyokek.org,dga,3.58418,8,11,20,1,0.72727,0.17921,0,0,0,0,0,0,0,0,0,0
9282,wihislafaw.com,dga,3.37878,5,8,14,1,0.625,0.24134,0,0,0,0,0,2,0,0,0,2
2836,mcdp-sadc1.outbrain.com,legit,3.88205,6,13,23,0,0.46154,0.16878,5,0,0,0,5,2,0,0,0,2
3136,array608.prod.do.dsp.mp.microsoft.com,legit,3.71259,8,20,37,0,0.4,0.10034,12,12,10,9,43,5,2,0,0,7
7221,zyyfqkcojo.com,dga,3.18201,3,10,14,1,0.3,0.22729,1,0,0,0,1,1,0,0,0,1
7673,factorpentransitiongearsave.com,dga,3.73567,12,18,31,1,0.66667,0.12051,7,1,0,0,8,14,5,1,0,20
3297,pull-flv-l11-va01.tiktokcdn.com,legit,4.00227,5,17,31,0,0.29412,0.12911,4,6,9,9,28,2,0,0,0,2
4807,evoke-windowsservices-tas-msedge-net.e-0009.e-msedge.net,legit,3.8464,17,26,56,0,0.65385,0.06869,9,4,2,1,16,13,2,1,0,16
5048,pujotiqunif.eu,dga,3.32486,7,6,14,1,1.16667,0.23749,1,0,0,0,1,2,0,0,0,2
3739,shavar.services.mozilla.com,legit,3.63397,9,15,27,0,0.6,0.13459,7,2,1,1,11,7,2,1,0,10
4026,wd-prod-ss.trafficmanager.net,legit,3.97833,7,18,29,0,0.38889,0.13718,9,5,2,3,19,6,2,0,0,8
7814,irxdwlpjunfr.org,dga,3.70282,3,12,16,1,0.25,0.23143,0,0,0,0,0,0,0,0,0,0
5379,alexandrinamasterson.net,dga,3.47018,9,14,24,1,0.64286,0.14459,8,2,0,0,10,12,4,0,0,16
3578,ss.epdg.epc.mnc260.mcc310.pub.3gppnetwork.org,legit,4.09694,6,25,45,0,0.24,0.09104,3,0,0,0,3,3,0,0,0,3
425,quantserve.com,legit,3.6645,5,8,14,0,0.625,0.26175,3,1,1,0,5,4,2,1,0,7
4656,iphone-ld.apple.com-v1.edgesuite.net,legit,3.99591,12,17,36,0,0.70588,0.111,14,8,5,3,30,11,3,1,0,15
6080,fyxvgqymu.com.py,dga,3.45282,2,12,16,1,0.16667,0.2158,2,2,1,0,5,2,2,1,0,5
80,teams.events.data.microsoft.com,legit,3.60663,10,17,31,0,0.58824,0.11634,15,9,7,6,37,10,1,0,0,11
847,us-central1-gcp.api.snapchat.com,legit,3.95282,8,18,32,0,0.44444,0.12353,10,3,1,0,14,4,3,0,0,7
4664,com.dual-spo-0003.spo-msedge.net,legit,3.92096,8,14,32,0,0.57143,0.12253,5,4,2,0,11,6,1,0,0,7
3905,cdn.undertone.com,legit,3.21953,5,10,17,0,0.5,0.18938,4,2,1,0,7,6,1,0,0,7
1371,events.data.trafficmanager.net,legit,3.53624,10,17,30,0,0.58824,0.11787,12,4,1,3,20,11,2,0,0,13
9614,kvofstiyikfbttygo.net,dga,3.53517,5,15,21,1,0.33333,0.16834,3,0,0,0,3,2,0,0,0,2
5428,jwmfmpdcvpjqtqsl.eu,dga,3.82687,2,16,19,1,0.125,0.20141,0,0,0,0,0,0,0,0,0,0
811,dsct.akamaiedge.net,legit,3.43162,7,10,19,0,0.7,0.18061,6,5,5,3,19,4,0,0,0,4
3173,filedownload.csw.lenovo.com,legit,3.60232,9,15,27,0,0.6,0.13342,7,0,0,0,7,3,0,0,0,3
6007,propterminniesseilapud.com,dga,3.76718,10,15,26,1,0.66667,0.14489,9,1,0,0,10,8,3,0,0,11
8506,iqcukuwsccgeeyqo.org,dga,3.58418,7,12,20,1,0.58333,0.17921,1,0,0,0,1,1,0,0,0,1
5697,sg4ulf8oocv7bix1pq.cn,dga,4.20184,4,12,21,1,0.33333,0.20009,1,0,0,0,1,0,0,0,0,0
3299,api.ams.gcc.teams.microsoft.com,legit,3.47438,9,17,31,0,0.52941,0.11208,14,9,8,6,37,5,0,0,0,5
3899,weather.microsoft.com.edgekey.net,legit,3.86198,11,18,33,0,0.61111,0.11703,13,13,10,7,43,9,3,2,1,15
6077,inswiqsscc.in,dga,2.66123,3,9,13,1,0.33333,0.20471,1,0,0,0,1,2,0,0,0,2
8277,emqyquttoodw.com,dga,3.32782,5,10,16,1,0.5,0.20799,1,0,0,0,1,1,0,0,0,1
316,history.google.com,legit,3.50326,6,10,18,0,0.6,0.19463,3,5,4,3,15,4,1,0,0,5
9267,redimereabsolutionemet.com,dga,3.65739,12,13,26,1,0.92308,0.14067,6,0,0,0,6,9,4,1,0,14
6158,kettqk.net,dga,2.44644,2,7,10,1,0.28571,0.24464,0,0,0,0,0,1,0,0,0,1
2504,android.pool.ntp.org,legit,3.28418,6,11,20,0,0.54545,0.16421,4,0,0,0,4,2,1,0,0,3
5733,bzenplg.com,dga,3.45943,2,8,11,1,0.25,0.31449,2,0,0,0,2,1,0,0,0,1
7780,natrilka.ru,dga,3.0958,4,6,11,1,0.66667,0.28144,1,0,0,0,1,2,0,0,0,2
2099,edge-web.dual-gslb.spotify.com,legit,4.12323,8,17,30,0,0.47059,0.13744,4,2,1,0,7,4,0,0,0,4
2289,springserve.com,legit,3.50689,4,10,15,0,0.4,0.23379,4,1,1,0,6,5,4,1,0,10
3946,bluebook.app.collegeboard.org,legit,3.52594,11,15,29,0,0.73333,0.12158,9,3,1,0,13,4,1,0,0,5
4510,avatar-a.wbx2.com,legit,3.49923,5,8,17,0,0.625,0.20584,2,0,0,0,2,3,0,0,0,3
4412,rb.adnxs-simple.com,legit,3.93214,4,12,19,0,0.33333,0.20695,5,1,0,0,6,3,0,0,0,3
4265,winatp-gw-cus3.microsoft.com,legit,3.96772,7,16,28,0,0.4375,0.1417,9,8,7,6,30,4,0,0,0,4
2304,goofy-cdn.com,legit,3.18083,3,8,13,0,0.375,0.24468,4,2,0,0,6,1,0,0,0,1
9249,mwqwyoio2s6w.org,dga,3.40564,4,9,16,1,0.44444,0.21285,0,0,0,0,0,0,0,0,0,0
117,time.apple.com,legit,3.23593,5,7,14,0,0.71429,0.23114,7,4,3,2,16,2,0,0,0,2
6071,golffeatureattractplaydig.com,dga,3.8235,10,18,29,1,0.55556,0.13184,5,0,0,0,5,6,2,0,0,8
1788,amazonvideo.com,legit,3.32323,7,7,15,0,1.0,0.22155,3,1,3,2,9,4,0,0,0,4
6594,xuaksdipjmpvrhny.eu,dga,4.0374,5,13,19,1,0.38462,0.21249,0,0,0,0,0,0,0,0,0,0
8449,tradition-ralph.com,dga,3.72161,6,11,19,1,0.54545,0.19587,4,0,0,0,4,4,3,1,0,8
8476,wwxmsyhmtoaf.co.uk,dga,3.72548,4,12,18,1,0.33333,0.20697,2,1,0,0,3,1,1,0,0,2
4681,pushnami.com,legit,3.4183,4,7,12,0,0.57143,0.28486,3,0,0,0,3,2,0,0,0,2
5498,bynfxwndyhpjeozonvzxtugxg.com,dga,4.1592,5,23,29,1,0.21739,0.14342,1,0,0,0,1,2,0,0,0,2
532,b.tlu.dl.delivery.mp.microsoft.com,legit,3.8588,8,20,34,0,0.4,0.11349,11,8,7,7,33,7,1,0,0,8
6476,emqcagmscqqaaquw.org,dga,3.38418,6,13,20,1,0.46154,0.16921,0,0,0,0,0,2,0,0,0,2
8094,state-dozen.net,dga,3.13957,5,8,15,1,0.625,0.2093,5,0,0,0,5,5,1,0,0,6
7577,kkvopwdxypil.net,dga,3.75,3,12,16,1,0.25,0.23438,1,0,0,0,1,0,0,0,0,0
5039,tufuqyp.info,dga,3.25163,4,7,12,1,0.57143,0.27097,0,0,0,0,0,0,0,0,0,0
2634,cloud.acrobat.com,legit,3.29277,6,9,17,0,0.66667,0.19369,7,4,2,1,14,2,0,0,0,2
1728,commnat-cohort-gc.ess.apple.com,legit,3.7442,8,18,31,0,0.44444,0.12078,9,5,3,2,19,6,2,0,0,8
8288,rildugto.ru,dga,3.0958,4,6,11,1,0.66667,0.28144,0,0,0,0,0,1,0,0,0,1
3778,cdnbasket.net,legit,3.2389,3,9,13,0,0.33333,0.24915,2,1,0,0,3,3,0,0,0,3
4097,yap.yahoo.com,legit,2.87314,5,6,13,0,0.83333,0.22101,3,0,0,1,4,0,0,0,0,0
7211,leukjnxiique.com,dga,3.625,7,8,16,1,0.875,0.22656,1,0,0,0,1,1,0,0,0,1
5026,mmggpwhxumpk.biz,dga,3.45282,2,13,16,1,0.15385,0.2158,0,0,0,0,0,0,0,0,0,0
1833,dscg2.akamai.net,legit,3.57782,5,8,16,0,0.625,0.22361,4,3,4,3,14,2,0,0,0,2
2618,array811.prod.do.dsp.mp.microsoft.com,legit,3.65853,8,20,37,0,0.4,0.09888,12,12,10,9,43,5,2,0,0,7
3002,ap-guc3.spotify.com,legit,3.82687,5,10,19,0,0.5,0.20141,2,0,0,0,2,1,0,0,0,1
8362,hwseei.mooo.com,dga,2.97356,7,6,15,1,1.16667,0.19824,3,0,0,0,3,1,1,2,1,5
8848,puvowog.info,dga,3.18872,5,6,12,1,0.83333,0.26573,0,0,0,0,0,0,0,0,0,0
6968,ygmwew.com.co,dga,2.93121,3,8,13,1,0.375,0.22548,2,2,1,0,5,2,2,1,0,5
446,res.cdn.office.net,legit,3.30827,5,10,18,0,0.5,0.18379,9,6,5,3,23,5,1,0,0,6
3682,forester.a2z.com,legit,3.5,5,8,16,0,0.625,0.21875,6,0,0,0,6,6,3,0,0,9
9564,itucrivuhoam.ddns.net,dga,3.82089,7,12,21,1,0.58333,0.18195,4,1,0,0,5,7,3,2,2,14
4469,mmi360.net,legit,3.12193,2,4,10,0,0.5,0.31219,1,0,0,0,1,1,0,0,0,1
9203,mariabellawhittemore.net,dga,3.52206,10,13,24,1,0.76923,0.14675,3,0,0,0,3,11,0,0,0,11
7989,qgknrjsdvp.com,dga,3.80735,1,12,14,1,0.08333,0.27195,0,0,0,0,0,0,0,0,0,0
7598,gqxklrtkydjbaiqchiqgofdmmnnvg.org,dga,4.23364,5,27,33,1,0.18519,0.12829,1,0,0,0,1,0,0,0,0,0
805,gspe1-ssl.ls.apple.com,legit,3.35649,4,13,22,0,0.30769,0.15257,6,4,3,2,15,1,0,0,0,1
4385,rt.udmserve.net,legit,3.1899,4,9,15,0,0.44444,0.21266,2,1,1,0,4,3,2,1,0,6
3942,pull-lls-l11.tiktokcdn.com,legit,3.71545,4,16,26,0,0.25,0.1429,4,6,9,8,27,2,0,0,0,2
6224,tiohexikkuume.ddns.net,dga,3.60694,8,12,22,1,0.66667,0.16395,4,1,0,0,5,5,5,3,2,15
601,rtb-csync.smartadserver.com,legit,3.73601,5,19,27,0,0.26316,0.13837,6,1,1,0,8,6,3,1,0,10
8763,aaoisocykyueukaq.org,dga,3.54644,10,9,20,1,1.11111,0.17732,0,0,0,0,0,1,0,0,0,1
7867,kelumehoxoug.ddns.net,dga,3.6897,7,12,21,1,0.58333,0.1757,3,1,0,0,4,5,3,3,2,13
3338,pixel.rubiconproject.net.akadns.net,legit,3.96486,11,20,35,0,0.55,0.11328,9,5,4,3,21,9,3,0,0,12
9758,penitenspossintitsurface.com,dga,3.62809,10,17,28,1,0.58824,0.12957,6,0,0,0,6,11,0,0,0,11
3075,gql.reddit.com,legit,3.52164,3,9,14,0,0.33333,0.25155,2,0,0,0,2,4,0,0,0,4
3489,winatp-gw-eus3.microsoft.com,legit,4.06611,8,15,28,0,0.53333,0.14522,9,8,7,6,30,4,0,0,0,4
9369,naretuk.info,dga,3.4183,5,6,12,1,0.83333,0.28486,1,0,0,0,1,3,0,0,0,3
1396,prod.webservices.mozgcp.net,legit,3.91211,7,17,27,0,0.41176,0.14489,10,5,3,2,20,5,3,1,0,9
8693,ytexsqkckv.com,dga,3.52164,2,11,14,1,0.18182,0.25155,1,0,0,0,1,1,0,0,0,1
9139,fsluen.com.py,dga,3.54659,3,8,13,1,0.375,0.27281,3,2,1,0,6,3,2,1,0,6
9250,reconciliaturrelecclest.com,dga,3.45417,10,16,27,1,0.625,0.12793,8,1,0,0,9,9,3,0,0,12
1204,au.download.windowsupdate.com,legit,3.67644,11,15,29,0,0.73333,0.12677,7,0,0,0,7,6,1,0,0,7
4943,tm-2.office.com,legit,3.24022,4,7,15,0,0.57143,0.21601,3,4,4,3,14,2,0,0,0,2
3818,ads.tremorhub.com,legit,3.61687,5,10,17,0,0.5,0.21276,5,0,0,0,5,3,0,0,0,3
7081,adfxcrwkvjdl.co.uk,dga,3.72548,3,13,18,1,0.23077,0.20697,4,1,0,0,5,1,1,0,0,2
2902,a.a47b.com,legit,2.92193,3,3,10,0,1.0,0.29219,1,0,0,0,1,0,0,0,0,0
4725,twitter.map.fastly.net,legit,3.53377,5,14,22,0,0.35714,0.16063,7,1,0,0,8,6,1,0,0,7
2950,onedscolprdcus01.centralus.cloudapp.azure.com,legit,3.91643,14,25,45,0,0.56,0.08703,19,5,3,4,31,8,3,0,0,11
7532,wuvutoju.ru,dga,2.73216,5,5,11,1,1.0,0.24838,0,0,0,0,0,0,0,0,0,0
8947,kkwgxmnansnan.com,dga,3.26393,3,13,17,1,0.23077,0.192,0,0,0,0,0,2,2,4,3,11
9537,keicoqga.ru,dga,3.45943,5,5,11,1,1.0,0.31449,2,0,0,0,2,2,0,0,0,2
8576,qdoja67rsx3nuxm0qdg.ddns.net,dga,4.06611,4,18,28,1,0.22222,0.14522,2,1,0,0,3,4,3,3,2,12
6490,ppjfdvxywwq.dynserv.com,dga,4.00182,2,19,23,1,0.10526,0.17399,4,1,1,0,6,4,5,5,4,18
7640,hsybxjuuhiv.dynserv.com,dga,4.00182,5,16,23,1,0.3125,0.17399,3,1,1,0,5,4,5,5,4,18
9060,jqenhutlenoj.ru,dga,3.37356,5,9,15,1,0.55556,0.2249,2,0,0,0,2,2,0,0,0,2
5890,betterboard.net,dga,3.00624,5,9,15,1,0.55556,0.20042,2,0,0,0,2,5,1,0,0,6
8831,gxnkkxvjdwmmomvji.su,dga,3.68418,3,16,20,1,0.1875,0.18421,0,0,0,0,0,1,0,0,0,1
5342,fmtc.co.nz,dga,2.92193,1,7,10,1,0.14286,0.29219,2,1,0,0,3,1,1,0,0,2
1182,unity3d.com,legit,3.45943,3,6,11,0,0.5,0.31449,0,0,0,0,0,2,0,0,0,2
4361,datto.com,legit,2.72548,3,5,9,0,0.6,0.30283,1,0,0,0,1,1,0,0,0,1
2009,data.grammarly.com,legit,3.2391,5,11,18,0,0.45455,0.17995,5,0,0,0,5,6,0,0,0,6
691,mozilla.com,legit,2.91398,4,6,11,0,0.66667,0.26491,0,0,0,0,0,1,0,0,0,1
9559,ixw27bul5rkv1v3rgno0a0y.ddns.net,dga,4.53891,5,18,32,1,0.27778,0.14184,2,1,0,0,3,4,3,2,2,11
9504,tiivamelvewxrwmk.eu,dga,3.57662,7,11,19,1,0.63636,0.18824,2,0,0,0,2,4,0,0,0,4
3279,api.hubapi.com,legit,3.23593,6,6,14,0,1.0,0.23114,2,1,1,0,4,0,0,0,0,0
3259,imdb.com,legit,2.75,2,5,8,0,0.4,0.34375,0,0,0,0,0,0,0,0,0,0
1045,pull-flv-l16-va01.tiktokcdn.com,legit,4.09114,5,17,31,0,0.29412,0.13197,4,6,9,9,28,2,0,0,0,2
3385,redditmedia.com,legit,3.1899,6,8,15,0,0.75,0.21266,2,0,0,0,2,4,0,0,0,4
1969,a2047.w181.akamai.net,legit,3.6897,6,5,21,0,1.2,0.1757,3,3,4,3,13,2,0,0,0,2
8252,propotestatemepis.com,dga,3.29615,8,12,21,1,0.66667,0.15696,8,1,0,0,9,7,3,0,0,10
2851,auth.split.io,legit,3.2389,5,6,13,0,0.83333,0.24915,2,0,0,0,2,1,0,0,0,1
1398,r.casalemedia.com,legit,3.33718,7,8,17,0,0.875,0.1963,3,0,0,0,3,5,0,0,0,5
9251,fkaldcfkokblodfn.com,dga,3.30869,4,15,20,1,0.26667,0.16543,1,0,0,0,1,0,0,0,0,0
9579,esdatawn.com,dga,3.4183,4,7,12,1,0.57143,0.28486,3,0,0,0,3,3,0,0,0,3
8902,m8m4iguoe86w.net,dga,3.625,5,6,16,1,0.83333,0.22656,0,0,0,0,0,0,0,0,0,0
1688,bam-cell.nr-data.net,legit,3.48418,5,11,20,0,0.45455,0.17421,4,0,0,0,4,5,0,0,0,5
1699,winatp-gw-weu.microsoft.com,legit,3.95823,8,15,27,0,0.53333,0.1466,8,8,7,6,29,4,0,0,0,4
7331,itdgwxyvsrqn.ru,dga,3.77356,2,12,15,1,0.16667,0.25157,0,0,0,0,0,1,0,0,0,1
7231,spirits-headquarters.pk,dga,3.67531,7,14,23,1,0.5,0.1598,5,0,0,0,5,6,2,0,0,8
5687,nqlxpudllsmprul.info,dga,3.62193,4,15,20,1,0.26667,0.1811,1,0,0,0,1,0,0,0,0,0
7556,aygulwiq.info,dga,3.54659,5,7,13,1,0.71429,0.27281,0,0,0,0,0,0,0,0,0,0
8539,gatyhab.com,dga,3.27761,3,7,11,1,0.42857,0.29796,1,0,0,0,1,1,0,0,0,1
6264,organizationmarchgrasszone.com,dga,3.65656,11,18,30,1,0.61111,0.12189,5,0,0,0,5,11,5,2,1,19
136,e673.dsce9.akamaiedge.net,legit,3.71908,9,9,25,0,1.0,0.14876,8,5,5,3,21,6,0,0,0,6
7451,dkfdckbobofcocac.website,dga,3.52206,7,16,24,1,0.4375,0.14675,2,0,0,0,2,3,0,0,0,3
4446,a-iad.1rx.io,legit,3.08496,5,3,12,0,1.66667,0.25708,2,0,0,0,2,0,0,0,0,0
3648,p.adsymptotic.com,legit,3.38158,4,11,17,0,0.36364,0.19892,6,0,0,0,6,2,0,0,0,2
9642,efzycvcfgquugyctn.com,dga,3.63041,4,16,21,1,0.25,0.17288,0,0,0,0,0,0,0,0,0,0
9400,flnvlcoppfyuqxrp.eu,dga,3.68188,4,14,19,1,0.28571,0.19378,2,0,0,0,2,1,0,0,0,1
857,pbs.twimg.com,legit,3.39275,2,9,13,0,0.22222,0.26098,2,0,0,0,2,0,0,0,0,0
1412,symcb.com,legit,2.72548,1,7,9,0,0.14286,0.30283,0,0,0,0,0,0,0,0,0,0
5441,nacaddufeng.com,dga,3.37356,5,9,15,1,0.55556,0.2249,2,0,0,0,2,4,0,0,0,4
7132,madunufqbex.org,dga,3.77356,5,9,15,1,0.55556,0.25157,2,0,0,0,2,2,3,2,2,9
6133,idknlf.tv,dga,3.16993,1,7,9,1,0.14286,0.35221,0,0,0,0,0,0,0,0,0,0
6770,doofivcad.ddns.net,dga,3.39215,5,11,18,1,0.45455,0.18845,6,1,0,0,7,5,3,2,1,11
2409,static.yieldmo.com,legit,3.50326,6,10,18,0,0.6,0.19463,5,0,0,0,5,6,1,0,0,7
5585,cfsrg8wnshqp5r7.ddns.net,dga,3.93872,1,18,24,1,0.05556,0.16411,2,1,0,0,3,4,3,3,2,12
7335,gucolsifeww.com,dga,3.50689,5,9,15,1,0.55556,0.23379,1,0,0,0,1,2,0,0,0,2
26,office365.com,legit,3.2389,4,5,13,0,0.8,0.24915,3,4,3,2,12,2,0,0,0,2
2256,22-courier.push.apple.com,legit,3.78347,8,11,25,0,0.72727,0.15134,9,4,3,2,18,4,0,0,0,4
9521,50olat7balqtu6ercti8wfq.ddns.net,dga,4.3125,7,18,32,1,0.38889,0.13477,5,1,0,0,6,8,3,3,2,16
4890,grey.erne.co,legit,2.85539,4,6,12,0,0.66667,0.23795,2,0,0,0,2,3,0,0,0,3
4694,scheduler.teams.microsoft.com,legit,3.73628,9,17,29,0,0.52941,0.12884,14,8,7,6,35,8,0,0,0,8
4264,www.civicscience.com,legit,3.06596,6,12,20,0,0.5,0.1533,4,0,0,0,4,3,1,1,0,5
7764,pumopop.info,dga,2.79248,5,6,12,1,0.83333,0.23271,0,0,0,0,0,0,0,0,0,0
5083,omwaetvue.ddns.net,dga,3.46132,6,10,18,1,0.6,0.1923,3,1,0,0,4,6,4,3,2,15
7415,interdicitur.com,dga,3.32782,6,9,16,1,0.66667,0.20799,5,0,0,0,5,5,2,1,0,8
4781,adventori.com,legit,3.54659,5,7,13,0,0.71429,0.27281,3,1,0,0,4,4,1,0,0,5
8319,mtbwf32m59cqaxdsm69f32brdrdvayi35aze11.com,dga,4.48125,6,23,42,1,0.26087,0.1067,1,0,0,0,1,0,0,0,0,0
7934,xixehrncdqkotrjti.net,dga,3.6897,5,15,21,1,0.33333,0.1757,2,0,0,0,2,1,0,0,0,1
9903,agitequremissionemlutp.com,dga,3.84411,11,14,26,1,0.78571,0.14785,4,0,0,0,4,9,2,0,0,11
4876,wamsm-a-2.prod.infra.webex.com,legit,3.9899,8,15,30,0,0.53333,0.133,6,4,3,2,15,4,2,0,0,6
5616,gqyuyiooowgoucqi.org,dga,3.1037,9,10,20,1,0.9,0.15518,2,0,0,0,2,0,1,0,0,1
8462,uehcginkphgg.ru,dga,3.32323,4,10,15,1,0.4,0.22155,1,0,0,0,1,1,0,0,0,1
8209,saltspenddumpdeterminecream.com,dga,3.71663,10,20,31,1,0.5,0.11989,9,0,0,0,9,14,2,0,0,16
2193,dbankcloud.com,legit,3.37878,4,9,14,0,0.44444,0.24134,2,3,2,1,8,1,0,0,0,1
2423,mapbox.com,legit,2.92193,3,6,10,0,0.5,0.29219,2,0,0,0,2,1,0,0,0,1
1730,nel.goog,legit,2.5,3,4,8,0,0.75,0.3125,0,0,0,0,0,2,0,0,0,2
7408,eaaoclakkeamedab.com,dga,3.1037,10,9,20,1,1.11111,0.15518,3,0,0,0,3,4,0,0,0,4
369,waconatm.officeapps.live.com,legit,3.77094,10,15,28,0,0.66667,0.13468,11,6,4,3,24,8,1,0,0,9
1497,api.intentiq.com,legit,3.32782,6,8,16,0,0.75,0.20799,7,2,1,0,10,4,1,1,0,6
9822,dyukxfjxeplfbnhb.com,dga,4.02193,3,16,20,1,0.1875,0.2011,1,0,0,0,1,0,0,0,0,0
1314,bitmoji.com,legit,2.91398,4,6,11,0,0.66667,0.26491,0,0,0,0,0,1,0,0,0,1
6866,q87j3nuoz4m7jaf733.biz,dga,3.84535,4,9,22,1,0.44444,0.17479,0,0,0,0,0,0,0,0,0,0
3118,andbeyond.media,legit,3.1899,6,8,15,0,0.75,0.21266,1,0,0,0,1,4,1,0,0,5
9873,gdhiwlblcaoxrm.pw,dga,3.85217,3,13,17,1,0.23077,0.2266,0,0,0,0,0,1,0,0,0,1
4610,mobile.zscaler.net,legit,3.68354,6,10,18,0,0.6,0.20464,3,0,0,0,3,3,0,0,0,3
1747,jamfcloud.com,legit,3.2389,4,8,13,0,0.5,0.24915,3,3,2,1,9,1,0,0,0,1
242,pubmatic.com,legit,3.25163,4,7,12,0,0.57143,0.27097,4,0,0,0,4,4,1,0,0,5
1353,hbx.media.net,legit,3.39275,4,7,13,0,0.57143,0.26098,2,0,0,0,2,1,0,0,0,1
1658,l.betrad.com,legit,3.4183,3,7,12,0,0.42857,0.28486,2,0,0,0,2,3,1,0,0,4
327,nam.loki.delve.office.com,legit,3.54347,9,12,25,0,0.75,0.14174,7,4,4,3,18,7,1,0,0,8
7470,goxqor.com.gh,dga,3.02699,3,8,13,1,0.375,0.23285,2,2,1,0,5,3,2,1,0,6
2528,worldfcdn2.com,legit,3.37878,2,10,14,0,0.2,0.24134,2,1,0,0,3,2,0,0,0,2
6690,therapyexhibition.su,dga,3.78418,8,11,20,1,0.72727,0.18921,5,0,0,0,5,5,3,2,0,10
4138,1d.tlu.dl.delivery.mp.microsoft.com,legit,3.85702,8,20,35,0,0.4,0.1102,12,8,7,7,34,7,1,0,0,8
7053,poepfuoxami.ddns.net,dga,3.72193,7,11,20,1,0.63636,0.1861,4,1,0,0,5,6,4,3,2,15
5899,vjgpcrpcc.com,dga,2.93121,1,11,13,1,0.09091,0.22548,1,0,0,0,1,0,0,0,0,0
8871,dvcpwsoqrphjan.com,dga,3.83659,3,14,18,1,0.21429,0.21314,0,0,0,0,0,1,0,0,0,1
4246,ts01-gyr-maverick.cloudsink.net,legit,4.30904,7,18,31,0,0.38889,0.139,8,3,3,2,16,7,2,0,0,9
8505,e31oyf12byo11m29n40kzp52c29fwjtg53ouowix.org,dga,4.51376,8,19,44,1,0.42105,0.10259,1,0,0,0,1,0,0,0,0,0
846,maxcdn.bootstrapcdn.com,legit,3.58835,5,16,23,0,0.3125,0.15602,7,2,1,0,10,4,1,0,0,5
129,browser.pipe.aria.microsoft.com,legit,3.63952,11,16,31,0,0.6875,0.1174,11,9,7,6,33,6,1,0,0,7
7878,klhqeyfaflokqqsko.su,dga,3.44644,5,14,20,1,0.35714,0.17232,1,0,0,0,1,0,0,0,0,0
6683,temhosjjrcini.com,dga,3.49923,5,11,17,1,0.45455,0.20584,2,0,0,0,2,4,0,0,0,4
1455,conversions.appsflyer.com,legit,3.78347,7,16,25,0,0.4375,0.15134,7,3,1,0,11,6,4,0,0,10
6715,46gfypffuuasknujay.ru,dga,3.59447,6,12,21,1,0.5,0.17117,0,0,0,0,0,1,0,0,0,1
1076,config.extension.grammarly.com,legit,3.87291,9,18,30,0,0.5,0.1291,7,1,0,0,8,10,2,0,0,12
6823,gwybnalfe.tw,dga,3.4183,2,9,12,1,0.22222,0.28486,0,0,0,0,0,0,0,0,0,0
8669,gaduceba.info,dga,3.54659,6,6,13,1,1.0,0.27281,2,0,0,0,2,1,0,0,0,1
4928,launcher.spot.im,legit,3.875,5,9,16,0,0.55556,0.24219,1,0,0,0,1,2,1,0,0,3
4193,a5.behance.net,legit,3.03915,5,6,14,0,0.83333,0.21708,1,0,0,0,1,3,1,1,0,5
8961,ogafdarwat.com,dga,3.32486,5,8,14,1,0.625,0.23749,1,0,0,0,1,2,0,0,0,2
5544,3lolg2i0mpyb3n1du03.ddns.net,dga,4.08362,4,15,28,1,0.26667,0.14584,3,1,0,0,4,4,3,2,2,11
3067,com.akamaized.net,legit,3.45482,7,8,17,0,0.875,0.20322,5,5,6,6,22,5,1,0,0,6
983,socdm.com,legit,2.50326,2,6,9,0,0.33333,0.27814,1,0,0,0,1,0,0,0,0,0
9167,ywdeucuiwcymao.info,dga,3.61635,8,10,19,1,0.8,0.19033,1,0,0,0,1,2,0,5,4,11
9363,evangelinamalandra.net,dga,3.26104,9,12,22,1,0.75,0.14823,6,1,0,0,7,9,1,0,0,10
409,peoplestackwebexperiments-pa.clients6.google.com,legit,4.048,16,27,48,0,0.59259,0.08433,11,7,4,3,25,9,4,0,0,13
2838,identity.ess.apple.com,legit,3.66353,7,12,22,0,0.58333,0.16652,10,5,3,2,20,6,2,0,0,8
4389,az667904.vo.msecnd.net,legit,3.97057,4,9,22,0,0.44444,0.18048,2,0,0,0,2,3,0,0,0,3
9788,doubneither.net,dga,3.32323,6,8,15,1,0.75,0.22155,2,0,0,0,2,3,1,1,0,5
4739,tm.v4.a.prd.aadg.trafficmanager.net,legit,3.62845,9,19,35,0,0.47368,0.10367,10,4,1,3,18,6,1,0,0,7
3977,apps.apis.classlink.com,legit,3.29466,6,14,23,0,0.42857,0.14325,8,3,0,0,11,4,1,0,0,5
2661,scene7.com,legit,2.92193,3,5,10,0,0.6,0.29219,2,0,0,0,2,3,0,0,0,3
7468,batcupan.ru,dga,3.0958,4,6,11,1,0.66667,0.28144,1,0,0,0,1,2,0,0,0,2
4668,cph.liveintent.com,legit,3.50326,5,11,18,0,0.45455,0.19463,5,1,0,0,6,4,1,1,0,6
1754,player.vimeo.com,legit,3.5,6,8,16,0,0.75,0.21875,2,0,0,0,2,2,0,0,0,2
1798,iecvlist.microsoft.com,legit,3.4474,7,13,22,0,0.53846,0.1567,8,8,7,6,29,5,1,0,0,6
4462,api-glb-ause2c.smoot.apple.com,legit,3.87291,10,14,30,0,0.71429,0.1291,9,5,3,2,19,2,0,0,0,2
5293,shbxecshjjy.eu,dga,3.23593,3,10,14,1,0.3,0.23114,0,0,0,0,0,1,0,0,0,1
4326,pbp.gysm.yahoodns.net,legit,3.6897,4,14,21,0,0.28571,0.1757,3,1,0,1,5,2,1,0,0,3
7201,otrxsm4lwb72lexq7l.com,dga,3.87966,3,14,22,1,0.21429,0.17635,1,0,0,0,1,1,0,0,0,1
9708,tmomqxu.tv,dga,2.92193,2,7,10,1,0.28571,0.29219,0,0,0,0,0,1,0,0,0,1
8730,olfewmhhagan.com,dga,3.5,5,10,16,1,0.5,0.21875,0,0,0,0,0,1,0,0,0,1
8971,ijtpptqbyfcfcfhvulw.com,dga,3.93618,3,19,23,1,0.15789,0.17114,1,0,0,0,1,0,0,0,0,0
8474,wttctmicaligeh.biz,dga,3.53049,5,12,18,1,0.41667,0.19614,4,1,0,0,5,4,0,0,0,4
435,peoplestack-pa.clients6.google.com,legit,3.82218,11,18,34,0,0.61111,0.11242,10,7,4,3,24,6,2,0,0,8
4755,www.zillow.com,legit,2.80735,3,9,14,0,0.33333,0.20052,1,0,0,0,1,0,0,0,0,0
5454,gentlebicycle.net,dga,3.14629,5,11,17,1,0.45455,0.18508,5,1,0,0,6,4,1,0,0,5
2582,pull-cmaf-l10-gcp01.tiktokcdn.com.rocket-cdn.com,legit,4.07098,8,28,48,0,0.28571,0.08481,8,10,12,10,40,6,2,1,0,9
1573,adswizz.com,legit,3.27761,3,7,11,0,0.42857,0.29796,2,0,0,0,2,0,0,0,0,0
3189,cl3-cdn.origin-apple.com.akadns.net,legit,4.00043,9,19,35,0,0.47368,0.1143,12,11,10,9,42,8,3,1,0,12
5194,mhq0qh1lojkrm8e4cdm6m2a.ddns.net,dga,4.28891,4,20,32,1,0.2,0.13403,4,1,0,0,5,4,4,3,2,13
8907,lulavumo.ru,dga,2.84535,5,5,11,1,1.0,0.25867,0,0,0,0,0,1,0,0,0,1
5677,qecgaodsholapet.org,dga,3.68188,7,11,19,1,0.63636,0.19378,2,0,0,0,2,3,0,5,5,13
7008,degogoenbog.ddns.net,dga,3.03321,6,12,20,1,0.5,0.15166,3,1,0,0,4,6,3,3,2,14
8439,exrcormpr.cd,dga,3.02206,2,9,12,1,0.22222,0.25184,2,0,0,0,2,2,0,0,0,2
2794,braze-images.com,legit,3.625,6,8,16,0,0.75,0.22656,4,1,0,0,5,4,0,0,0,4
4344,cdn.privacy-mgmt.com,legit,3.74644,3,14,20,0,0.21429,0.18732,3,3,1,0,7,3,0,0,0,3
2843,clmbtech.com,legit,3.02206,2,9,12,0,0.22222,0.25184,1,0,0,0,1,2,0,0,0,2
1513,privacymanager.io,legit,3.57247,7,9,17,0,0.77778,0.21015,4,1,0,3,8,6,0,1,0,7
972,shell.cdn.office.net,legit,3.44644,5,12,20,0,0.41667,0.17232,6,6,5,3,20,4,0,0,0,4
7199,myuggsmgagwqesyg.org,dga,3.24644,4,15,20,1,0.26667,0.16232,1,0,0,0,1,1,0,0,0,1
6033,soapdelaware.ru,dga,3.32323,7,7,15,1,1.0,0.22155,2,0,0,0,2,5,0,0,0,5
2079,xgapromomanager-pa.googleapis.com,legit,3.62836,13,17,33,0,0.76471,0.10995,10,8,4,7,29,8,1,0,0,9
2840,musicstatus.edge-itunes-apple.com.akadns.net,legit,3.89741,15,23,44,0,0.65217,0.08858,19,11,10,9,49,15,3,1,0,19
371,ajax.googleapis.com,legit,3.53689,8,9,19,0,0.88889,0.18615,5,6,4,4,19,3,0,0,0,3
9563,icyuxaafyuvawsdri.pw,dga,3.68418,7,12,20,1,0.58333,0.18421,1,0,0,0,1,2,0,0,0,2
7721,renitdah.com,dga,3.58496,4,7,12,1,0.57143,0.29875,2,0,0,0,2,4,0,0,0,4
5918,qmmmmgeoya.net,dga,3.09307,4,9,14,1,0.44444,0.22093,1,0,0,0,1,1,0,1,0,2
6037,forgetindeed.net,dga,3.125,6,9,16,1,0.66667,0.19531,4,0,0,0,4,8,0,0,0,8
9418,eqkkbwnansnan.cc,dga,3.125,3,12,16,1,0.25,0.19531,0,0,0,0,0,2,2,4,3,11
5883,remaneretvicarioitem.com,dga,3.32393,11,12,24,1,0.91667,0.1385,5,0,0,0,5,13,1,0,0,14
531,s.yimg.com,legit,2.92193,2,6,10,0,0.33333,0.29219,1,0,0,0,1,0,0,0,0,0
8647,qdrbbxayolnswak.net,dga,3.93214,4,14,19,1,0.28571,0.20695,0,0,0,0,0,1,0,0,0,1
5139,bejlmmwvfoxxtlnb.eu,dga,3.72161,4,14,19,1,0.28571,0.19587,0,0,0,0,0,1,0,0,0,1
1346,disc501.prod.do.dsp.mp.microsoft.com,legit,3.55495,7,20,36,0,0.35,0.09875,11,12,10,9,42,4,2,0,0,6
4378,tm.lg.prod.aadmsa.trafficmanager.net,legit,3.74259,10,21,36,0,0.47619,0.10396,11,7,4,5,27,6,2,0,0,8
4019,userway.org,legit,3.27761,4,6,11,0,0.66667,0.29796,3,1,0,0,4,2,1,0,0,3
5566,peohpwogwhcjce.tj,dga,3.26393,4,12,17,1,0.33333,0.192,1,0,0,0,1,1,0,0,0,1
7594,tbc7ascyrtw8t5zsxj.net,dga,3.91398,2,16,22,1,0.125,0.17791,0,0,0,0,0,1,0,0,0,1
5476,ygtapuucvm.com,dga,3.37878,4,9,14,1,0.44444,0.24134,2,0,0,0,2,1,0,0,0,1
4967,cs11.wpc.v0cdn.net,legit,3.41938,1,11,18,0,0.09091,0.18997,2,1,0,0,3,1,0,0,0,1
2478,turing-writingassistance.edge.microsoft.com,legit,3.91711,14,25,43,0,0.56,0.0911,14,10,8,6,38,15,6,1,0,22
8787,aacccieauywcyskq.org,dga,3.58418,7,12,20,1,0.58333,0.17921,1,0,0,0,1,2,0,0,0,2
3859,s.bytefcdn-oversea.com,legit,3.87966,6,13,22,0,0.46154,0.17635,7,1,0,0,8,6,3,0,0,9
2166,pull-a5-sg01.tiktokcdn.com.c.bytefcdn-oversea.com,legit,4.40075,11,27,49,0,0.40741,0.08981,10,10,12,10,42,9,5,1,0,15
6217,pwbedkjslrrq.com,dga,3.875,2,13,16,1,0.15385,0.24219,1,0,0,0,1,2,0,0,0,2
9944,4j2jh84l2t2b5qgddu.net,dga,3.87966,2,12,22,1,0.16667,0.17635,0,0,0,0,0,1,0,0,0,1
6150,separationfinished.kr,dga,3.6897,8,12,21,1,0.66667,0.1757,7,0,0,0,7,10,3,2,1,16
537,1rx.io,legit,2.58496,2,2,6,0,1.0,0.43083,0,0,0,0,0,0,0,0,0,0
965,meraki.com,legit,3.12193,4,5,10,0,0.8,0.31219,2,0,0,0,2,2,0,0,0,2
6278,jbyeeqocymfbab.jp,dga,3.45482,4,12,17,1,0.33333,0.20322,0,0,0,0,0,0,0,0,0,0
6586,moriukeffasaaha.ddns.net,dga,3.75163,9,13,24,1,0.69231,0.15632,2,1,0,0,3,7,4,3,2,16
1804,revcontent.com,legit,3.09307,4,9,14,0,0.44444,0.22093,6,2,0,0,8,5,2,0,0,7
6310,vendossibusseccl.com,dga,3.48418,6,13,20,1,0.46154,0.17421,3,0,0,0,3,6,0,0,0,6
5301,fcfccmfdefdaflbd.cc,dga,2.7756,2,16,19,1,0.125,0.14608,0,0,0,0,0,1,0,0,0,1
3079,login.msa.msidentity.com,legit,3.65727,7,14,24,0,0.5,0.15239,6,1,0,0,7,6,1,0,0,7
6378,qegoheg.info,dga,3.08496,5,6,12,1,0.83333,0.25708,0,0,0,0,0,0,0,0,0,0
8825,jepnlocab.com,dga,3.39275,4,8,13,1,0.5,0.26098,1,0,0,0,1,1,0,0,0,1
3573,wordpress.com,legit,3.2389,3,9,13,0,0.33333,0.24915,3,0,0,0,3,3,2,0,0,5
6043,urisecapixiluh.ddns.net,dga,3.79509,8,13,23,1,0.61538,0.165,5,2,0,0,7,9,4,2,2,17
5288,6w6cqsqsekag.org,dga,3.5,3,10,16,1,0.3,0.21875,1,0,0,0,1,1,0,0,0,1
4399,com.v.aaplimg.com,legit,3.17512,5,9,17,0,0.55556,0.18677,5,2,1,0,8,2,1,0,0,3
4177,en25.com,legit,3.0,2,3,8,0,0.66667,0.375,1,0,0,0,1,1,0,0,0,1
2596,bam.cell.nr-data.net,legit,3.44644,5,11,20,0,0.45455,0.17232,5,0,0,0,5,5,0,0,0,5
3334,config.unityads.unity3d.com,legit,3.78212,8,15,27,0,0.53333,0.14008,5,1,0,0,6,4,1,0,0,5
8824,rhcfbhxwyh.com,dga,3.32486,1,12,14,1,0.08333,0.23749,0,0,0,0,0,0,0,0,0,0
8293,tnngbavujkuyiukrwmk.com,dga,3.93618,6,16,23,1,0.375,0.17114,0,0,0,0,0,0,0,0,0,0
5175,leokeaja.ru,dga,3.0958,6,4,11,1,1.5,0.28144,2,0,0,0,2,2,0,0,0,2
4244,us1.roaming1.live.com.akadns.net,legit,3.96502,10,15,32,0,0.66667,0.12391,12,6,7,8,33,8,4,1,0,13
5462,filsihux.ru,dga,3.0958,4,6,11,1,0.66667,0.28144,0,0,0,0,0,1,0,0,0,1
4709,ads.inmobi.com,legit,3.23593,5,7,14,0,0.71429,0.23114,4,0,0,0,4,1,0,0,0,1
4942,ooc.tm-2.office.com,legit,3.11583,6,8,19,0,0.75,0.16399,5,4,4,3,16,2,0,0,0,2
804,bcp.crwdcntrl.net,legit,3.33718,1,14,17,0,0.07143,0.1963,4,0,0,0,4,0,0,0,0,0
1187,www.cisco.com,legit,2.66123,3,8,13,0,0.375,0.20471,2,0,0,0,2,2,0,0,0,2
9915,upgrading-knowledge.net,dga,3.8164,7,14,23,1,0.5,0.16593,6,2,1,0,9,5,1,0,0,6
3840,e4686.dsca.akamaiedge.net,legit,3.65366,9,9,25,0,1.0,0.14615,7,5,5,3,20,6,0,0,0,6
6322,odohdpwfvfud.com,dga,3.28064,4,11,16,1,0.36364,0.20504,0,0,0,0,0,0,0,0,0,0
5797,indicationlecturesellstrain.com,dga,3.67115,12,18,31,1,0.66667,0.11842,11,0,0,0,11,15,6,2,1,24
6275,rentcopywriteriskplanground.com,dga,4.06678,9,21,31,1,0.42857,0.13119,9,1,0,0,10,11,4,0,0,15
9895,fijeatur.ru,dga,3.0958,5,5,11,1,1.0,0.28144,2,0,0,0,2,2,1,0,0,3
6765,hgnnzyw.ru,dga,3.12193,1,8,10,1,0.125,0.31219,0,0,0,0,0,0,0,0,0,0
5423,pufcxhcopv.com,dga,3.18201,3,10,14,1,0.3,0.22729,1,0,0,0,1,1,0,0,0,1
3826,eu.criteo.com,legit,3.08506,6,5,13,0,1.2,0.23731,3,0,0,0,3,3,0,0,0,3
9509,rjoaedu.com,dga,3.27761,5,5,11,1,1.0,0.29796,1,0,0,0,1,1,0,0,0,1
9502,vadgcwrubkuhirds.eu,dga,3.78714,6,12,19,1,0.5,0.19932,2,0,0,0,2,0,0,0,0,0
2933,onedscolprdcus12.centralus.cloudapp.azure.com,legit,3.91643,14,25,45,0,0.56,0.08703,19,5,3,4,31,8,3,0,0,11
1830,w.org,legit,2.32193,1,3,5,0,0.33333,0.46439,0,0,0,0,0,0,0,0,0,0
6660,5bba2n87tb67rr8831.ru,dga,3.61781,2,8,21,1,0.25,0.17228,0,0,0,0,0,0,0,0,0,0
7572,treeaddstaffcatchnervepick.com,dga,3.85656,9,20,30,1,0.45,0.12855,10,0,0,0,10,11,1,0,0,12
1906,pitaya-task.us.tiktokv.com,legit,3.61334,8,14,26,0,0.57143,0.13897,6,5,4,3,18,4,1,0,0,5
8423,sxbdxixxsp.dynserv.com,dga,3.69785,3,17,22,1,0.17647,0.16808,4,1,1,0,6,4,5,5,4,18
1684,worldfcdn.com,legit,3.2389,2,10,13,0,0.2,0.24915,2,1,0,0,3,2,0,0,0,2
3165,api.pinterest.com,legit,3.49923,6,9,17,0,0.66667,0.20584,9,1,1,0,11,6,4,1,0,11
9156,fwtbomn.ae,dga,3.32193,3,6,10,1,0.5,0.33219,0,0,0,0,0,1,0,0,0,1
9030,uhaxkl50k2cb3bcfadu01d7.ddns.net,dga,4.25,5,18,32,1,0.27778,0.13281,3,1,0,0,4,4,3,3,2,12
8422,lkglmgaynpixwcfqi.tw,dga,3.92193,3,16,20,1,0.1875,0.1961,1,0,0,0,1,0,0,0,0,0
74,dsp.mp.microsoft.com,legit,3.30869,4,13,20,0,0.30769,0.16543,8,8,7,7,30,2,0,0,0,2
5277,gcvmik.info,dga,3.27761,3,7,11,1,0.42857,0.29796,1,0,0,0,1,1,0,0,0,1
8760,mpengtcnwd.yi.org,dga,3.73452,3,12,17,1,0.25,0.21968,2,0,0,0,2,1,0,0,0,1
1650,oscs.protection.outlook.com,legit,3.42466,10,14,27,0,0.71429,0.12684,9,2,1,0,12,4,3,1,1,9
5002,txumyqrubwutbb.cc,dga,3.29277,3,13,17,1,0.23077,0.19369,0,0,0,0,0,0,0,0,0,0
5764,wjoipwnansnan.org,dga,3.26393,5,11,17,1,0.45455,0.192,0,0,0,0,0,2,2,4,3,11
5154,iamvinecessdeiplenitem.com,dga,3.53257,11,14,26,1,0.78571,0.13587,8,1,0,0,9,13,2,0,0,15
1742,aadg.akadns.net,legit,2.97356,5,8,15,0,0.625,0.19824,3,3,4,3,13,2,1,0,0,3
9909,qctlvropcvnfcfi.biz,dga,3.68188,3,15,19,1,0.2,0.19378,1,0,0,0,1,0,0,0,0,0
8007,jwiebmhrxketldff.eu,dga,3.89241,5,13,19,1,0.38462,0.20486,0,0,0,0,0,1,0,0,0,1
2841,services.adobe.com,legit,3.46132,7,9,18,0,0.77778,0.1923,8,2,1,1,12,6,2,1,0,9
8876,iqkwkugmkeseoqma.org,dga,3.58418,7,12,20,1,0.58333,0.17921,3,0,0,0,3,3,0,0,0,3
1592,zendesk.com,legit,3.27761,3,7,11,0,0.42857,0.29796,2,0,0,0,2,4,0,0,0,4
5412,hzaxfc.hk,dga,2.9477,1,7,9,1,0.14286,0.32752,0,0,0,0,0,0,0,0,0,0
6088,ntnuytghqgaenhrg.eu,dga,3.32636,5,13,19,1,0.38462,0.17507,2,0,0,0,2,1,0,0,0,1
2165,mobile-collector.newrelic.com,legit,3.47867,10,16,29,0,0.625,0.11995,5,0,0,0,5,8,0,0,0,8
6323,ogiamsskwcmwaook.org,dga,3.32193,7,12,20,1,0.58333,0.1661,2,0,0,0,2,1,0,0,0,1
3125,l-0005.l-msedge.net,legit,3.43162,3,8,19,0,0.375,0.18061,3,2,1,0,6,3,0,0,0,3
5624,ywwshiox6ncdgrn4oo.com,dga,3.82307,5,14,22,1,0.35714,0.17378,2,0,0,0,2,0,0,0,0,0
673,captive.apple.com,legit,3.33718,6,9,17,0,0.66667,0.1963,7,4,3,2,16,4,0,0,0,4
6904,cqepbmdzga.com,dga,3.52164,3,10,14,1,0.3,0.25155,0,0,0,0,0,0,0,0,0,0
1113,sp.analytics.yahoo.com,legit,3.53831,7,12,22,0,0.58333,0.16083,6,0,0,1,7,3,0,0,0,3
6143,hafecaz.info,dga,3.25163,5,6,12,1,0.83333,0.27097,0,0,0,0,0,2,0,0,0,2
2494,edge-microsoft-com.dual-a-0036.a-msedge.net,legit,4.10083,13,18,43,0,0.72222,0.09537,11,11,8,5,35,8,1,0,0,9
4221,onedscolprduks04.uksouth.cloudapp.azure.com,legit,4.02536,14,23,43,0,0.6087,0.09361,13,4,3,4,24,5,1,0,0,6
7302,aqch.tj,dga,2.80735,1,5,7,1,0.2,0.40105,0,0,0,0,0,0,0,0,0,0
5195,tjdikerwbgmhwgccrqp.com,dga,3.969,3,19,23,1,0.15789,0.17257,2,0,0,0,2,1,0,0,0,1
1476,salesforce.com,legit,3.23593,5,8,14,0,0.625,0.23114,3,0,0,0,3,4,0,0,0,4
8176,sempersedsoliusma.com,dga,3.46328,8,12,21,1,0.66667,0.16492,7,0,0,0,7,5,1,0,0,6
4843,fp-afd-nocache-ccp.azureedge.net,legit,3.77752,10,17,32,0,0.58824,0.11805,5,2,1,2,10,5,0,0,0,5
4473,api.us.tiktokv.com,legit,3.46132,6,9,18,0,0.66667,0.1923,6,6,5,3,20,1,0,0,0,1
5101,jtrihdur.com,dga,3.4183,3,8,12,1,0.375,0.28486,0,0,0,0,0,1,0,0,0,1
6740,gsopwsgftbaoaelfa.su,dga,3.54644,7,12,20,1,0.58333,0.17732,0,0,0,0,0,1,0,0,0,1
885,sdk.iad-01.braze.com,legit,3.88418,5,9,20,0,0.55556,0.19421,2,0,0,0,2,1,0,0,0,1
9382,dlcfemldkmfdcdbc.website,dga,3.52206,4,19,24,1,0.21053,0.14675,1,0,0,0,1,1,0,0,0,1
7565,oggeayeoya.net,dga,2.89629,7,6,14,1,1.16667,0.20688,2,0,0,0,2,2,0,1,0,3
6652,jozxuriw.ru,dga,3.0958,4,6,11,1,0.66667,0.28144,0,0,0,0,0,1,0,0,0,1
7140,odhujbaxmevfywla.eu,dga,3.93214,7,11,19,1,0.63636,0.20695,0,0,0,0,0,1,0,0,0,1
7566,derrwpsasaui.com,dga,3.625,6,9,16,1,0.66667,0.22656,1,0,0,0,1,3,0,0,0,3
3822,prod-m-node-1113.ssp.yahoo.com,legit,3.77775,7,13,30,0,0.53846,0.12593,4,2,1,1,8,1,1,0,0,2
2336,com.edgekey.net.globalredir.akadns.net,legit,3.84308,12,21,38,0,0.57143,0.10113,8,7,6,3,24,9,2,0,0,11
4430,mobile-collector.cell.nr-data.net,legit,3.63139,10,18,33,0,0.55556,0.11004,6,0,0,0,6,8,0,0,0,8
1782,l-msedge.net,legit,3.18872,3,7,12,0,0.42857,0.26573,3,2,1,0,6,3,0,0,0,3
2069,bing.com.trafficmanager.net,legit,3.63397,8,16,27,0,0.5,0.13459,9,6,3,4,22,9,4,1,0,14
1525,rtb.gumgum.com,legit,3.03915,3,9,14,0,0.33333,0.21708,0,0,0,0,0,0,0,0,0,0
7994,specialistgrabprotectattract.com,dga,3.55423,10,21,32,1,0.47619,0.11107,8,1,0,0,9,8,3,0,0,11
6222,wmcewahkth.com,dga,3.23593,3,10,14,1,0.3,0.23114,1,0,0,0,1,1,0,0,0,1
2909,onedscolprdcus02.centralus.cloudapp.azure.com,legit,3.91643,14,25,45,0,0.56,0.08703,19,5,3,4,31,8,3,0,0,11
1948,getpocket.cdn.mozilla.net,legit,3.75327,7,15,25,0,0.46667,0.15013,5,2,1,0,8,4,0,0,0,4
6166,mctmueub.me,dga,2.66353,4,6,11,1,0.66667,0.24214,0,0,0,0,0,0,0,0,0,0
1569,edgekey.net.globalredir.akadns.net,legit,3.68233,11,19,34,0,0.57895,0.1083,7,5,5,3,20,7,1,0,0,8
2995,push-rtmp-f5-tt02.fcdn.us.tiktokv.com.c.worldfcdn2.com,legit,4.20136,7,33,54,0,0.21212,0.0778,8,10,7,4,29,5,2,1,0,8
3010,mads.amazon-adsystem.com,legit,3.47018,7,14,24,0,0.5,0.14459,9,1,3,3,16,6,0,0,0,6
6883,gasestimateclickorganize.com,dga,3.77094,11,16,28,1,0.6875,0.13468,9,0,0,0,9,13,2,0,0,15
9076,cpssrseb.yi.org,dga,3.32323,3,10,15,1,0.3,0.22155,1,0,0,0,1,1,0,0,0,1
4484,vpaid.pubmatic.com,legit,3.50326,6,10,18,0,0.6,0.19463,5,0,0,0,5,4,1,0,0,5
707,devices.a2z.com,legit,3.50689,5,7,15,0,0.71429,0.23379,5,1,0,0,6,4,0,0,0,4
9480,lbmalfkblolbcebd.de,dga,3.1953,4,14,19,1,0.28571,0.16817,3,0,0,0,3,2,0,0,0,2
1740,securetoken.googleapis.com,legit,3.77736,11,13,26,0,0.84615,0.14528,8,7,4,4,23,8,0,0,0,8
3034,cdn.polyfill.io,legit,3.1899,4,9,15,0,0.44444,0.21266,2,2,1,0,5,1,0,0,0,1
8573,h7anhnivfabmubydz3.cn,dga,3.88018,4,14,21,1,0.28571,0.18477,0,0,0,0,0,2,0,0,0,2
8806,jusjqsqqxv.com,dga,3.18201,2,11,14,1,0.18182,0.22729,1,0,0,0,1,0,0,0,0,0
5332,openingdelayboatorderwish.com,dga,4.07333,11,17,29,1,0.64706,0.14046,4,0,0,0,4,10,1,0,0,11
1527,wp.com,legit,2.58496,1,4,6,0,0.25,0.43083,0,0,0,0,0,0,0,0,0,0
9595,igmgq068q46s.top,dga,3.625,2,8,16,1,0.25,0.22656,0,0,0,0,0,0,0,0,0,0
2033,prod.us001-prod.arcticwolf.net,legit,4.09807,7,16,30,0,0.4375,0.1366,7,3,2,1,13,3,1,0,0,4
4945,cloud.malwarebytes.com,legit,3.82307,7,13,22,0,0.53846,0.17378,8,3,2,1,14,5,0,0,0,5
3346,techsmith.com,legit,3.08506,3,9,13,0,0.33333,0.23731,2,0,0,0,2,4,0,0,0,4
1222,ocsp.usertrust.com,legit,3.2391,5,11,18,0,0.45455,0.17995,5,1,0,0,6,3,1,0,0,4
6591,robertprojectpromptamta.com,dga,3.29156,8,18,27,1,0.44444,0.12191,5,1,0,0,6,6,1,0,0,7
3626,crashtracking.prod.ring.com,legit,3.73601,6,18,27,0,0.33333,0.13837,6,4,3,2,15,5,4,0,0,9
4132,yep.video.yahoo.com,legit,3.36609,8,8,19,0,1.0,0.17716,2,0,0,1,3,1,0,0,0,1
3276,marketo.net,legit,3.0958,4,6,11,0,0.66667,0.28144,1,0,0,0,1,3,0,0,0,3
7043,carpetsuckmoveposthabitstore.com,dga,3.80423,11,20,32,1,0.55,0.11888,2,0,0,0,2,9,1,0,0,10
7912,concesvanaeuangelium.com,dga,3.54248,11,12,24,1,0.91667,0.1476,6,1,0,0,7,7,2,0,0,9
5514,vtypqtkjnkyfycwj.eu,dga,3.68188,2,16,19,1,0.125,0.19378,0,0,0,0,0,0,0,0,0,0
1901,mail-attachment.googleusercontent.com,legit,3.78704,13,21,37,0,0.61905,0.10235,13,8,4,3,28,11,3,0,0,14
9608,cmfdhxro.mn,dga,3.27761,1,9,11,1,0.11111,0.29796,1,0,0,0,1,0,0,0,0,0
1049,pull-cmaf-f16-va01.ttlivecdn.com,legit,4.11673,6,17,32,0,0.35294,0.12865,5,1,2,1,9,4,0,0,0,4
920,mail-ads.google.com,legit,3.47135,7,9,19,0,0.77778,0.1827,6,5,4,3,18,2,0,0,0,2
8543,lwlkjifox.cc,dga,3.25163,2,9,12,1,0.22222,0.27097,0,0,0,0,0,0,0,0,0,0
613,trustarc.com,legit,3.08496,3,8,12,0,0.375,0.25708,3,0,0,0,3,3,0,0,0,3
5090,dlqefx8omkcqhrgtbc.net,dga,4.0958,3,17,22,1,0.17647,0.18617,0,0,0,0,0,1,0,0,0,1
5473,1ruvwjy4u850385.ddns.net,dga,4.08496,3,11,24,1,0.27273,0.17021,2,1,0,0,3,4,3,2,2,11
998,safebrowsing-proxy.g.aaplimg.com,legit,4.09314,9,19,32,0,0.47368,0.12791,7,1,0,0,8,2,2,0,0,4
4593,rmp.rakuten.com,legit,3.50689,4,9,15,0,0.44444,0.23379,4,0,0,0,4,3,0,0,0,3
4572,ap-gew4.spotify.com,legit,3.93214,5,10,19,0,0.5,0.20695,3,0,0,0,3,2,0,0,0,2
4447,api-stream.twitter.com,legit,3.55034,7,12,22,0,0.58333,0.16138,9,1,0,0,10,7,1,0,0,8
279,img-s-msn-com.akamaized.net,legit,3.73601,8,14,27,0,0.57143,0.13837,5,5,6,6,22,5,1,0,0,6
9737,jkmgqxribpm.mooo.com,dga,3.42193,5,13,20,1,0.38462,0.1711,2,0,0,0,2,1,1,2,1,5
6399,meovustiwusub.ddns.net,dga,3.57262,7,13,22,1,0.53846,0.16239,5,1,0,0,6,7,3,2,1,13
7668,rmumjpopkvox.com,dga,3.28064,4,11,16,1,0.36364,0.20504,0,0,0,0,0,0,0,0,0,0
5222,lxaudhrufnrmkvpcx.su,dga,3.88418,4,15,20,1,0.26667,0.19421,0,0,0,0,0,0,0,0,0,0
6153,adfdcaalcklbbfmf.com,dga,3.20869,4,15,20,1,0.26667,0.16043,1,0,0,0,1,1,0,0,0,1
2764,gammaplatform.com,legit,3.21953,5,11,17,0,0.45455,0.18938,5,0,0,0,5,5,0,0,0,5
5319,xxvglkjmuvro.com,dga,3.5,3,12,16,1,0.25,0.21875,1,0,0,0,1,0,0,0,0,0
6379,bootboardgatherpoundcarry.com,dga,3.74196,10,18,29,1,0.55556,0.12903,4,0,0,0,4,5,1,1,1,8
351,o.lencr.org,legit,2.91398,3,6,11,0,0.5,0.26491,3,0,0,0,3,2,0,0,0,2
4885,pre-usermatch.targeting.unrulymedia.com,legit,4.06042,13,22,39,0,0.59091,0.10411,13,1,0,0,14,12,2,0,0,14
9406,yakoqecuogmyyeum.org,dga,3.44644,8,11,20,1,0.72727,0.17232,0,0,0,0,0,1,0,0,0,1
926,prebid.a-mo.net,legit,3.64022,5,7,15,0,0.71429,0.24268,4,0,0,0,4,1,0,0,0,1
6429,krcyqbvjamusjgb.ru,dga,3.72548,3,14,18,1,0.21429,0.20697,2,0,0,0,2,1,0,0,0,1
5008,lrushteeoideiqbci.pw,dga,3.84644,8,11,20,1,0.72727,0.19232,2,0,0,0,2,2,0,0,0,2
5675,cuhligwlyo.net,dga,3.6645,4,9,14,1,0.44444,0.26175,1,0,0,0,1,0,0,0,0,0
6629,bphjbmrigeklwsrnc.in,dga,3.92193,3,16,20,1,0.1875,0.1961,1,0,0,0,1,2,0,0,0,2
2497,ads.rubiconproject.com,legit,3.84535,7,13,22,0,0.53846,0.17479,8,2,0,0,10,4,2,0,0,6
8512,mulorgatl.com,dga,3.2389,4,8,13,1,0.5,0.24915,2,0,0,0,2,2,0,0,0,2
4801,aid.send.microad.jp,legit,3.53689,6,10,19,0,0.6,0.18615,9,4,3,2,18,5,0,0,0,5
9723,tdjhklaebpnsfyui.eu,dga,4.0374,6,12,19,1,0.5,0.21249,0,0,0,0,0,2,0,0,0,2
9898,iqscygaskiaqwgqo.org,dga,3.44644,6,13,20,1,0.46154,0.17232,0,0,0,0,0,1,0,0,0,1
5762,puvypug.info,dga,3.25163,4,7,12,1,0.57143,0.27097,0,0,0,0,0,0,0,0,0,0
618,chat-e2ee-mini.facebook.com,legit,3.73601,11,11,27,0,1.0,0.13837,5,0,0,0,5,6,1,0,0,7
5052,jeannetteabrahamson.net,dga,3.27335,9,13,23,1,0.69231,0.14232,5,0,0,0,5,8,0,0,0,8
1444,confiant-integrations.net,legit,3.42928,9,14,25,0,0.64286,0.13717,8,1,0,0,9,9,4,3,1,17
5292,ldbabaonaaakaedd.com,dga,3.10869,9,10,20,1,0.9,0.15543,2,1,0,0,3,3,0,0,0,3
4134,avatar-prod-us-east-2.webexcontent.com,legit,4.01754,12,19,38,0,0.63158,0.10572,12,5,1,0,18,11,4,0,0,15
9145,encnbemdodkcdcnf.com,dga,3.14644,4,15,20,1,0.26667,0.15732,2,0,0,0,2,3,0,0,0,3
7421,aeooyusokwamcwmk.org,dga,3.52193,8,11,20,1,0.72727,0.1761,3,0,0,0,3,1,0,0,0,1
3950,grs.dbankcloud.cn,legit,3.61687,3,12,17,0,0.25,0.21276,4,3,2,1,10,2,0,0,0,2
2459,us-teams.events.data.microsoft.com,legit,3.76336,11,18,34,0,0.61111,0.11069,16,9,7,6,38,10,1,0,0,11
7164,uujirdbsfiagkxpq.eu,dga,3.89241,7,11,19,1,0.63636,0.20486,0,0,0,0,0,0,0,0,0,0
8019,ncxxwbgamcyfpwsvoi.ki,dga,4.01137,4,16,21,1,0.25,0.19102,1,0,0,0,1,1,0,0,0,1
7742,wrtbwtwrjoaxvewvk.cc,dga,3.52193,3,16,20,1,0.1875,0.1761,0,0,0,0,0,1,0,0,0,1
2627,ivitrack.com,legit,3.25163,4,7,12,0,0.57143,0.27097,1,0,0,0,1,3,1,0,0,4
6234,wwqykmiwyeqaeawk.org,dga,3.42193,6,13,20,1,0.46154,0.1711,2,0,0,0,2,2,0,0,0,2
3417,i.simpli.fi,legit,2.55034,4,5,11,0,0.8,0.23185,2,0,0,0,2,1,0,0,0,1
8940,prp32dzgxh14hsesfxp22g33jtispsove31hw.ru,dga,4.23418,5,24,40,1,0.20833,0.10585,4,0,0,0,4,5,1,0,0,6
8148,southlunchblockwaitsellabuse.com,dga,3.84314,11,20,32,1,0.55,0.1201,4,0,0,0,4,4,0,0,0,4
109,opendns.com,legit,3.0958,3,7,11,0,0.42857,0.28144,2,1,0,0,3,4,1,1,0,6
2611,cacerts.digicert.com,legit,3.42193,6,12,20,0,0.5,0.1711,5,1,0,0,6,6,0,0,0,6
2360,c.urs.microsoft.com,legit,3.18137,5,11,19,0,0.45455,0.16744,7,8,7,6,28,2,0,0,0,2
3834,securitydomain-pa.googleapis.com,legit,4.01532,13,16,32,0,0.8125,0.12548,8,6,4,4,22,10,0,0,0,10
3835,epc.att.net,legit,2.66353,3,6,11,0,0.5,0.24214,2,0,0,0,2,1,0,0,0,1
6189,ddfakldbcflkcolf.net,dga,3.40869,3,16,20,1,0.1875,0.17043,1,0,0,0,1,2,0,0,0,2
6970,pf4zu1ycdg6dy174f6.cn,dga,3.72565,1,12,21,1,0.08333,0.17741,1,0,0,0,1,0,0,0,0,0
17,nrdp.prod.cloud.netflix.com,legit,3.73601,6,17,27,0,0.35294,0.13837,8,7,6,4,25,2,1,0,0,3
4035,e7808.dscg.akamaiedge.net,legit,3.70347,8,10,25,0,0.8,0.14814,7,5,5,3,20,5,0,0,0,5
4317,ad.yieldlab.net,legit,3.24022,5,8,15,0,0.625,0.21601,2,0,0,0,2,2,0,0,0,2
4227,officeci-mauservice.azurewebsites.net,legit,3.88077,16,18,37,0,0.88889,0.10489,12,5,4,5,26,11,2,1,0,14
5603,myeoqoyaymeikaqo.org,dga,3.28418,9,10,20,1,0.9,0.16421,0,0,0,0,0,0,0,0,0,0
3408,p.ad.gt,legit,2.52164,1,4,7,0,0.25,0.36023,3,0,0,0,3,0,0,0,0,0
3908,pixel.pointmediatracker.com,legit,3.81008,10,15,27,0,0.66667,0.14111,7,0,0,0,7,7,1,0,0,8
2617,playstoregatewayadapter-pa.googleapis.com,legit,3.81703,16,22,41,0,0.72727,0.0931,12,6,4,4,26,10,2,0,0,12
2837,amd-infra.itunes.apple.com,legit,3.95006,9,13,26,0,0.69231,0.15193,10,4,3,2,19,7,0,0,0,7
9575,dajcti3otqj4.net,dga,3.57782,4,9,16,1,0.44444,0.22361,1,0,0,0,1,1,0,0,0,1
595,tags.bluekai.com,legit,3.75,6,8,16,0,0.75,0.23438,2,0,0,0,2,1,0,0,0,1
2233,44-courier.push.apple.com,legit,3.78347,8,11,25,0,0.72727,0.15134,9,4,3,2,18,4,0,0,0,4
9512,a4anyj121lobu2cbs87.ddns.net,dga,4.13754,5,14,28,1,0.35714,0.14777,3,1,0,0,4,5,3,3,2,13
9217,sosuosmwaymiiwgm.org,dga,3.30869,7,12,20,1,0.58333,0.16543,1,0,0,0,1,2,0,0,0,2
8911,tony-photos.sh,dga,3.03915,3,9,14,1,0.33333,0.21708,1,0,0,0,1,1,0,0,0,1
2243,35-courier.push.apple.com,legit,3.86347,8,11,25,0,0.72727,0.15454,9,4,3,2,18,4,0,0,0,4
2522,datadoghq.com,legit,3.2389,4,8,13,0,0.5,0.24915,3,0,0,0,3,2,0,0,0,2
8551,okvkaletce.com,dga,3.23593,5,8,14,1,0.625,0.23114,2,0,0,0,2,3,0,0,0,3
8479,riding-italian.wtf,dga,3.39215,6,10,18,1,0.6,0.18845,3,0,0,0,3,5,2,0,0,7
430,support.content.office.net,legit,3.43046,8,15,26,0,0.53333,0.13194,10,7,4,3,24,8,3,0,0,11
4161,crl.pki.goog,legit,3.08496,3,7,12,0,0.42857,0.25708,1,0,0,0,1,0,0,0,0,0
4038,gtq6.sct.sc-prod.net,legit,3.64644,2,13,20,0,0.15385,0.18232,2,2,1,0,5,0,1,0,0,1
9237,qkgowskcqsoaqmac.org,dga,3.34644,5,14,20,1,0.35714,0.16732,1,0,0,0,1,2,0,0,0,2
5914,melucgofdic.com,dga,3.32323,5,9,15,1,0.55556,0.22155,2,0,0,0,2,2,0,0,0,2
8011,makevif.info,dga,3.25163,5,6,12,1,0.83333,0.27097,1,0,0,0,1,1,0,0,0,1
4176,quantcast584928381.s.moatpixel.com,legit,4.29277,8,14,34,0,0.57143,0.12626,6,1,0,0,7,6,0,0,0,6
2591,tiktokv.com.c.worldfcdn2.com,legit,3.6645,5,18,28,0,0.27778,0.13088,5,8,5,3,21,5,2,1,0,8
61,ls.apple.com,legit,3.08496,3,7,12,0,0.42857,0.25708,6,4,3,2,15,1,0,0,0,1
7980,pagerepairprofileexpress.com,dga,3.53558,11,16,28,1,0.6875,0.12627,8,2,0,0,10,5,4,0,2,11
1402,adnxs-simple.com,legit,3.75,4,10,16,0,0.4,0.23438,4,1,0,0,5,3,0,0,0,3
6481,iqudksbgqqkgt.org,dga,3.41042,3,13,17,1,0.23077,0.20061,0,0,0,0,0,0,0,0,0,0
8458,bonajuko.info,dga,3.18083,6,6,13,1,1.0,0.24468,1,0,0,0,1,1,0,0,0,1
1146,segment.com,legit,3.0958,3,7,11,0,0.42857,0.28144,3,1,0,0,4,2,1,0,0,3
7612,oe06cqom4uwq.net,dga,3.625,5,7,16,1,0.71429,0.22656,0,0,0,0,0,1,0,0,0,1
650,calendar.google.com,legit,3.36609,7,10,19,0,0.7,0.17716,3,5,4,3,15,5,0,0,0,5
6822,czsibnpfctoziqnqnxa.com,dga,3.76227,5,17,23,1,0.29412,0.16358,0,0,0,0,0,1,0,0,0,1
9191,kfyebzcsovsvjbgjmsj.com,dga,3.67531,3,19,23,1,0.15789,0.1598,0,0,0,0,0,0,0,0,0,0
4698,samsungknox.com,legit,3.37356,4,10,15,0,0.4,0.2249,1,0,0,0,1,2,0,0,0,2
8195,same-failing.net,dga,3.5,6,8,16,1,0.75,0.21875,3,0,0,0,3,2,1,0,0,3
6945,ocmgpvdxnq.com,dga,3.37878,2,11,14,1,0.18182,0.24134,0,0,0,0,0,0,0,0,0,0
9551,hpvstrofmcuwfujld.su,dga,3.88418,4,15,20,1,0.26667,0.19421,3,0,0,0,3,1,0,0,0,1
1907,1.courier-push-apple.com.akadns.net,legit,4.09315,11,17,35,0,0.64706,0.11695,13,9,9,9,40,7,3,1,0,11
5212,gegxglvhdeg.tj,dga,3.09307,2,11,14,1,0.18182,0.22093,1,0,0,0,1,2,0,0,0,2
7684,rusjtjnmujziodm.com,dga,3.53689,5,13,19,1,0.38462,0.18615,1,0,0,0,1,0,0,0,0,0
854,mookie1.com,legit,2.84535,5,4,11,0,1.25,0.25867,1,0,0,0,1,0,0,0,0,0
578,sync.1rx.io,legit,3.27761,2,6,11,0,0.33333,0.29796,0,0,0,0,0,0,0,0,0,0
5945,brooklynnwashington.net,dga,3.7251,6,16,23,1,0.375,0.16196,4,0,0,0,4,3,1,0,0,4
8643,migtdkrvrdytexxqc.tw,dga,3.78418,2,17,20,1,0.11765,0.18921,2,0,0,0,2,2,0,0,0,2
1983,scone-pa.clients6.google.com,legit,3.72647,9,14,28,0,0.64286,0.13309,8,7,4,3,22,5,3,0,0,8
3536,appleid.cdn-apple.com,legit,3.43994,6,12,21,0,0.5,0.16381,8,4,2,1,15,2,0,0,0,2
7428,mhlajrljulyl.com,dga,3.25,3,12,16,1,0.25,0.20312,0,0,0,0,0,1,0,0,0,1
1749,a880.us.akamai.net,legit,3.35021,7,5,18,0,1.4,0.18612,5,3,4,3,15,2,0,0,0,2
530,api.snapchat.com,legit,3.32782,5,9,16,0,0.55556,0.20799,3,1,1,0,5,1,1,0,0,2
1387,xz.fbcdn.net,legit,3.25163,1,9,12,0,0.11111,0.27097,2,1,0,0,3,1,0,0,0,1
8243,jbmtckktkwridwwcs.pw,dga,3.48418,1,18,20,1,0.05556,0.17421,0,0,0,0,0,1,0,0,0,1
3665,microsoft.us,legit,3.25163,4,7,12,0,0.57143,0.27097,5,7,6,5,23,2,0,0,0,2
3596,cdn.adsafeprotected.com,legit,3.55553,7,14,23,0,0.5,0.15459,9,3,1,0,13,4,1,0,0,5
7627,llibfhmklmxlymdjq.com,dga,3.63041,2,18,21,1,0.11111,0.17288,1,0,0,0,1,0,0,0,0,0
971,wpc.2be4.phicdn.net,legit,3.57662,3,11,19,0,0.27273,0.18824,3,1,0,0,4,3,0,0,0,3
8790,ddhinwsqqowo.com,dga,3.32782,4,11,16,1,0.36364,0.20799,1,0,0,0,1,2,0,0,0,2
1474,westeurope.cloudapp.azure.com,legit,3.71938,12,14,29,0,0.85714,0.12825,13,4,3,4,24,4,1,0,0,5
5654,dxgmvvtodclxcc.com,dga,3.16993,2,15,18,1,0.13333,0.17611,0,0,0,0,0,0,0,0,0,0
745,mqtt-mini.facebook.com,legit,3.66353,7,12,22,0,0.58333,0.16652,4,0,0,0,4,5,0,0,0,5
9229,espoahah.ddns.net,dga,3.26393,5,10,17,1,0.5,0.192,3,1,0,0,4,5,3,2,2,12
6918,cadisuatd.ddns.net,dga,3.16993,5,11,18,1,0.45455,0.17611,5,1,0,0,6,8,3,2,1,14
9322,pdbipafox.org,dga,3.39275,4,8,13,1,0.5,0.26098,0,0,0,0,0,0,0,0,0,0
6288,yrzcjw.com.ni,dga,3.39275,2,9,13,1,0.22222,0.26098,2,2,1,0,5,2,2,1,0,5
8248,zswyqbrvplekrnff.com,dga,4.12193,2,17,20,1,0.11765,0.2061,2,1,0,0,3,1,0,0,0,1
6868,vuxbuxna.ru,dga,2.84535,4,6,11,1,0.66667,0.25867,0,0,0,0,0,0,0,0,0,0
5747,ddafcbfdacbaaaab.org,dga,2.87095,7,12,20,1,0.58333,0.14355,0,0,0,0,0,2,0,0,0,2
6436,igkhqdvbfnktmonqe.com,dga,3.91613,4,16,21,1,0.25,0.18648,1,0,0,0,1,1,0,0,0,1
7382,yskfpdhr.ru,dga,3.27761,1,9,11,1,0.11111,0.29796,0,0,0,0,0,0,0,0,0,0
5673,trgjenjilpub.org,dga,3.625,4,11,16,1,0.36364,0.22656,1,0,0,0,1,1,0,0,0,1
2361,www.office.com,legit,2.89629,4,8,14,0,0.5,0.20688,3,4,4,3,14,2,0,0,0,2
9576,nnbertwvchvebg.co.uk,dga,3.72193,4,14,20,1,0.28571,0.1861,3,1,0,0,4,4,1,0,0,5
5548,rjyorryv.com,dga,2.85539,2,9,12,1,0.22222,0.23795,0,0,0,0,0,1,0,0,0,1
2747,osi.office.net.akadns.net,legit,3.46347,9,12,25,0,0.75,0.13854,7,7,8,6,28,7,1,0,0,8
4084,widget.us.tiktokv.com,legit,3.65376,6,12,21,0,0.5,0.17399,5,6,4,3,18,3,0,0,0,3
7097,bddfeakolemfnoln.com,dga,3.48418,6,13,20,1,0.46154,0.17421,2,0,0,0,2,4,0,0,0,4
1075,extension.grammarly.com,legit,3.79509,7,14,23,0,0.5,0.165,6,0,0,0,6,9,1,0,0,10
464,dotomi.com,legit,2.64644,4,5,10,0,0.8,0.26464,1,0,0,0,1,2,0,0,0,2
3861,dcape-na.amazon.com,legit,3.30056,7,9,19,0,0.77778,0.17371,5,1,3,3,12,4,0,0,0,4
9326,bfwbsiscr.com,dga,3.2389,2,10,13,1,0.2,0.24915,1,0,0,0,1,2,0,0,0,2
5952,qv5f7tcrmvqtafe.ddns.net,dga,3.80351,3,17,24,1,0.17647,0.15848,5,1,0,0,6,5,4,3,2,14
1424,pptservicescast.officeapps.live.com,legit,3.65758,11,21,35,0,0.52381,0.1045,12,7,5,4,28,10,2,1,0,13
6311,56qfyxk4wtyfq8sxebi.ddns.net,dga,4.09307,3,19,28,1,0.15789,0.14618,2,1,0,0,3,4,4,3,2,13
1598,gateway.devices.a2z.com,legit,3.8164,8,11,23,0,0.72727,0.16593,8,1,0,0,9,7,1,0,0,8
1949,api.onedrive.com,legit,3.5,7,7,16,0,1.0,0.21875,4,1,1,0,6,5,1,0,0,6
6711,glassplease.net,dga,3.00624,5,9,15,1,0.55556,0.20042,4,1,0,0,5,5,1,0,0,6
4758,sync.connectad.io,legit,3.29277,5,10,17,0,0.5,0.19369,5,2,0,0,7,5,2,0,0,7
7939,keiwikaf.ru,dga,3.0958,5,5,11,1,1.0,0.28144,0,0,0,0,0,0,0,0,0,0
5853,uwnahuslut.com,dga,3.46772,5,8,14,1,0.625,0.24769,1,0,0,0,1,0,0,0,0,0
4575,tp.b16066390-frontier.amazonalexa.com,legit,4.28338,10,15,37,0,0.66667,0.11577,10,1,3,3,17,6,0,0,0,6
1648,cp501.prod.do.dsp.mp.microsoft.com,legit,3.51734,6,19,34,0,0.31579,0.10345,11,12,10,9,42,3,2,0,0,5
3053,xiaomi.com,legit,2.72193,5,4,10,0,1.25,0.27219,1,0,0,0,1,2,0,0,0,2
3900,cws.prod.dcat.dsp.trafficmanager.net,legit,3.81911,8,23,36,0,0.34783,0.10609,14,7,4,5,30,9,2,0,0,11
5993,8soas1e2fblisp2an8.biz,dga,3.78875,6,10,22,1,0.6,0.17222,1,0,0,0,1,3,0,0,0,3
3325,cl2.g.aaplimg.com,legit,3.21953,4,9,17,0,0.44444,0.18938,4,0,0,0,4,0,0,0,0,0
3572,settings-service-a.wbx2.com,legit,4.0323,7,15,27,0,0.46667,0.14934,6,2,1,1,10,7,3,1,0,11
8328,pretchristiani.com,dga,3.57243,6,11,18,1,0.54545,0.19847,4,0,0,0,4,8,2,0,2,12
8974,hbhchfr.ir,dga,2.64644,1,8,10,1,0.125,0.26464,0,0,0,0,0,0,0,0,0,0
5839,raweahug.ru,dga,2.91398,5,5,11,1,1.0,0.26491,2,0,0,0,2,2,0,0,0,2
6097,aqxifkni.mu,dga,3.27761,4,6,11,1,0.66667,0.29796,0,0,0,0,0,1,0,0,0,1
2370,ow.pubmatic.com,legit,3.37356,5,8,15,0,0.625,0.2249,4,0,0,0,4,4,1,0,0,5
6601,cu5fecy1kpl4gjfw48.ru,dga,4.01137,3,12,21,1,0.25,0.19102,1,0,0,0,1,1,0,0,0,1
7661,wqiynwruvp.biz,dga,3.52164,3,10,14,1,0.3,0.25155,0,0,0,0,0,0,0,0,0,0
3995,pull-flv-f11-gcp01.tiktokcdn.com,legit,4.03064,4,19,32,0,0.21053,0.12596,4,6,9,9,28,2,0,0,0,2
3842,netseer-ipaddr-assoc.xy.fbcdn.net,legit,3.92259,8,20,33,0,0.4,0.11887,5,1,0,0,6,7,1,0,0,8
2155,pull-o5-sg01.tiktokcdn.com.c.bytefcdn-oversea.com,legit,4.3679,11,27,49,0,0.40741,0.08914,10,10,12,10,42,9,5,1,0,15
6906,rghwarmlxmqivfmcs.com,dga,3.82089,3,17,21,1,0.17647,0.18195,0,0,0,0,0,1,0,0,0,1
474,res-h3.public.cdn.office.net,legit,3.96772,7,15,28,0,0.46667,0.1417,9,6,5,3,23,5,1,0,0,6
1872,parsely.com,legit,3.45943,3,7,11,0,0.42857,0.31449,1,0,0,0,1,3,0,0,0,3
1939,bouncex.net,legit,3.0958,4,6,11,0,0.66667,0.28144,2,0,0,0,2,1,1,0,0,2
8807,y4uky82kekyg.top,dga,3.40564,3,9,16,1,0.33333,0.21285,0,0,0,0,0,0,0,0,0,0
3959,cs.krushmedia.com,legit,3.61687,5,10,17,0,0.5,0.21276,3,0,0,0,3,1,0,0,0,1
5754,washingtonharoldson.net,dga,3.62118,7,15,23,1,0.46667,0.15744,4,0,0,0,4,4,1,0,0,5
1877,francecentral.cloudapp.azure.com,legit,3.74173,11,18,32,0,0.61111,0.11693,12,5,3,4,24,6,3,1,0,10
1517,i6.liadm.com,legit,3.08496,4,5,12,0,0.8,0.25708,2,0,0,0,2,0,0,0,0,0
5240,fjzxvttb.com.pe,dga,3.64022,2,11,15,1,0.18182,0.24268,2,2,1,0,5,2,2,1,0,5
3362,adsmoloco.com,legit,2.77736,5,7,13,0,0.71429,0.21364,4,0,0,0,4,1,0,0,0,1
4495,p.skimresources.com,legit,3.36609,6,11,19,0,0.54545,0.17716,5,0,0,0,5,3,1,0,0,4
4542,cache-ssl.celtra.com,legit,3.42193,5,12,20,0,0.41667,0.1711,3,0,0,0,3,5,1,0,0,6
467,imasdk.googleapis.com,legit,3.59447,8,11,21,0,0.72727,0.17117,6,6,4,4,20,5,0,0,0,5
8839,xjuopazgre.com,dga,3.6645,5,8,14,1,0.625,0.26175,1,0,0,0,1,1,0,0,0,1
1318,acroipm2.adobe.com,legit,3.46132,7,8,18,0,0.875,0.1923,4,1,0,0,5,2,0,0,0,2
4467,cdn.p-n.io,legit,2.92193,2,5,10,0,0.4,0.29219,2,2,1,0,5,1,0,0,0,1
7245,wucudsutang.com,dga,3.45656,5,9,15,1,0.55556,0.23044,2,0,0,0,2,3,0,0,0,3
1124,execute-api.us-east-1.amazonaws.com,legit,3.87573,14,14,35,0,1.0,0.11074,10,3,4,3,20,8,0,0,0,8
5785,yuomnskbuxrchonylobusqsjz.com,dga,3.90937,7,21,29,1,0.33333,0.13481,3,0,0,0,3,3,0,0,0,3
2119,www.paypalobjects.com,legit,3.6897,5,14,21,0,0.35714,0.1757,1,0,0,0,1,1,0,0,0,1
7395,serviceformreplacerepair.com,dga,3.45113,11,16,28,1,0.6875,0.12325,6,2,1,1,10,8,3,1,2,14
7876,vonapa.info,dga,2.91398,5,5,11,1,1.0,0.26491,2,0,0,0,2,1,0,0,0,1
1183,akstat.io,legit,2.72548,4,4,9,0,1.0,0.30283,3,0,0,0,3,3,0,0,0,3
5614,y47nybahob7fuf14q0m.ddns.net,dga,4.13754,4,16,28,1,0.25,0.14777,2,1,0,0,3,4,3,2,2,11
9838,klnumuqse.cc,dga,3.25163,3,8,12,1,0.375,0.27097,1,0,0,0,1,1,0,0,0,1
300,ups.analytics.yahoo.com,legit,3.64249,8,12,23,0,0.66667,0.15837,5,0,0,1,6,3,0,0,0,3
4426,o.aolcdn.com,legit,2.85539,4,6,12,0,0.66667,0.23795,3,1,0,0,4,1,0,0,0,1
7957,withinhealth.net,dga,3.03064,5,10,16,1,0.5,0.18942,2,0,0,0,2,3,0,0,0,3
7409,inkeoppeelhii.ddns.net,dga,3.39081,8,12,22,1,0.66667,0.15413,4,1,0,0,5,6,4,3,2,15
8792,hwbxxwkjolmyaxbf.eu,dga,3.78714,4,14,19,1,0.28571,0.19932,0,0,0,0,0,0,0,0,0,0
5028,dikeabok.ru,dga,3.27761,5,5,11,1,1.0,0.29796,1,0,0,0,1,1,0,0,0,1
5180,vjmenusqmy.com,dga,3.46772,3,10,14,1,0.3,0.24769,2,0,0,0,2,1,0,0,0,1
507,use.typekit.net,legit,3.13957,5,8,15,0,0.625,0.2093,4,0,0,0,4,2,0,0,0,2
164,configuration.ls.apple.com,legit,3.87314,9,14,26,0,0.64286,0.14897,11,5,3,2,21,6,4,2,1,13
9,safebrowsing.googleapis.com,legit,3.81008,10,15,27,0,0.66667,0.14111,7,6,4,4,21,5,1,0,0,6
131,core.windows.net,legit,3.375,5,9,16,0,0.55556,0.21094,4,0,0,0,4,5,0,0,0,5
1885,mparticle.com,legit,3.39275,4,8,13,0,0.5,0.26098,3,0,0,0,3,4,0,0,0,4
8464,fearinterestedstanddiscover.com,dga,3.64358,11,19,31,1,0.57895,0.11753,12,0,0,0,12,17,8,1,0,26
6083,madurwutdar.com,dga,3.24022,5,9,15,1,0.55556,0.21601,2,0,0,0,2,2,0,0,0,2
4874,music.amazon.com,legit,3.20282,6,8,16,0,0.75,0.20018,6,1,3,3,13,5,0,0,0,5
6579,pkugxetwowlsf.biz,dga,3.96982,4,12,17,1,0.33333,0.23352,0,0,0,0,0,1,0,0,0,1
8370,perdocendimaledictus.com,dga,3.7406,9,14,24,1,0.64286,0.15586,8,0,0,0,8,8,0,0,0,8
6258,fgkvbovbqmbgoabxw.in,dga,3.62193,4,15,20,1,0.26667,0.1811,0,0,0,0,0,0,0,0,0,0
7476,lelpzbuxx.mooo.com,dga,3.28104,6,10,18,1,0.6,0.18228,3,0,0,0,3,2,1,2,1,6
4486,tags.mathtag.com,legit,3.03064,4,10,16,0,0.4,0.18942,5,0,0,0,5,3,0,0,0,3
1264,cdn-icloud-content.g.aaplimg.com,legit,3.80423,9,18,32,0,0.5,0.11888,14,6,2,1,23,6,2,0,0,8
7025,jukbli.net,dga,3.32193,3,6,10,1,0.5,0.33219,1,0,0,0,1,0,0,0,0,0
5141,txmibdxfblgjyfmhi.me,dga,3.68418,3,16,20,1,0.1875,0.18421,1,0,0,0,1,1,0,0,0,1
4837,cdnssl.clicktale.net,legit,3.34644,4,14,20,0,0.28571,0.16732,7,2,0,0,9,5,1,0,0,6
3064,i.vimeocdn.com,legit,3.09307,5,7,14,0,0.71429,0.22093,2,1,0,0,3,1,0,0,0,1
6047,klclclqd74cbgfwlwp10odo.ddns.net,dga,4.10141,3,23,32,1,0.13043,0.12817,2,1,0,0,3,4,4,3,2,13
1385,self-events-data.trafficmanager.net,legit,3.73702,11,20,35,0,0.55,0.10677,11,4,1,3,19,12,2,0,0,14
4353,usuyk1.icloud-content.com,legit,3.83327,8,13,25,0,0.61538,0.15333,9,5,2,1,17,6,2,0,0,8
3617,m.taobao.com,legit,2.68872,5,5,12,0,1.0,0.22406,2,0,0,0,2,1,0,0,0,1
124,measure.office.net,legit,3.50326,8,8,18,0,1.0,0.19463,6,4,4,3,17,6,0,0,0,6
4395,alt6-mtalk.google.com,legit,3.46328,6,11,21,0,0.54545,0.16492,3,5,4,3,15,2,0,0,0,2
103,msedge.net,legit,2.84644,3,6,10,0,0.5,0.28464,3,2,1,0,6,3,0,0,0,3
2914,adobess.com,legit,3.0958,4,6,11,0,0.66667,0.28144,2,0,0,0,2,2,1,0,0,3
5821,gqcisumyqmqqyycg.org,dga,3.24644,3,16,20,1,0.1875,0.16232,0,0,0,0,0,2,0,0,0,2
2535,onetrust.io,legit,3.0958,5,5,11,0,1.0,0.28144,3,0,0,0,3,4,1,0,0,5
3149,47cf2c8c9-frontier.amazon.com,legit,4.00436,7,14,29,0,0.5,0.13808,8,1,3,3,15,5,0,0,0,5
410,mqtt.c10r.facebook.com,legit,3.62922,5,12,22,0,0.41667,0.16496,3,0,0,0,3,2,0,0,0,2
4789,accounts.firefox.com,legit,3.64644,7,11,20,0,0.63636,0.18232,5,0,0,0,5,3,0,0,0,3
7799,odmldcednnkdnlen.eu,dga,3.0503,5,13,19,1,0.38462,0.16054,5,0,0,0,5,5,0,0,0,5
8481,abcfafkacfackadc.co,dga,2.67034,6,12,19,1,0.5,0.14054,1,0,0,0,1,1,0,0,0,1
2717,ninthdecimal.com,legit,3.5,5,10,16,0,0.5,0.21875,3,0,0,0,3,5,0,0,0,5
1748,buy.itunes-apple.com.akadns.net,legit,3.97792,10,16,31,0,0.625,0.12832,11,9,9,9,38,8,3,1,0,12
3386,duckduckgo.com,legit,2.89629,4,9,14,0,0.44444,0.20688,0,0,0,0,0,0,0,0,0,0
828,doh.opendns.com,legit,3.1899,4,9,15,0,0.44444,0.21266,2,1,0,0,3,4,1,1,0,6
9176,aajlfpophlz.net,dga,3.50689,4,10,15,1,0.4,0.23379,0,0,0,0,0,0,0,0,0,0
2744,cs.yellowblue.io,legit,3.32782,6,8,16,0,0.75,0.20799,2,0,0,0,2,1,0,0,0,1
5421,zhjmwglzzdkvlzzdqsjnxwl.org,dga,3.8525,1,25,27,1,0.04,0.14269,0,0,0,0,0,0,0,0,0,0
448,www.amazon.com,legit,2.89629,4,8,14,0,0.5,0.20688,4,1,3,3,11,3,0,0,0,3
2208,19-courier.push.apple.com,legit,3.86347,8,11,25,0,0.72727,0.15454,9,4,3,2,18,4,0,0,0,4
1837,static.zdassets.com,legit,3.26083,5,12,19,0,0.41667,0.17162,6,0,0,0,6,8,2,0,0,10
1002,pull-f5-va01.ttlivecdn.com,legit,4.13294,5,14,26,0,0.35714,0.15896,4,1,2,1,8,3,0,0,0,3
2040,p1.parsely.com,legit,3.52164,3,8,14,0,0.375,0.25155,1,0,0,0,1,3,0,0,0,3
1979,presence.gcc.teams.microsoft.com,legit,3.56643,9,19,32,0,0.47368,0.11145,18,8,7,6,39,10,2,1,0,13
2094,ss2.us,legit,1.79248,1,3,6,0,0.33333,0.29875,0,0,0,0,0,0,0,0,0,0
1892,instantmessaging-pa.googleapis.com,legit,3.66791,12,19,34,0,0.63158,0.10788,10,6,4,4,24,9,2,0,0,11
1850,api.samsungcloud.com,legit,3.62193,7,11,20,0,0.63636,0.1811,5,4,3,1,13,2,0,0,0,2
4294,p19.tiktokcdn-us.com,legit,3.82193,4,11,20,0,0.36364,0.1911,5,6,7,6,24,2,0,0,0,2
1048,node.e2ro.com,legit,3.02699,5,5,13,0,1.0,0.23285,2,0,0,0,2,1,0,0,0,1
2035,7.tlu.dl.delivery.mp.microsoft.com,legit,3.8588,8,19,34,0,0.42105,0.11349,11,8,7,7,33,7,1,0,0,8
1029,geover.prod.do.dsp.mp.microsoft.com,legit,3.52817,9,20,35,0,0.45,0.1008,13,12,10,9,44,6,4,0,0,10
7293,qcm0a02oqoq4.top,dga,3.28064,4,7,16,1,0.57143,0.20504,0,0,0,0,0,0,0,0,0,0
9565,mybroswbckiff.ru,dga,3.625,3,12,16,1,0.25,0.22656,1,1,0,0,2,0,0,0,0,0
5470,dimensionpressurehopeassociate.com,dga,3.67646,15,18,34,1,0.83333,0.10813,8,0,0,0,8,11,5,0,0,16
6263,sqsluqixalzomq.biz,dga,3.46132,5,12,18,1,0.41667,0.1923,0,0,0,0,0,1,0,0,0,1
1249,pubgw.yahoo.com,legit,3.45656,5,8,15,0,0.625,0.23044,1,0,0,1,2,0,0,0,0,0
727,c10r.instagram.com,legit,3.61437,4,10,18,0,0.4,0.2008,5,0,0,0,5,6,0,0,0,6
1700,aesir.office.com,legit,3.25,7,7,16,0,1.0,0.20312,4,4,4,3,15,4,0,0,0,4
5786,bmghgl.hk,dga,2.72548,0,8,9,1,0.0,0.30283,0,0,0,0,0,0,0,0,0,0
454,dgw.c10r.facebook.com,legit,3.71305,5,11,21,0,0.45455,0.17681,3,0,0,0,3,2,0,0,0,2
7227,fnuzzfkrz.com,dga,3.18083,2,10,13,1,0.2,0.24468,0,0,0,0,0,0,0,0,0,0
2917,onedscolprdcus14.centralus.cloudapp.azure.com,legit,3.91643,14,25,45,0,0.56,0.08703,19,5,3,4,31,8,3,0,0,11
8828,suphatfo.ru,dga,3.27761,4,6,11,1,0.66667,0.29796,1,0,0,0,1,2,0,0,0,2
4388,usemessages.com,legit,2.92323,6,8,15,0,0.75,0.19488,4,1,0,0,5,4,1,0,0,5
5874,ymfkofxpueo.me,dga,3.23593,5,8,14,1,0.625,0.23114,1,0,0,0,1,0,0,0,0,0
7083,cnbebnkafkdeaoco.com,dga,3.34644,7,12,20,1,0.58333,0.16732,2,0,0,0,2,4,0,0,0,4
6182,guzhbhepwd.com,dga,3.6645,3,10,14,1,0.3,0.26175,0,0,0,0,0,0,0,0,0,0
8445,axtvtwdjxcwurhqf.eu,dga,3.82687,4,14,19,1,0.28571,0.20141,0,0,0,0,0,0,0,0,0,0
3345,events3.adcolony.com,legit,3.68418,6,11,20,0,0.54545,0.18421,7,1,0,0,8,4,1,0,0,5
8928,catherinepickering.net,dga,3.39081,8,13,22,1,0.61538,0.15413,5,0,0,0,5,7,5,1,1,14
2768,wf.taboola.com,legit,3.18201,5,7,14,0,0.71429,0.22729,3,0,0,0,3,2,0,0,0,2
5581,ogoxxeaxu.ddns.net,dga,3.35021,6,10,18,1,0.6,0.18612,3,1,0,0,4,5,3,3,2,13
6630,gahinusujac.eu,dga,3.32486,7,6,14,1,1.16667,0.23749,2,0,0,0,2,3,0,0,0,3
8622,supdthkl.com,dga,3.58496,2,9,12,1,0.22222,0.29875,0,0,0,0,0,1,0,0,0,1
9926,sugarsucceedbeenassociate.com,dga,3.60403,13,15,29,1,0.86667,0.12428,5,0,0,0,5,9,2,0,0,11
9912,desirereservewrapwaitpension.com,dga,3.65564,13,18,32,1,0.72222,0.11424,8,1,1,0,10,12,5,1,0,18
6320,micnatle.ru,dga,3.45943,4,6,11,1,0.66667,0.31449,4,1,0,0,5,4,0,0,0,4
4865,ads.samba.tv,legit,2.85539,3,7,12,0,0.42857,0.23795,4,0,0,0,4,1,0,0,0,1
7455,bvch.com.fj,dga,3.0958,1,8,11,1,0.125,0.28144,2,2,1,0,5,2,2,1,0,5
1512,esp.rtbhouse.com,legit,3.5,5,9,16,0,0.55556,0.21875,5,0,0,0,5,2,0,0,0,2
6529,thaynsfox.cc,dga,3.4183,2,9,12,1,0.22222,0.28486,0,0,0,0,0,1,0,0,0,1
1178,adobelogin.com,legit,3.46772,6,7,14,0,0.85714,0.24769,3,0,0,0,3,3,0,0,0,3
5545,xiiqauttesedpapa.com,dga,3.68418,9,10,20,1,0.9,0.18421,5,0,0,0,5,4,0,0,0,4
6053,xp3rpbtgxou5jmn4hx.com,dga,3.97057,3,15,22,1,0.2,0.18048,1,0,0,0,1,0,0,0,0,0
1372,disc801.prod.do.dsp.mp.microsoft.com,legit,3.55495,7,20,36,0,0.35,0.09875,11,12,10,9,42,4,2,0,0,6
5019,vrnixstxftvpfo.com,dga,3.61437,3,14,18,1,0.21429,0.2008,1,0,0,0,1,2,0,0,0,2
7380,iigudiiugkeq.biz,dga,3.0244,8,7,16,1,1.14286,0.18902,0,0,0,0,0,0,0,3,2,5
9002,dhjpohmhjupxkdob.eu,dga,3.47135,5,13,19,1,0.38462,0.1827,0,0,0,0,0,0,0,0,0,0
9638,lfygigefbwgsonta.eu,dga,3.78714,6,12,19,1,0.5,0.19932,4,0,0,0,4,3,0,0,0,3
9347,o68q4ioigiki.top,dga,3.20282,7,5,16,1,1.4,0.20018,0,0,0,0,0,0,0,0,0,0
5202,utudhiohuchu.ddns.net,dga,3.2728,7,12,21,1,0.58333,0.15585,2,1,0,0,3,4,3,3,2,12
9496,eraropg6o4o67turkdi.ddns.net,dga,3.94076,8,14,28,1,0.57143,0.14074,5,1,0,0,6,7,5,3,2,17
7518,ernxvac2ldtehjtltq.cn,dga,3.78494,3,16,21,1,0.1875,0.18024,2,0,0,0,2,3,0,0,0,3
9053,oqmluxyys.com,dga,3.2389,3,9,13,1,0.33333,0.24915,0,0,0,0,0,0,0,0,0,0
4577,is-gateway.supersonicads.com,legit,3.99468,10,15,28,0,0.66667,0.14267,7,0,0,0,7,9,2,0,0,11
3654,assets-jpcust.jwpsrv.com,legit,3.68456,4,17,24,0,0.23529,0.15352,3,0,0,0,3,4,1,0,0,5
9983,ypajmpe0gngr1t3pml1.ddns.net,dga,3.96772,3,19,28,1,0.15789,0.1417,2,1,0,0,3,4,3,2,1,10
3593,intuit.com,legit,2.92193,4,5,10,0,0.8,0.29219,2,0,0,0,2,2,0,0,0,2
6418,awissg.dyndns.org,dga,3.33718,3,12,17,1,0.25,0.1963,2,1,0,0,3,5,3,4,3,15
2703,ads.scorecardresearch.com,legit,3.19327,8,15,25,0,0.53333,0.12773,8,0,0,0,8,9,1,0,0,10
5481,nnccxklpthlt.com,dga,3.32782,1,14,16,1,0.07143,0.20799,0,0,0,0,0,0,0,0,0,0
5561,zmwoezwkti.com,dga,3.23593,4,9,14,1,0.44444,0.23114,1,0,0,0,1,1,0,0,0,1
2172,hadron.ad.gt,legit,3.08496,3,7,12,0,0.42857,0.25708,4,0,0,0,4,1,0,0,0,1
7681,lcmpnmqsdmfak.net,dga,3.69012,2,14,17,1,0.14286,0.21707,0,0,0,0,0,0,0,0,0,0
1825,c.worldfcdn.com,legit,3.1899,2,11,15,0,0.18182,0.21266,2,1,0,0,3,2,0,0,0,2
5685,jvjfahmhcdbujcqd.eu,dga,3.57662,4,14,19,1,0.28571,0.18824,1,0,0,0,1,0,0,0,0,0
5167,etdzjygrexlvjuiyctlwkwk17n50e41cwn50.ru,dga,4.42618,6,24,39,1,0.25,0.11349,1,0,0,0,1,2,0,0,0,2
4520,apac.cc.skype.com,legit,3.10188,4,10,17,0,0.4,0.18246,2,0,0,0,2,1,0,0,0,1
166,msg.teams.microsoft.com,legit,3.38162,6,14,23,0,0.42857,0.14703,11,8,7,6,32,5,0,0,0,5
5587,pqtkyghc.us,dga,3.45943,1,9,11,1,0.11111,0.31449,0,0,0,0,0,0,0,0,0,0
7205,hqrjunbknqyqvc.info,dga,3.74741,3,15,19,1,0.2,0.19723,0,0,0,0,0,0,0,0,0,0
8655,3ro050gnmjah1hi2av5.ddns.net,dga,4.20897,5,14,28,1,0.35714,0.15032,3,1,0,0,4,4,3,2,2,11
715,truste.com,legit,3.12193,3,6,10,0,0.5,0.31219,3,0,0,0,3,2,0,0,0,2
3641,eur.loki.delve.office.com,legit,3.49366,10,11,25,0,0.90909,0.13975,6,4,4,3,17,6,1,0,0,7
4776,mmg.whatsapp.net,legit,3.375,3,11,16,0,0.27273,0.21094,3,1,0,0,4,1,0,0,0,1
6227,buokhhklcpkcsfgyfs.com,dga,3.66353,3,18,22,1,0.16667,0.16652,0,0,0,0,0,0,0,0,0,0
8731,gemefiwea.ddns.net,dga,3.39215,6,10,18,1,0.6,0.18845,4,1,0,0,5,7,4,3,2,16
1409,ums.acuityplatform.com,legit,3.69785,7,13,22,0,0.53846,0.16808,4,0,0,0,4,5,0,0,0,5
1128,secure.quantserve.com,legit,3.53517,8,11,21,0,0.72727,0.16834,5,1,1,0,7,6,2,1,0,9
9652,bcycxxcjmhmvi.net,dga,3.57247,2,14,17,1,0.14286,0.21015,0,0,0,0,0,0,0,0,0,0
3928,jwplatform.com,legit,3.52164,3,10,14,0,0.3,0.25155,2,0,0,0,2,3,0,0,0,3
1366,cm.mgid.com,legit,2.66353,2,7,11,0,0.28571,0.24214,1,0,0,0,1,0,0,0,0,0
2775,alexa-14.na.gateway.devices.a2z.com,legit,4.06873,12,14,35,0,0.85714,0.11625,9,1,0,0,10,8,1,0,0,9
1405,openxcdn.net,legit,3.02206,3,8,12,0,0.375,0.25184,3,1,0,0,4,2,0,0,0,2
1038,pull-cmaf-l16-va01.tiktokcdn.com,legit,4.11673,6,17,32,0,0.35294,0.12865,5,6,9,9,29,3,0,0,0,3
7938,atg4sdulqlc6c07454i05po.ddns.net,dga,4.20282,5,16,32,1,0.3125,0.13134,3,1,0,0,4,5,4,3,2,14
6253,kylltgiexthgho.ga,dga,3.45482,4,12,17,1,0.33333,0.20322,0,0,0,0,0,0,0,0,0,0
2249,12-courier.push.apple.com,legit,3.86347,8,11,25,0,0.72727,0.15454,9,4,3,2,18,4,0,0,0,4
1312,pancake.cdn-apple.com.akadns.net,legit,3.56643,9,18,32,0,0.5,0.11145,11,10,9,9,39,7,3,1,0,11
4325,ad-score.com,legit,3.25163,4,6,12,0,0.66667,0.27097,3,0,0,0,3,3,0,0,0,3
9456,tchriscalumodovenviris.com,dga,3.84411,9,16,26,1,0.5625,0.14785,1,0,0,0,1,5,2,0,1,8
9616,y8iky02k2seo.net,dga,3.5,4,7,16,1,0.57143,0.21875,1,0,0,0,1,1,0,0,0,1
8556,emkgwcoemqaqccaa.org,dga,3.34644,7,12,20,1,0.58333,0.16732,1,0,0,0,1,3,0,0,0,3
6272,nuruldefeng.com,dga,3.50689,5,9,15,1,0.55556,0.23379,1,0,0,0,1,2,0,0,0,2
5353,tripattractaccesspenfinance.com,dga,3.49873,10,20,31,1,0.5,0.11286,7,0,0,0,7,10,4,1,0,15
2778,cedexis.net,legit,3.02717,4,6,11,0,0.66667,0.2752,2,0,0,0,2,4,0,0,0,4
5408,jnauhinmnhucnyerm.net,dga,3.45853,6,14,21,1,0.42857,0.16469,2,0,0,0,2,2,0,0,0,2
4372,rbp.mxptint.net,legit,3.1899,2,11,15,0,0.18182,0.21266,5,0,0,0,5,2,0,0,0,2
2207,11-courier.push.apple.com,legit,3.78347,8,11,25,0,0.72727,0.15134,9,4,3,2,18,4,0,0,0,4
6879,mrueewva.com,dga,3.25163,5,6,12,1,0.83333,0.27097,0,0,0,0,0,0,0,0,0,0
6719,seihoqod.ru,dga,3.27761,5,5,11,1,1.0,0.29796,1,0,0,0,1,1,0,0,0,1
9057,o7qfaesyg7m3zlgify.ru,dga,4.01137,5,12,21,1,0.41667,0.19102,1,0,0,0,1,1,0,0,0,1
9562,yaxbp.li,dga,3.0,2,5,8,1,0.4,0.375,0,0,0,0,0,0,0,0,0,0
3559,stats.pandora.com,legit,3.33718,5,10,17,0,0.5,0.1963,5,0,0,0,5,7,1,0,0,8
6063,hljxbsmnxvrgniaejgyno.nf,dga,4.00163,4,19,24,1,0.21053,0.16673,0,0,0,0,0,1,0,0,0,1
1397,aan.amazon.com,legit,2.6645,6,6,14,0,1.0,0.19032,4,1,3,3,11,4,0,0,0,4
4205,public.wlhrm-a-10.prod.infra.webex.com,legit,4.23833,9,20,38,0,0.45,0.11154,7,4,3,2,16,4,2,0,0,6
9028,homafdid.ru,dga,3.27761,4,6,11,1,0.66667,0.29796,1,0,0,0,1,2,0,0,0,2
6519,s4ql6qpocoh7ez1iu2.cn,dga,4.1066,5,10,21,1,0.5,0.19555,1,0,0,0,1,1,0,0,0,1
5791,mbbbdmnfdoadfoaf.com,dga,3.03321,5,14,20,1,0.35714,0.15166,1,0,0,0,1,0,0,0,0,0
2026,atm-settingsfe-prod-geo2.trafficmanager.net,legit,3.91478,13,24,43,0,0.54167,0.09104,12,5,2,3,22,11,3,0,0,14
7602,glassbottom.net,dga,3.32323,4,10,15,1,0.4,0.22155,0,0,0,0,0,3,1,0,0,4
8224,wnpxezvhw.com,dga,3.54659,2,10,13,1,0.2,0.27281,0,0,0,0,0,0,0,0,0,0
9753,7czklkp85qhtsytrcb.net,dga,4.06148,1,17,22,1,0.05882,0.18461,0,0,0,0,0,0,0,0,0,0
3806,l.facebook.com,legit,3.18201,5,7,14,0,0.71429,0.22729,2,0,0,0,2,2,0,0,0,2
4160,sites.google.com,legit,3.20282,6,8,16,0,0.75,0.20018,5,5,4,3,17,5,0,0,0,5
5941,vvpgduipktvylvo.com,dga,3.61635,4,14,19,1,0.28571,0.19033,0,0,0,0,0,0,0,0,0,0
2822,com.itunes-apple.com.akadns.net,legit,3.84888,10,16,31,0,0.625,0.12416,11,9,9,9,38,8,3,1,0,12
4897,services.gfe.nvidia.com,legit,3.64249,8,12,23,0,0.66667,0.15837,7,2,1,1,11,5,2,1,0,8
2788,6sc.co,legit,2.25163,1,3,6,0,0.33333,0.37527,0,0,0,0,0,0,0,0,0,0
4870,by2.uservoice.com,legit,3.61687,6,8,17,0,0.75,0.21276,5,2,1,0,8,4,2,1,0,7
9836,casestaffstationexperience.com,dga,3.61925,12,17,30,1,0.70588,0.12064,10,0,0,0,10,14,7,3,1,25
2477,cdn.fluidpreview.office.net,legit,3.70805,9,15,27,0,0.6,0.13734,7,6,5,3,21,4,0,0,0,4
8373,tobm8vencv64sha37w.com,dga,4.0958,4,12,22,1,0.33333,0.18617,1,0,0,0,1,2,0,0,0,2
7483,ikvvfxbtxpouphody.com,dga,3.88018,5,15,21,1,0.33333,0.18477,1,0,0,0,1,0,0,0,0,0
4766,thumbs.redditmedia.com,legit,3.66353,7,13,22,0,0.53846,0.16652,3,0,0,0,3,4,0,0,0,4
4515,stats.paypal.com,legit,3.20282,4,10,16,0,0.4,0.20018,4,0,0,0,4,3,0,0,0,3
3780,probe.twitter.com,legit,3.33718,5,10,17,0,0.5,0.1963,6,1,0,0,7,4,2,0,0,6
1452,cs.media.net,legit,3.25163,4,6,12,0,0.66667,0.27097,3,0,0,0,3,1,0,0,0,1
8441,gereddifun.com,dga,3.52164,5,8,14,1,0.625,0.25155,4,0,0,0,4,5,1,0,0,6
6641,oigsrwiq.net,dga,3.4183,4,7,12,1,0.57143,0.28486,0,0,0,0,0,0,0,0,0,0
4281,samsungqbe.com,legit,3.52164,4,9,14,0,0.44444,0.25155,1,0,0,0,1,3,1,0,0,4
88,clients4.google.com,legit,3.47135,6,10,19,0,0.6,0.1827,5,6,4,3,18,2,1,0,0,3
2410,lf16-gecko-source.tiktokcdn.com,legit,4.02662,8,17,31,0,0.47059,0.12989,8,6,7,6,27,5,0,0,0,5
4183,scontent-dfw5-2.xx.fbcdn.net,legit,3.75343,3,18,28,0,0.16667,0.13405,7,3,0,0,10,5,2,0,0,7
9062,qbucrsfjpavxfyt.ki,dga,4.05881,3,14,18,1,0.21429,0.22549,1,0,0,0,1,0,0,0,0,0
5069,boikatbeepgoex.ddns.net,dga,3.654,8,13,23,1,0.61538,0.15887,3,1,0,0,4,6,3,2,1,12
3402,microsoft.com.akadns.net,legit,3.68872,7,14,24,0,0.5,0.1537,10,13,13,12,48,6,3,1,0,10
4553,ir.surveywall-api.survata.com,legit,3.90937,10,15,29,0,0.66667,0.13481,4,1,1,0,6,4,0,0,0,4
6963,ncaakfmlkddbomae.com,dga,3.44644,6,13,20,1,0.46154,0.17232,1,0,0,0,1,4,0,0,0,4
1336,oajs.openx.net,legit,3.23593,5,7,14,0,0.71429,0.23114,2,0,0,0,2,1,0,0,0,1
7007,sowieuiossmesgew.org,dga,3.14644,9,10,20,1,0.9,0.15732,2,0,0,0,2,2,0,0,0,2
9811,somehowhonduras.hn,dga,3.41938,6,11,18,1,0.54545,0.18997,2,0,0,0,2,5,0,0,0,5
3853,oauth.ring.com,legit,3.52164,5,7,14,0,0.71429,0.25155,1,0,0,0,1,2,2,0,0,4
3056,flightproxy-noam-teams.trafficmanager.net,legit,4.0555,12,25,41,0,0.48,0.09891,13,4,1,3,21,9,2,0,0,11
3407,analytics-log.classlink.io,legit,3.53641,8,15,26,0,0.53333,0.13602,6,0,0,0,6,6,1,0,0,7
7575,esvjsyeoya.info,dga,3.37356,6,8,15,1,0.75,0.2249,1,0,0,0,1,1,0,1,0,2
1422,weather-edge.apple.com,legit,3.65899,8,11,22,0,0.72727,0.16632,11,6,4,2,23,6,1,1,1,9
4390,digital-cloud.medallia.com,legit,3.53641,10,13,26,0,0.76923,0.13602,7,3,2,1,13,3,1,0,0,4
8801,fbuianfp.co.nz,dga,3.37878,4,8,14,1,0.5,0.24134,3,1,0,0,4,2,1,0,0,3
1163,cdn-apple.com.akadns.net,legit,3.65727,6,14,24,0,0.42857,0.15239,11,10,9,9,39,5,3,1,0,9
9518,rhqnoqhybi.com,dga,3.37878,3,10,14,1,0.3,0.24134,0,0,0,0,0,0,0,0,0,0
9992,tomckdzzudc.net,dga,3.37356,3,11,15,1,0.27273,0.2249,0,0,0,0,0,1,0,0,0,1
6410,presentesopinaripapampen.com,dga,3.41023,11,16,28,1,0.6875,0.12179,11,1,0,0,12,9,2,0,0,11
4977,ktpx.amazon.com,legit,3.37356,4,9,15,0,0.44444,0.2249,4,1,3,3,11,3,0,0,0,3
597,firebaseinstallations.googleapis.com,legit,3.79465,15,19,36,0,0.78947,0.10541,14,6,4,4,28,14,3,2,1,20
9593,isixehacug.ddns.net,dga,3.61635,6,11,19,1,0.54545,0.19033,2,1,0,0,3,7,3,3,2,15
2461,apple.imap.mail.yahoo.com,legit,3.27327,10,11,25,0,0.90909,0.13093,9,3,2,2,16,2,0,0,0,2
8256,4b7t4mlkes3qak8uh5.net,dga,4.0958,4,11,22,1,0.36364,0.18617,1,0,0,0,1,1,0,0,0,1
154,weather-data.apple.com,legit,3.60694,8,11,22,0,0.72727,0.16395,9,4,3,2,18,5,1,1,1,8
6853,aaoffmaablafaanm.co.uk,dga,3.07732,10,10,22,1,1.0,0.13988,4,2,0,0,6,4,1,0,0,5
5273,pojabxlinexbhnxzsra.com,dga,3.969,6,16,23,1,0.375,0.17257,3,0,0,0,3,3,1,0,0,4
8430,myk27a57bviqbybzdydzh24dtdwn40m39pql48.net,dga,4.52887,3,26,42,1,0.11538,0.10783,0,0,0,0,0,0,0,0,0,0
3921,hsleadflows.net,legit,3.50689,4,10,15,0,0.4,0.23379,4,0,0,0,4,2,0,0,0,2
729,aws.api.snapchat.com,legit,3.38418,6,11,20,0,0.54545,0.16921,5,2,1,0,8,1,1,0,0,2
668,u.openx.net,legit,2.91398,4,5,11,0,0.8,0.26491,1,0,0,0,1,1,0,0,0,1
5730,odolimtiux.ddns.net,dga,3.47135,6,11,19,1,0.54545,0.1827,4,1,0,0,5,5,3,2,1,11
519,eastus.cloudapp.azure.com,legit,3.67327,10,12,25,0,0.83333,0.14693,12,5,3,4,24,4,0,0,0,4
1016,lb.eu-1-id5-sync.com,legit,3.88418,4,9,20,0,0.44444,0.19421,0,0,0,0,0,0,0,0,0,0
1466,com.edgesuite.net,legit,3.38158,7,8,17,0,0.875,0.19892,5,4,2,0,11,8,1,0,0,9
7289,rusitcbfsmm.tv,dga,3.37878,2,11,14,1,0.18182,0.24134,1,0,0,0,1,2,0,0,0,2
5409,ignecad.com,dga,3.27761,4,6,11,1,0.66667,0.29796,1,0,0,0,1,3,0,0,0,3
1411,intel.com,legit,3.16993,3,5,9,0,0.6,0.35221,3,0,0,0,3,3,0,1,0,4
8900,eilkkueoya.biz,dga,3.37878,7,6,14,1,1.16667,0.24134,0,0,0,0,0,0,0,1,0,1
8025,otxsutepcrwki.co.uk,dga,3.61635,6,11,19,1,0.54545,0.19033,4,1,0,0,5,3,1,0,0,4
3597,teads.tv.edgekey.net,legit,3.16596,6,11,20,0,0.54545,0.1583,8,2,1,0,11,4,0,0,0,4
443,pr-bh.ybp.yahoo.com,legit,3.32636,4,11,19,0,0.36364,0.17507,3,0,0,1,4,0,0,0,0,0
6595,reofiduw.ddns.net,dga,3.45482,5,10,17,1,0.5,0.20322,4,1,0,0,5,5,3,3,2,13
8323,edikgmilnwlaa.info,dga,3.57243,7,10,18,1,0.7,0.19847,2,0,0,0,2,3,0,0,0,3
4937,backend-xpress.jabra.com,legit,3.88684,6,15,24,0,0.4,0.16195,6,0,0,0,6,6,2,0,0,8
5985,secuergosimuteo.com,dga,3.32636,9,9,19,1,1.0,0.17507,3,0,0,0,3,5,0,0,0,5
1929,mediawallahscript.com,legit,3.78494,7,13,21,0,0.53846,0.18024,2,0,0,0,2,3,0,0,0,3
9610,viljanmo.ru,dga,3.45943,4,6,11,1,0.66667,0.31449,0,0,0,0,0,1,0,0,0,1
7680,sofonguhedd.com,dga,3.45656,5,9,15,1,0.55556,0.23044,3,1,0,0,4,3,0,0,0,3
5122,vvuyetphpoam.com,dga,3.5,5,10,16,1,0.5,0.21875,1,0,0,0,1,2,0,0,0,2
2387,live.primis.tech,legit,3.45282,5,9,16,0,0.55556,0.2158,4,1,0,0,5,4,0,0,0,4
2057,mcc310.pub.3gppnetwork.org,legit,3.95006,4,15,26,0,0.26667,0.15193,1,0,0,0,1,3,0,0,0,3
797,android.com,legit,3.0958,4,6,11,0,0.66667,0.28144,1,0,0,0,1,2,1,0,0,3
3421,japanwest.cloudapp.azure.com,legit,3.89629,10,15,28,0,0.66667,0.13915,10,4,3,4,21,4,1,0,0,5
6626,pv1dr4b2ww8j2rqxb6.biz,dga,3.97057,1,14,22,1,0.07143,0.18048,0,0,0,0,0,0,0,0,0,0
6220,q8sjexy8cpmpwpq434m.ddns.net,dga,3.99468,2,19,28,1,0.10526,0.14267,2,1,0,0,3,4,3,2,2,11
1472,lenovo.com,legit,2.84644,4,5,10,0,0.8,0.28464,2,0,0,0,2,2,0,0,0,2
3994,tag.yieldoptimizer.com,legit,3.78875,8,12,22,0,0.66667,0.17222,4,0,0,0,4,5,0,0,0,5
5954,ajmropitmnixibi.ddns.net,dga,3.72018,7,15,24,1,0.46667,0.15501,4,1,0,0,5,6,4,3,2,15
7973,awufdar.com,dga,3.27761,4,6,11,1,0.66667,0.29796,0,0,0,0,0,1,0,0,0,1
3025,www3.zoom.us,legit,2.85539,3,6,12,0,0.5,0.23795,1,0,0,0,1,1,0,0,0,1
1449,a.teads.tv,legit,2.72193,3,5,10,0,0.6,0.27219,5,0,0,0,5,2,0,0,0,2
3209,adingo.jp,legit,3.16993,3,5,9,0,0.6,0.35221,2,0,0,0,2,1,1,0,0,2
393,ybp.yahoo.com,legit,3.02699,4,7,13,0,0.57143,0.23285,2,0,0,1,3,0,0,0,0,0
2158,pull-q5-gcp01.tiktokcdn.com.c.bytefcdn-oversea.com,legit,4.41617,10,29,50,0,0.34483,0.08832,10,10,12,10,42,9,5,1,0,15
6148,a2inmr3l3har74a.ddns.net,dga,3.85539,5,12,24,1,0.41667,0.16064,3,1,0,0,4,6,4,3,2,15
1827,api.vungle.com,legit,3.6645,5,7,14,0,0.71429,0.26175,3,2,1,0,6,1,0,0,0,1
614,braze.com,legit,3.16993,3,5,9,0,0.6,0.35221,1,0,0,0,1,1,0,0,0,1
841,inmobi.com,legit,2.72193,4,5,10,0,0.8,0.27219,1,0,0,0,1,1,0,0,0,1
4963,smoot-feedback.v.aaplimg.com,legit,3.98523,9,15,28,0,0.6,0.14233,6,0,0,0,6,2,0,0,0,2
4965,api.appcues.net,legit,3.1899,6,7,15,0,0.85714,0.21266,5,3,2,0,10,1,0,0,0,1
6216,glgrqp1fed30i6u0gpo.ddns.net,dga,4.11058,5,16,28,1,0.3125,0.14681,3,1,0,0,4,5,4,3,2,14
6659,mfjpcdcagr.yi.org,dga,3.61687,3,12,17,1,0.25,0.21276,1,0,0,0,1,1,0,0,0,1
895,teams.nel.measure.office.net,legit,3.53915,11,13,28,0,0.84615,0.1264,10,4,4,3,21,10,0,0,0,10
6317,mykgmmieoiksewao.org,dga,3.44644,8,11,20,1,0.72727,0.17232,2,0,0,0,2,2,0,0,0,2
3342,rakuten.com,legit,3.45943,4,6,11,0,0.66667,0.31449,3,0,0,0,3,3,0,0,0,3
9916,jgjdqhsqtwnryb.pw,dga,3.73452,0,16,17,1,0.0,0.21968,0,0,0,0,0,0,0,0,0,0
4039,pull-lls-l11-sg01.tiktokcdn.com,legit,3.88583,4,18,31,0,0.22222,0.12535,4,6,9,9,28,2,0,0,0,2
3315,windows.us,legit,2.92193,3,6,10,0,0.5,0.29219,1,0,0,0,1,2,0,0,0,2
1125,idsync.analytics.yahoo.com,legit,3.55527,8,15,26,0,0.53333,0.13674,6,0,0,1,7,3,0,0,0,3
2805,htlb.casalemedia.com.cdn.cloudflare.net,legit,3.84016,12,22,39,0,0.54545,0.09847,9,8,6,3,26,11,2,1,0,14
1737,www.datadoghq-browser-agent.com,legit,3.93775,8,19,31,0,0.42105,0.12702,10,3,0,0,13,7,2,0,0,9
6265,jpttdiltpyki.net,dga,3.25,3,12,16,1,0.25,0.20312,0,0,0,0,0,0,0,0,0,0
5134,xoseolat.ru,dga,3.27761,5,5,11,1,1.0,0.29796,2,0,0,0,2,3,0,0,0,3
9017,figaeludgeakugd.ddns.net,dga,3.52206,8,14,24,1,0.57143,0.14675,5,2,0,0,7,7,3,2,1,13
6162,4a8e464642ki.org,dga,3.375,4,3,16,1,1.33333,0.21094,0,0,0,0,0,0,0,0,0,0
3427,a13lrv2jf2efa0-ats.iot.us-west-2.amazonaws.com,legit,4.25119,13,20,46,0,0.65,0.09242,9,1,3,3,16,6,1,0,0,7
3983,gsp57-ssl-locus.ls.apple.com,legit,3.55309,5,16,28,0,0.3125,0.1269,8,4,3,2,17,1,0,0,0,1
5812,ip56qlknkrmv1befmdq.ddns.net,dga,4.11058,3,20,28,1,0.15,0.14681,2,1,0,0,3,5,3,3,2,13
759,twimg.com,legit,2.9477,2,6,9,0,0.33333,0.32752,0,0,0,0,0,0,0,0,0,0
7687,m29n20gvcxarezm19dspygqp62h64o41gvjrjz.net,dga,4.59447,4,25,42,1,0.16,0.10939,2,0,0,0,2,2,0,0,0,2
762,publisher-services.amazon.dev,legit,4.07333,10,16,29,0,0.625,0.14046,11,3,4,4,22,9,3,1,0,13
4570,na01.safelinks.protection.outlook.com,legit,3.93865,13,18,37,0,0.72222,0.10645,11,2,1,0,14,6,3,1,1,11
475,zemanta.com,legit,3.0958,4,6,11,0,0.66667,0.28144,3,0,0,0,3,4,0,0,0,4
8232,mziwe41n10d60h44hqo41mrori65d30cwl58m69or.ru,dga,4.32819,7,18,44,1,0.38889,0.09837,1,0,0,0,1,2,0,0,0,2
6276,kfcsctjmhnpiaowpm.in,dga,3.82193,4,15,20,1,0.26667,0.1911,1,0,0,0,1,0,0,0,0,0
7295,bpxiuoudcl.com,dga,3.37878,5,8,14,1,0.625,0.24134,1,1,0,0,2,0,0,0,0,0
9879,dcecldfnfbcbdbnb.co.uk,dga,3.2433,3,17,22,1,0.17647,0.14742,3,1,0,0,4,3,1,0,0,4
7645,xecjhmpgmtf.dynserv.com,dga,4.05596,3,18,23,1,0.16667,0.17635,3,1,1,0,5,5,5,5,4,19
3124,apple.com.edgekey.net.globalredir.akadns.net,legit,3.88157,14,24,44,0,0.58333,0.08822,14,11,9,6,40,10,3,1,0,14
2331,warp.media.net,legit,3.37878,5,7,14,0,0.71429,0.24134,3,0,0,0,3,2,0,0,0,2
2307,amp-api.media.apple.com,legit,3.24053,9,10,23,0,0.9,0.14089,9,5,4,2,20,3,0,0,0,3
7700,fodoafdbcdlnkakf.com,dga,3.30869,5,14,20,1,0.35714,0.16543,1,0,0,0,1,0,0,0,0,0
2234,9-courier.push.apple.com,legit,3.77206,8,11,24,0,0.72727,0.15717,9,4,3,2,18,4,0,0,0,4
1799,audrte.com,legit,3.32193,4,5,10,0,0.8,0.33219,1,0,0,0,1,1,0,0,0,1
7523,sqhmrsuiwcymao.info,dga,3.82687,6,12,19,1,0.5,0.20141,1,0,0,0,1,2,0,5,4,11
1482,eum-appdynamics.com,legit,3.68188,6,11,19,0,0.54545,0.19378,5,2,0,0,7,3,1,0,0,4
4657,ch-trc-events.taboola.com,legit,3.75327,7,14,25,0,0.5,0.15013,6,1,0,0,7,4,1,0,0,5
1842,bounceexchange.com,legit,3.41938,7,10,18,0,0.7,0.18997,3,0,0,0,3,3,2,0,0,5
5507,zcoef.in,dga,3.0,3,4,8,1,0.75,0.375,1,0,0,0,1,1,0,0,0,1
2486,r3.i.lencr.org,legit,3.12809,3,7,14,0,0.42857,0.22344,3,0,0,0,3,2,0,0,0,2
9953,qiqpurrxpnwgk.com,dga,3.73452,3,13,17,1,0.23077,0.21968,0,0,0,0,0,0,0,0,0,0
6365,edtgoxcpcmdekrjy.eu,dga,3.78714,5,13,19,1,0.38462,0.19932,1,0,0,0,1,2,0,0,0,2
4336,netseer-ipaddr-assoc.xz.fbcdn.net,legit,3.92259,8,20,33,0,0.4,0.11887,5,1,0,0,6,7,1,0,0,8
5322,universityavoidpeakcalculate.com,dga,3.99173,14,17,32,1,0.82353,0.12474,4,0,0,0,4,10,3,0,0,13
6612,gbnmdvfnpkvjunfy.com,dga,3.78418,2,17,20,1,0.11765,0.18921,0,0,0,0,0,0,0,0,0,0
304,msftncsi.com,legit,3.08496,2,9,12,0,0.22222,0.25708,0,0,0,0,0,1,0,0,0,1
2972,mobile-data.onetrust.io,legit,3.76227,10,10,23,0,1.0,0.16358,6,0,0,0,6,7,1,0,0,8
5778,oiihehndokmwamdqc.net,dga,3.72565,7,13,21,1,0.53846,0.17741,1,0,0,0,1,2,0,0,0,2
9204,glanvillecharisma.net,dga,3.65376,7,13,21,1,0.53846,0.17399,2,0,0,0,2,8,2,1,0,11
5231,girlfriendslightclaimdiscuss.com,dga,3.84002,9,22,32,1,0.40909,0.12,4,0,0,0,4,5,0,0,0,5
3581,prod-classifyclient.normandy.prod.cloudops.mozgcp.net,legit,4.1169,13,34,53,0,0.38235,0.07768,12,8,6,4,30,8,4,0,0,12
633,search.spotxchange.com,legit,3.69785,6,14,22,0,0.42857,0.16808,3,0,0,0,3,5,1,0,0,6
8340,hjtwtvpvylncuwmb.eu,dga,3.82687,3,15,19,1,0.2,0.20141,0,0,0,0,0,0,0,0,0,0
392,tapad.com,legit,2.9477,3,5,9,0,0.6,0.32752,3,0,0,0,3,1,0,0,0,1
9780,ndnbmkabmcoekafa.co,dga,3.36609,6,12,19,1,0.5,0.17716,2,0,0,0,2,3,0,0,0,3
6966,wdxfjcmtmjt.com,dga,3.1899,1,13,15,1,0.07692,0.21266,0,0,0,0,0,0,0,0,0,0
5446,ybckvhqrrjwlrmcp.eu,dga,3.89241,2,16,19,1,0.125,0.20486,0,0,0,0,0,0,0,0,0,0
3571,view.adjust.com,legit,3.77356,5,8,15,0,0.625,0.25157,4,0,0,0,4,1,0,0,0,1
5150,afomdbdmdnnbnabc.com,dga,3.07095,4,15,20,1,0.26667,0.15355,1,0,0,0,1,2,0,0,0,2
3789,wc.yahoodns.net,legit,3.50689,4,9,15,0,0.44444,0.23379,2,1,0,1,4,2,1,0,0,3
9107,unwahas.com,dga,3.27761,4,6,11,1,0.66667,0.29796,0,0,0,0,0,1,0,0,0,1
8627,gwendolineainsworth.net,dga,3.62118,8,14,23,1,0.57143,0.15744,4,0,0,0,4,7,1,0,0,8
2863,array607.prod.do.dsp.mp.microsoft.com,legit,3.71259,8,20,37,0,0.4,0.10034,12,12,10,9,43,5,2,0,0,7
1495,apheleia-a.wbx2.com,legit,3.78714,7,8,19,0,0.875,0.19932,2,0,0,0,2,2,0,0,0,2
6771,wkbvevbovyefqd.net,dga,3.53049,4,13,18,1,0.30769,0.19614,0,0,0,0,0,1,0,0,0,1
7644,ulkoibdueti.ddns.net,dga,3.48418,7,11,20,1,0.63636,0.17421,3,1,0,0,4,6,4,3,2,15
3741,ads.celtra.com,legit,3.37878,4,8,14,0,0.5,0.24134,6,0,0,0,6,3,1,0,0,4
1070,onenote.net,legit,2.23127,5,5,11,0,1.0,0.20284,3,0,0,0,3,4,1,0,0,5
4981,samsungpositioning.com,legit,3.41309,8,13,22,0,0.61538,0.15514,4,0,0,0,4,8,3,1,0,12
4297,wd.adcolony.com,legit,3.1899,4,9,15,0,0.44444,0.21266,6,0,0,0,6,2,0,0,0,2
6008,kalobecbabldefda.website,dga,3.55351,9,14,24,1,0.64286,0.14806,1,0,0,0,1,3,0,0,0,3
1897,blismedia.com,legit,3.39275,5,7,13,0,0.71429,0.26098,2,0,0,0,2,2,0,0,0,2
1192,sync.targeting.unrulymedia.com,legit,3.92323,9,18,30,0,0.5,0.13077,6,0,0,0,6,7,1,0,0,8
1646,teams.trafficmanager.net,legit,3.43872,8,14,24,0,0.57143,0.14328,10,3,1,3,17,9,1,0,0,10
6908,hwwjgnhhryry.com,dga,3.32782,1,14,16,1,0.07143,0.20799,0,0,0,0,0,0,0,0,0,0
2878,ade.clmbtech.com,legit,3.32782,4,10,16,0,0.4,0.20799,4,0,0,0,4,3,0,0,0,3
361,fpc.msedge.net,legit,3.32486,3,9,14,0,0.33333,0.23749,4,2,1,0,7,3,0,0,0,3
1143,ssp-sync.criteo.com,legit,3.53689,4,12,19,0,0.33333,0.18615,3,0,0,0,3,3,0,0,0,3
2831,cdn.forter.com,legit,3.23593,3,9,14,0,0.33333,0.23114,4,2,1,0,7,4,1,0,0,5
8602,i0u428ywqs6k.net,dga,4.0,3,7,16,1,0.42857,0.25,0,0,0,0,0,0,0,0,0,0
3669,pndsn.com,legit,2.9477,1,7,9,0,0.14286,0.32752,1,0,0,0,1,1,0,0,0,1
3786,p16.tiktokcdn-us.com,legit,3.82193,4,11,20,0,0.36364,0.1911,5,6,7,6,24,2,0,0,0,2
5859,3q5mb5go8krlgn3nyf.ru,dga,3.91613,2,13,21,1,0.15385,0.18648,0,0,0,0,0,0,0,0,0,0
4448,www.homedepot.com,legit,3.17512,5,10,17,0,0.5,0.18677,1,0,0,0,1,3,0,0,0,3
9105,bottleholdpeakconcerntower.com,dga,3.73624,10,19,30,1,0.52632,0.12454,7,1,0,0,8,6,2,0,0,8
6132,cjkpk4e8mry0101.ddns.net,dga,4.00163,2,14,24,1,0.14286,0.16673,2,1,0,0,3,4,3,2,1,10
2384,powerapps.com,legit,3.18083,4,8,13,0,0.5,0.24468,4,1,0,0,5,2,0,0,0,2
8031,mehworedbaatepbef.net,dga,3.55376,8,12,21,1,0.66667,0.16923,4,0,0,0,4,6,1,0,0,7
3471,assoc-na.associates-amazon.com,legit,3.31108,12,14,30,0,0.85714,0.11037,7,1,3,2,13,7,2,0,0,9
1047,rules.quantcount.com,legit,3.58418,7,11,20,0,0.63636,0.17921,6,0,0,0,6,4,0,0,0,4
929,script.hotjar.com,legit,3.49923,4,11,17,0,0.36364,0.20584,1,0,0,0,1,2,0,0,0,2
7895,hmbijcbagt.com,dga,3.37878,3,10,14,1,0.3,0.24134,0,0,0,0,0,0,0,0,0,0
647,svc.ms,legit,2.25163,0,5,6,0,0.0,0.37527,0,0,0,0,0,0,0,0,0,0
4692,analytics.tiktok.com.bytewlb.akadns.net,legit,3.83081,10,24,39,0,0.41667,0.09823,10,11,10,7,38,8,3,1,0,12
4379,www.tm.lg.prod.aadmsa.trafficmanager.net,legit,3.82095,10,24,40,0,0.41667,0.09552,11,7,4,5,27,6,2,0,0,8
2140,match.sync.ad.cpe.dotomi.com,legit,3.55309,7,16,28,0,0.4375,0.1269,9,0,0,0,9,5,1,0,0,6
7472,kujeimam.ru,dga,3.0958,5,5,11,1,1.0,0.28144,2,0,0,0,2,2,0,0,0,2
9097,cihuahergoteeni.ddns.net,dga,3.63684,9,13,24,1,0.69231,0.15154,5,1,0,0,6,8,5,3,2,18
246,us-prod.asyncgw.teams.microsoft.com,legit,4.00043,9,21,35,0,0.42857,0.1143,15,11,9,7,42,6,1,0,0,7
4475,microad.jp,legit,3.32193,3,6,10,0,0.5,0.33219,5,3,2,1,11,2,0,0,0,2
641,srtb.msn.com,legit,3.08496,1,9,12,0,0.11111,0.25708,1,0,0,0,1,0,0,0,0,0
7452,wwmcuisigmciewem.org,dga,3.30869,7,12,20,1,0.58333,0.16543,0,0,0,0,0,3,0,0,0,3
4001,s.symcb.com,legit,2.73216,1,8,11,0,0.125,0.24838,1,0,0,0,1,0,0,0,0,0
3988,dt-external-217593033.us-east-1.elb.amazonaws.com,legit,4.39279,12,19,49,0,0.63158,0.08965,9,2,3,3,17,9,1,0,0,10
3925,cdn9.forter.com,legit,3.37356,3,9,15,0,0.33333,0.2249,4,1,0,0,5,4,1,0,0,5
5824,gfqcpaifkxd.bit,dga,3.64022,3,11,15,1,0.27273,0.24268,0,0,0,0,0,0,0,0,0,0
3731,public.wfram-a-1.prod.infra.webex.com,legit,4.09812,10,19,37,0,0.52632,0.11076,8,4,3,2,17,5,2,0,0,7
1170,postrelease.com,legit,3.32323,6,8,15,0,0.75,0.22155,5,0,0,0,5,7,0,0,0,7
2757,cdn.parsely.com,legit,3.64022,3,10,15,0,0.3,0.24268,3,2,1,0,6,4,0,0,0,4
4043,common-geo.ha.1drv.com,legit,3.57262,6,11,22,0,0.54545,0.16239,3,1,0,0,4,4,1,0,0,5
7960,bswqerpxpvwko.ru,dga,3.625,3,12,16,1,0.25,0.22656,1,0,0,0,1,1,0,0,0,1
431,icloud-content.com,legit,3.41938,6,10,18,0,0.6,0.18997,8,5,2,1,16,5,2,0,0,7
5597,semiwwiculs.com,dga,3.24022,5,9,15,1,0.55556,0.21601,3,0,0,0,3,4,0,0,0,4
390,bluekai.com,legit,3.45943,5,5,11,0,1.0,0.31449,0,0,0,0,0,0,0,0,0,0
273,adobe.com,legit,2.9477,4,4,9,0,1.0,0.32752,1,0,0,0,1,1,0,0,0,1
1943,adblockplus.org,legit,3.64022,4,10,15,0,0.4,0.24268,4,0,0,0,4,0,0,0,0,0
7092,clubtreewarprograminvest.com,dga,3.99468,9,18,28,1,0.5,0.14267,9,1,0,0,10,9,2,0,0,11
3847,log-gateway.zoom.us,legit,3.68188,7,9,19,0,0.77778,0.19378,4,0,0,0,4,3,1,0,0,4
4891,admedo.com,legit,2.72193,4,5,10,0,0.8,0.27219,2,0,0,0,2,1,0,0,0,1
8781,gmammekkwaakmkos.org,dga,3.08418,6,13,20,1,0.46154,0.15421,2,0,0,0,2,2,0,0,0,2
2708,vcs16-platform-useast5.us.tiktokv.com,legit,4.14162,9,20,37,0,0.45,0.11194,9,6,4,3,22,8,0,0,0,8
6989,iueayyqqukkuwaic.org,dga,3.58418,9,10,20,1,0.9,0.17921,2,0,0,0,2,2,0,0,0,2
4420,media-ecst.licdn.com,legit,3.58418,6,11,20,0,0.54545,0.17921,6,1,0,0,7,5,0,0,0,5
3655,sync.e-volution.ai,legit,3.72548,7,8,18,0,0.875,0.20697,2,0,0,0,2,2,2,1,0,5
7216,xerykcbtcpts.com,dga,3.57782,2,13,16,1,0.15385,0.22361,1,0,0,0,1,1,0,0,0,1
3312,clients.config.office.akadns.net,legit,3.65564,10,18,32,0,0.55556,0.11424,14,10,8,6,38,7,4,0,0,11
200,ogs.google.com,legit,2.75343,5,7,14,0,0.71429,0.19667,3,5,4,3,15,1,0,0,0,1
555,static.criteo.net,legit,3.14629,6,9,17,0,0.66667,0.18508,8,0,0,0,8,8,1,0,0,9
1787,b.akamai.net,legit,3.02206,5,5,12,0,1.0,0.25184,3,3,4,3,13,2,0,0,0,2
2428,mab.chartbeat.com,legit,3.21953,5,10,17,0,0.5,0.18938,4,0,0,0,4,5,1,1,0,7
1819,ls.apple.com.edgekey.net,legit,3.60123,7,13,24,0,0.53846,0.15005,11,9,6,4,30,5,2,1,0,8
1694,prebid.adnxs.com,legit,3.75,4,10,16,0,0.4,0.23438,6,0,0,0,6,2,0,0,0,2
5133,tribal-error.hn,dga,3.37356,4,9,15,1,0.44444,0.2249,2,0,0,0,2,3,0,0,0,3
2962,mobile.events.data.trafficmanager.net,legit,3.80475,13,20,37,0,0.65,0.10283,14,4,1,3,22,12,2,0,0,14
9824,eluiadjmfrybw.ru,dga,3.75,5,10,16,1,0.5,0.23438,1,0,0,0,1,1,0,0,0,1
2765,trouter.gcc.teams.microsoft.com,legit,3.48614,9,18,31,0,0.5,0.11246,13,8,7,6,34,6,1,0,0,7
2648,onedscolprdeus02.eastus.cloudapp.azure.com,legit,3.89185,15,21,42,0,0.71429,0.09266,17,5,3,4,29,9,1,0,0,10
7720,xdwrxaryumrksf.com,dga,3.68354,3,14,18,1,0.21429,0.20464,0,0,0,0,0,1,0,0,0,1
5370,zwpvyqskszhxswr.info,dga,3.88418,2,17,20,1,0.11765,0.19421,0,0,0,0,0,0,0,0,0,0
1166,adroll.com,legit,2.92193,3,6,10,0,0.5,0.29219,2,0,0,0,2,0,0,0,0,0
4815,wix.com,legit,2.80735,2,4,7,0,0.5,0.40105,0,0,0,0,0,0,0,0,0,0
1184,ic3.events.data.microsoft.com,legit,3.74541,9,15,29,0,0.6,0.12915,12,9,7,6,34,7,1,0,0,8
8685,csrdscqpsa.com,dga,3.12809,2,11,14,1,0.18182,0.22344,1,0,0,0,1,0,0,0,0,0
5191,augendeequamuna.com,dga,3.28663,10,8,19,1,1.25,0.17298,3,0,0,0,3,5,0,0,0,5
6994,dyela.co.cr,dga,3.0958,3,6,11,1,0.5,0.28144,2,1,0,0,3,3,1,0,0,4
5502,o0o01f10s61v5va.ddns.net,dga,3.68872,4,10,24,1,0.4,0.1537,2,1,0,0,3,4,4,3,2,13
3073,array509.prod.do.dsp.mp.microsoft.com,legit,3.71259,8,20,37,0,0.4,0.10034,12,12,10,9,43,5,2,0,0,7
858,ecn.dev.virtualearth.net,legit,3.52206,8,13,24,0,0.61538,0.14675,3,0,0,0,3,6,0,0,0,6
7322,rsuvpt.dynserv.com,dga,3.72548,3,13,18,1,0.23077,0.20697,3,1,1,0,5,5,5,5,4,19
1079,me.com,legit,2.25163,2,3,6,0,0.66667,0.37527,0,0,0,0,0,0,0,0,0,0
4282,hungryroot.com,legit,3.32486,4,9,14,0,0.44444,0.23749,2,0,0,0,2,0,0,0,0,0
7498,vfhnitwaxunrnmvturaq.mn,dga,3.654,5,17,23,1,0.29412,0.15887,1,0,0,0,1,3,1,0,0,4
6560,kafteawa.ru,dga,3.02717,5,5,11,1,1.0,0.2752,2,0,0,0,2,2,0,0,0,2
1835,d.applovin.com,legit,3.37878,4,8,14,0,0.5,0.24134,7,3,2,1,13,1,0,0,0,1
6118,nkoyxkbearyyw.com,dga,3.57247,4,12,17,1,0.33333,0.21015,1,0,0,0,1,3,0,0,0,3
379,msedge.api.cdp.microsoft.com,legit,3.65505,8,16,28,0,0.5,0.13054,16,12,9,7,44,5,0,0,0,5
2922,pull-f5-sg01.fcdn.us.tiktokv.com.c.worldfcdn2.com,legit,4.23663,7,29,49,0,0.24138,0.08646,8,10,9,5,32,5,2,1,0,8
1391,ssp.disqus.com,legit,3.09307,3,9,14,0,0.33333,0.22093,3,0,0,0,3,2,0,0,0,2
6178,wyqcgiiugkeq.net,dga,3.5,5,10,16,1,0.5,0.21875,0,0,0,0,0,0,0,3,2,5
7879,omnpetruscepropter.com,dga,3.32218,7,14,22,1,0.5,0.15101,6,1,0,0,7,5,2,0,0,7
7170,qvlluiuetgpp.com,dga,3.625,5,10,16,1,0.5,0.22656,1,0,0,0,1,1,0,0,0,1
2923,onedscolprdcus10.centralus.cloudapp.azure.com,legit,3.91643,14,25,45,0,0.56,0.08703,19,5,3,4,31,8,3,0,0,11
9303,zejlwq8otwfhqwqyac.biz,dga,3.93626,4,16,22,1,0.25,0.17892,0,0,0,0,0,1,0,0,0,1
9557,lhxoybxlppoi.pw,dga,3.1899,3,11,15,1,0.27273,0.21266,1,0,0,0,1,0,0,0,0,0
7804,mthwprprbmuyaw.su,dga,3.49923,3,13,17,1,0.23077,0.20584,1,0,0,0,1,0,0,0,0,0
9433,awempmvxhdrdbxficu.com,dga,3.97057,5,16,22,1,0.3125,0.18048,1,1,0,0,2,2,0,0,0,2
7494,eobrgdsadnc.cc,dga,3.32486,3,10,14,1,0.3,0.23749,3,0,0,0,3,1,0,0,0,1
8595,78ro6eazeweoy7ilzy.net,dga,3.73216,8,9,22,1,0.88889,0.16964,2,0,0,0,2,1,0,0,0,1
3843,na.albtls.t.co,legit,3.03915,3,8,14,0,0.375,0.21708,3,0,0,0,3,0,0,0,0,0
140,loki.delve.office.com,legit,3.3321,8,10,21,0,0.8,0.15867,6,4,4,3,17,6,1,0,0,7
3539,events.mapbox.com,legit,3.61687,5,10,17,0,0.5,0.21276,6,1,0,0,7,3,1,0,0,4
8948,ussoosemqcscieoa.org,dga,3.32193,9,10,20,1,0.9,0.1661,3,0,0,0,3,2,0,0,0,2
8145,bdcafobmobfnalme.com,dga,3.30869,6,13,20,1,0.46154,0.16543,0,0,0,0,0,1,0,0,0,1
9933,quasgraprorsusverborum.com,dga,3.55143,9,16,26,1,0.5625,0.13659,6,1,0,0,7,6,2,0,0,8
439,public.cdn.office.net,legit,3.55852,6,12,21,0,0.5,0.16945,7,6,5,3,21,3,0,0,0,3
6380,gsucoiglverhycdevc.cx,dga,3.72565,5,15,21,1,0.33333,0.17741,3,0,0,0,3,5,1,0,0,6
1363,aniview.com,legit,3.27761,5,5,11,0,1.0,0.29796,0,0,0,0,0,2,0,0,0,2
978,searchhighlights.bing.com,legit,3.70347,6,17,25,0,0.35294,0.14814,5,0,0,0,5,4,1,0,0,5
7155,ruhzeuwoze.com,dga,3.23593,6,7,14,1,0.85714,0.23114,0,0,0,0,0,0,0,0,0,0
6149,uetphmekjmjql.com,dga,3.57247,4,12,17,1,0.33333,0.21015,0,0,0,0,0,1,0,0,0,1
7971,stands-rachel.tf,dga,3.625,3,11,16,1,0.27273,0.22656,4,0,0,0,4,7,1,0,0,8
72,login.live.com,legit,3.23593,5,7,14,0,0.71429,0.23114,3,0,0,0,3,2,0,0,0,2
7309,xslp.com.ai,dga,3.27761,3,6,11,1,0.5,0.29796,3,2,1,0,6,2,2,1,0,5
1864,aorta.clickagy.com,legit,3.41938,6,10,18,0,0.6,0.18997,4,0,0,0,4,3,0,0,0,3
5743,nfppywlfvarrqebn.eu,dga,3.72161,4,14,19,1,0.28571,0.19587,1,0,0,0,1,1,0,0,0,1
387,idsync.rlcdn.com,legit,3.32782,2,12,16,0,0.16667,0.20799,3,1,0,0,4,1,0,0,0,1
1797,gnar.grammarly.com,legit,3.15522,4,12,18,0,0.33333,0.17529,3,0,0,0,3,4,0,0,0,4
7458,bbmmbblbdcdeocke.info,dga,3.36329,5,15,21,1,0.33333,0.16016,1,0,0,0,1,1,0,0,0,1
5456,rjgqrrbydhuda.ru,dga,3.25,3,12,16,1,0.25,0.20312,0,0,0,0,0,0,0,0,0,0
5169,xyowcxupnxnujqsc.eu,dga,3.53689,5,13,19,1,0.38462,0.18615,0,0,0,0,0,0,0,0,0,0
9117,habetsunecessitatem.com,dga,3.5014,9,13,23,1,0.69231,0.15223,5,0,0,0,5,13,3,0,0,16
3311,win1910.ipv6.microsoft.com,legit,3.92103,6,12,26,0,0.5,0.15081,7,8,7,6,28,3,0,0,0,3
814,wpc.phicdn.net,legit,3.23593,2,10,14,0,0.2,0.23114,3,1,0,0,4,2,0,0,0,2
5112,qcbottyqhptg.ru,dga,3.45656,2,12,15,1,0.16667,0.23044,0,0,0,0,0,0,0,0,0,0
3122,ad-m.asia,legit,2.6416,4,3,9,0,1.33333,0.29351,1,0,0,0,1,0,0,0,0,0
5107,kevobyd.info,dga,3.4183,4,7,12,1,0.57143,0.28486,0,0,0,0,0,0,0,0,0,0
1323,technoratimedia.com,legit,3.51109,8,10,19,0,0.8,0.18479,5,0,0,0,5,7,1,0,0,8
5911,oacasycywyga.top,dga,3.15564,5,10,16,1,0.5,0.19723,0,0,0,0,0,3,0,0,0,3
8786,ocleveimqua.ddns.net,dga,3.78418,7,11,20,1,0.63636,0.18921,3,1,0,0,4,6,4,3,2,15
8849,eigkumkeiiuoykgk.org,dga,3.14644,9,10,20,1,0.9,0.15732,0,0,0,0,0,0,0,0,0,0
5062,tqdwjcn.com,dga,3.27761,1,9,11,1,0.11111,0.29796,0,0,0,0,0,0,0,0,0,0
1161,www2.bing.com,legit,3.18083,2,8,13,0,0.25,0.24468,1,0,0,0,1,1,1,0,0,2
4506,forms.hscollectedforms.net,legit,3.61334,6,18,26,0,0.33333,0.13897,5,0,0,0,5,6,0,0,0,6
8649,raaxasana.ddns.net,dga,2.92745,6,10,18,1,0.6,0.16264,3,1,0,0,4,7,4,3,2,16
9885,tilacgetl.com,dga,3.2389,4,8,13,1,0.5,0.24915,2,0,0,0,2,5,0,0,0,5
8582,eokykwiugkeq.biz,dga,3.45282,6,9,16,1,0.66667,0.2158,0,0,0,0,0,0,0,3,2,5
1154,ocsp2.globalsign.com,legit,3.58418,5,12,20,0,0.41667,0.17921,1,0,0,0,1,1,0,0,0,1
4734,cdn.stickyadstv.com,legit,3.57662,3,14,19,0,0.21429,0.18824,7,2,1,0,10,4,0,0,0,4
4900,server.agent-cluster3.prod.us001-prod.arcticwolf.net,legit,4.21979,13,28,52,0,0.46429,0.08115,14,7,4,2,27,10,6,1,0,17
1085,bingapis.com,legit,3.4183,4,7,12,0,0.57143,0.28486,3,1,0,0,4,2,1,0,0,3
9627,eouqpwniza.com,dga,3.6645,6,7,14,1,0.85714,0.26175,1,0,0,0,1,1,0,0,0,1
8598,phgightfaek.dyndns.org,dga,3.87966,4,16,22,1,0.25,0.17635,2,1,0,0,3,4,3,4,3,14
1871,meet.google.com,legit,2.87291,6,7,15,0,0.85714,0.19153,2,5,4,3,14,2,0,0,0,2
151,ess.apple.com,legit,3.08506,4,7,13,0,0.57143,0.23731,7,4,3,2,16,2,1,0,0,3
3749,fonts.shopifycdn.com,legit,3.58418,4,14,20,0,0.28571,0.17921,6,1,0,0,7,2,0,0,0,2
768,s.pinimg.com,legit,3.08496,3,7,12,0,0.42857,0.25708,3,0,0,0,3,2,0,0,0,2
8321,cjmxdcch.tv,dga,3.02717,0,10,11,1,0.0,0.2752,0,0,0,0,0,0,0,0,0,0
2842,epm.cyberark.com,legit,3.375,4,10,16,0,0.4,0.21094,3,0,0,0,3,4,0,0,0,4
4219,voledevice-pa.googleapis.com,legit,3.6645,12,13,28,0,0.92308,0.13088,8,7,4,4,23,7,0,0,0,7
9527,pvtiljgmys.com,dga,3.6645,2,11,14,1,0.18182,0.26175,1,0,0,0,1,1,0,0,0,1
8470,uncleachieveclubdepositclub.com,dga,3.82131,12,18,31,1,0.66667,0.12327,2,0,0,0,2,8,0,0,0,8
9269,jlfbwvxciiyuvvbj.eu,dga,3.57662,5,13,19,1,0.38462,0.18824,0,0,0,0,0,0,0,0,0,0
9273,upbgslnpqo.com,dga,3.52164,3,10,14,1,0.3,0.25155,0,0,0,0,0,0,0,0,0,0
5006,tqbmiuywoywolsfev.com,dga,3.88018,6,14,21,1,0.42857,0.18477,1,0,0,0,1,1,0,0,0,1
5053,jboexxoicc.com,dga,2.98523,5,8,14,1,0.625,0.21323,1,0,0,0,1,1,0,0,0,1
7746,pupyjul.com,dga,3.0958,3,7,11,1,0.42857,0.28144,0,0,0,0,0,0,0,0,0,0
7203,spcsbrcwubpwutacjnb.com,dga,3.62118,4,18,23,1,0.22222,0.15744,1,0,0,0,1,2,0,0,0,2
2964,onedscolprdcus00.centralus.cloudapp.azure.com,legit,3.87199,14,25,45,0,0.56,0.08604,19,5,3,4,31,8,3,0,0,11
340,ow1.res.office365.com,legit,3.65376,6,8,21,0,0.75,0.17399,6,4,4,3,17,4,1,0,0,5
1439,chartbeat.com,legit,3.2389,4,8,13,0,0.5,0.24915,2,0,0,0,2,4,1,1,0,6
8228,simplycooking.lv,dga,3.625,4,11,16,1,0.36364,0.22656,4,0,0,0,4,3,1,0,0,4
3379,pulse-event-service.beta.clever.com,legit,3.75029,12,18,35,0,0.66667,0.10715,10,3,1,1,15,10,4,1,0,15
4023,yammer.com,legit,2.84644,3,6,10,0,0.5,0.28464,2,0,0,0,2,2,0,0,0,2
4645,frontier-i18n.tiktokv.com,legit,3.75327,7,13,25,0,0.53846,0.15013,6,5,4,3,18,3,0,0,0,3
1415,whoami.akamai.net,legit,3.26393,8,7,17,0,1.14286,0.192,4,3,4,3,14,3,0,0,0,3
2230,26-courier.push.apple.com,legit,3.86347,8,11,25,0,0.72727,0.15454,9,4,3,2,18,4,0,0,0,4
8350,ingva2wlk8cjw4c0o0u81fi.ddns.net,dga,4.41391,6,17,32,1,0.35294,0.13793,3,1,0,0,4,5,5,3,2,15
2645,tubemogul.com,legit,3.2389,5,7,13,0,0.71429,0.24915,0,0,0,0,0,2,0,0,0,2
9370,cwkkulsrulxydvyt.eu,dga,3.68188,4,14,19,1,0.28571,0.19378,0,0,0,0,0,0,0,0,0,0
81,nexusrules.officeapps.live.com,legit,3.85656,11,16,30,0,0.6875,0.12855,11,5,4,3,23,7,0,0,0,7
3029,mspa.n-able.com,legit,3.50689,4,8,15,0,0.5,0.23379,1,0,0,0,1,1,0,0,0,1
5392,kitoqlok.ru,dga,3.0958,4,6,11,1,0.66667,0.28144,1,0,0,0,1,1,0,0,0,1
1631,sync.technoratimedia.com,legit,3.72018,8,14,24,0,0.57143,0.15501,6,0,0,0,6,7,1,0,0,8
8566,xcrgunwqkhpdhvrg.eu,dga,3.82687,3,15,19,1,0.2,0.20141,1,0,0,0,1,0,0,0,0,0
8912,qtiayfxlabnixihm.eu,dga,3.78714,7,11,19,1,0.63636,0.19932,1,0,0,0,1,3,0,0,0,3
6359,wlbhkvxrnnxzk.com,dga,3.73452,1,15,17,1,0.06667,0.21968,0,0,0,0,0,0,0,0,0,0
7251,peleisos.ru,dga,3.0958,5,5,11,1,1.0,0.28144,1,0,0,0,1,3,0,0,0,3
7524,syoisioi8uga.top,dga,3.28064,8,6,16,1,1.33333,0.20504,0,0,0,0,0,2,0,0,0,2
2926,sf-api-token-service.itunes.apple.com,legit,3.98286,13,18,37,0,0.72222,0.10764,14,8,4,3,29,9,2,1,0,12
4295,dnkeeper.platform.dbankcloud.cn,legit,3.88905,8,20,31,0,0.4,0.12545,7,3,2,1,13,7,0,0,0,7
2299,mamservice.manage.microsoft.com,legit,3.61923,11,17,31,0,0.64706,0.11675,13,11,8,9,41,9,2,1,0,12
4906,ags.akadns.net,legit,3.03915,4,8,14,0,0.5,0.21708,4,3,4,3,14,2,1,0,0,3
5506,mozeuucofc.com,dga,2.84237,6,7,14,1,0.85714,0.20303,2,0,0,0,2,1,0,0,0,1
378,api.cdp.microsoft.com,legit,3.42733,6,12,21,0,0.5,0.16321,11,9,8,7,35,2,0,0,0,2
8332,cucoxirs.ru,dga,2.91398,4,6,11,1,0.66667,0.26491,1,0,0,0,1,1,0,0,0,1
6386,exmhcpdbgpltoojki.com,dga,3.88018,5,15,21,1,0.33333,0.18477,2,0,0,0,2,0,0,0,0,0
5437,piscantursecuritas.com,dga,3.57262,8,13,22,1,0.61538,0.16239,4,0,0,0,4,9,2,0,0,11
719,api.endpoint.ingress.rapid7.com,legit,3.7442,10,16,31,0,0.625,0.12078,9,1,1,0,11,6,3,0,0,9
1664,vast.doubleverify.com,legit,4.01137,7,12,21,0,0.58333,0.19102,5,1,0,0,6,7,2,0,0,9
2281,i.pinimg.com,legit,2.85539,4,6,12,0,0.66667,0.23795,2,0,0,0,2,2,0,0,0,2
6929,yxpalnqdqbinut.com,dga,3.9477,4,13,18,1,0.30769,0.21932,1,0,0,0,1,1,0,0,0,1
6581,ekdafmfffecmndfd.com,dga,3.06596,4,15,20,1,0.26667,0.1533,0,0,0,0,0,2,0,0,0,2
5788,ddbmmfnmldbmefdl.info,dga,3.11828,3,17,21,1,0.17647,0.14849,0,0,0,0,0,1,0,0,0,1
2517,send.acrobat.com,legit,3.5,5,9,16,0,0.55556,0.21875,7,1,0,0,8,5,0,0,0,5
7308,islimiwwo.com,dga,2.87314,5,7,13,1,0.71429,0.22101,2,0,0,0,2,2,0,0,0,2
987,pull-cmaf-l16-tt01.tiktokcdn-us.com,legit,4.05758,6,19,35,0,0.31579,0.11593,6,6,9,9,30,3,0,0,0,3
4796,us-west-sync.bidswitch.net,legit,3.67141,5,17,26,0,0.29412,0.14121,4,0,0,0,4,3,1,0,0,4
4578,exch.quantserve.com,legit,3.78714,6,11,19,0,0.54545,0.19932,3,1,1,0,5,4,2,1,0,7
3903,a2047.w182.akamai.net,legit,3.6897,6,5,21,0,1.2,0.1757,3,3,4,3,13,2,0,0,0,2
142,res.office365.com,legit,3.49923,5,7,17,0,0.71429,0.20584,6,4,4,3,17,4,1,0,0,5
790,choices.truste.com,legit,3.35021,6,10,18,0,0.6,0.18612,8,1,0,0,9,5,0,0,0,5
7014,2segiwa4uo6c.top,dga,3.875,6,6,16,1,1.0,0.24219,1,0,0,0,1,1,0,0,0,1
8104,airlinecarryaccountscale.com,dga,3.58005,11,16,28,1,0.6875,0.12786,6,0,0,0,6,8,1,0,0,9
2424,win-global-asimov-leafs-events-data.trafficmanager.net,legit,4.00972,18,29,54,0,0.62069,0.07425,14,4,1,3,22,15,2,0,0,17
1932,images.taboola.com,legit,3.41938,8,8,18,0,1.0,0.18997,7,1,0,0,8,5,0,0,0,5
2085,w184.akamai.net,legit,3.45656,5,5,15,0,1.0,0.23044,3,3,4,3,13,2,0,0,0,2
1357,js.stripe.com,legit,3.39275,3,8,13,0,0.375,0.26098,2,0,0,0,2,2,0,0,0,2
2014,drivefrontend-pa.googleapis.com,legit,4.02662,11,17,31,0,0.64706,0.12989,10,6,4,4,24,9,0,0,0,9
6547,magdalenechristopherson.net,dga,3.83804,9,17,27,1,0.52941,0.14215,6,0,0,0,6,10,4,0,2,16
4626,fp-as.azureedge.net,legit,3.61635,7,9,19,0,0.77778,0.19033,5,2,1,2,10,4,0,0,0,4
3695,digitaleast.mobi,legit,3.45282,7,8,16,0,0.875,0.2158,4,1,0,0,5,6,1,0,0,7
8053,lopeakav.ru,dga,3.27761,5,5,11,1,1.0,0.29796,2,1,0,0,3,1,0,0,0,1
2034,ats.rlcdn.com,legit,3.39275,2,9,13,0,0.22222,0.26098,4,1,0,0,5,2,0,0,0,2
2259,27-courier.push.apple.com,legit,3.86347,8,11,25,0,0.72727,0.15454,9,4,3,2,18,4,0,0,0,4
1633,cedexis-radar.net,legit,3.45482,6,9,17,0,0.66667,0.20322,4,0,0,0,4,6,0,0,0,6
740,s3-w.us-east-1.amazonaws.com,legit,3.68201,8,12,28,0,0.66667,0.1315,7,2,3,3,15,6,0,0,0,6
7703,wypttfqiddxqxrtiq.su,dga,3.54644,3,16,20,1,0.1875,0.17732,1,0,0,0,1,2,0,0,0,2
2245,cdp.cloud.unity3d.com,legit,3.52257,5,12,21,0,0.41667,0.16774,6,3,3,2,14,2,0,0,0,2
6032,cgdetnc.as,dga,3.12193,2,7,10,1,0.28571,0.31219,0,0,0,0,0,2,0,0,0,2
5369,lladffkomcolmlak.com,dga,3.04644,5,14,20,1,0.35714,0.15232,2,0,0,0,2,3,0,0,0,3
90,gateway.fe.apple-dns.net,legit,3.60539,7,13,24,0,0.53846,0.15022,9,5,3,2,19,5,2,0,0,7
2513,p11.techlab-cdn.com,legit,3.78714,3,11,19,0,0.27273,0.19932,4,1,0,0,5,4,0,0,0,4
6786,bpnfichjd.com,dga,3.54659,2,10,13,1,0.2,0.27281,1,1,0,0,2,1,0,0,0,1
2748,t.myvisualiq.net,legit,3.625,5,9,16,0,0.55556,0.22656,2,0,0,0,2,2,0,0,0,2
2491,crl.prod.cagenerator.pki.strln.net,legit,3.69088,8,21,34,0,0.38095,0.10856,11,5,3,2,21,9,1,0,0,10
5218,jkrwekhbhvdhig.info,dga,3.78714,4,14,19,1,0.28571,0.19932,0,0,0,0,0,0,0,0,0,0
9072,maeremisremiperinte.com,dga,3.2575,10,12,23,1,0.83333,0.14163,7,0,0,0,7,9,3,1,0,13
3487,reach-pa.googleapis.com,legit,3.67531,9,11,23,0,0.81818,0.1598,6,6,4,4,20,5,0,0,0,5
4365,web-oao.ssp.yahoo.com,legit,3.42258,8,9,21,0,0.88889,0.16298,2,0,0,1,3,0,0,0,0,0
2735,prod-video-cms-amp-microsoft-com.akamaized.net,legit,3.96164,15,24,46,0,0.625,0.08612,11,14,13,11,49,8,2,0,0,10
7617,o72fgzr1d5jhajgtuc.biz,dga,4.1867,4,13,22,1,0.30769,0.1903,0,0,0,0,0,0,0,0,0,0
7197,ksbktqfqbex.org,dga,3.50689,2,12,15,1,0.16667,0.23379,0,0,0,0,0,1,3,2,1,7
9313,bpyrbyppxxxk.us,dga,3.00624,1,13,15,1,0.07692,0.20042,1,0,0,0,1,0,0,0,0,0
9485,3hofkrujcfi072s.ddns.net,dga,4.1683,4,14,24,1,0.28571,0.17368,4,1,0,0,5,4,3,3,2,12
6225,geapugaigcuhmp.com,dga,3.35021,7,10,18,1,0.7,0.18612,3,0,0,0,3,2,0,0,0,2
6689,kphanym.dynserv.com,dga,3.82687,3,14,19,1,0.21429,0.20141,3,1,1,0,5,5,5,5,4,19
8395,uvhetanao.ddns.net,dga,3.35021,6,10,18,1,0.6,0.18612,3,1,0,0,4,7,4,3,2,16
3830,fe2.update.microsoft.com,legit,3.77206,8,12,24,0,0.66667,0.15717,9,8,7,6,30,4,1,0,0,5
8188,fbrbqdknk.yi.org,dga,3.5,2,12,16,1,0.16667,0.21875,0,0,0,0,0,0,0,0,0,0
2552,fmipalservice.icloud.com,legit,3.77206,9,13,24,0,0.69231,0.15717,8,5,3,2,18,5,2,1,0,8
3430,conn-service-us-04.allawnos.com,legit,3.92921,9,15,31,0,0.6,0.12675,8,3,1,1,13,7,3,1,0,11
5746,4ghhupoyqv34dn5zwt.com,dga,4.1867,3,14,22,1,0.21429,0.1903,1,0,0,0,1,1,0,0,0,1
2820,hangouts.clients6.google.com,legit,3.75343,9,15,28,0,0.6,0.13405,8,6,4,3,21,3,1,0,0,4
8764,igipencelorumsed.com,dga,3.68418,8,11,20,1,0.72727,0.18421,5,0,0,0,5,6,1,1,0,8
1625,apple-cloudkit.fe.apple-dns.net,legit,3.80872,9,17,31,0,0.52941,0.12286,9,8,5,3,25,4,1,0,0,5
2651,wordonline.nel.measure.office.net,legit,3.70304,13,16,33,0,0.8125,0.11221,10,4,4,3,21,11,1,0,0,12
3600,dwin1.com,legit,3.16993,2,5,9,0,0.4,0.35221,1,0,0,0,1,1,0,0,0,1
1848,clickagy.com,legit,3.18872,3,8,12,0,0.375,0.26573,2,0,0,0,2,1,0,0,0,1
7101,inofsorwa.com,dga,3.33468,5,7,13,1,0.71429,0.25651,2,0,0,0,2,2,0,0,0,2
9905,hzmb.co.uk,dga,3.12193,2,6,10,1,0.33333,0.31219,2,1,0,0,3,1,1,0,0,2
8488,troydelivers.xyz,dga,3.625,4,11,16,1,0.36364,0.22656,3,0,0,0,3,4,2,0,0,6
2514,dqa.samsung.com,legit,3.37356,4,9,15,0,0.44444,0.2249,1,0,0,0,1,2,0,0,0,2
3674,normandy-cdn.services.mozilla.com,legit,3.89971,9,20,33,0,0.45,0.11817,10,4,2,1,17,11,3,1,0,15
1743,prd.aadg.akadns.net,legit,3.2211,5,11,19,0,0.45455,0.16953,5,3,4,3,15,2,1,0,0,3
4939,pubnative.net,legit,3.2389,5,7,13,0,0.71429,0.24915,2,0,0,0,2,3,1,0,0,4
4971,m.yap.yahoo.com,legit,2.87291,5,7,15,0,0.71429,0.19153,3,0,0,1,4,0,0,0,0,0
4552,platform-api.sharethis.com,legit,3.82525,8,15,26,0,0.53333,0.14712,5,1,1,0,7,7,0,0,0,7
3301,bpb.opendns.com,legit,3.24022,3,10,15,0,0.3,0.21601,2,1,0,0,3,4,1,1,0,6
9295,tasupoopu.ddns.net,dga,3.28104,6,10,18,1,0.6,0.18228,4,1,0,0,5,7,3,3,2,15
150,tpc.googlesyndication.com,legit,3.73366,8,15,25,0,0.53333,0.14935,7,5,4,3,19,8,3,2,1,14
5058,lymuw.eu,dga,2.75,3,4,8,1,0.75,0.34375,0,0,0,0,0,0,0,0,0,0
4128,microsoft.net,legit,3.39275,4,8,13,0,0.5,0.26098,5,7,6,5,23,2,0,0,0,2
7418,hlxhqbwpxhll.com,dga,3.28064,1,14,16,1,0.07143,0.20504,0,0,0,0,0,0,0,0,0,0
4525,push-rtmp-f5-va01.tiktokcdn.com,legit,4.26033,5,18,31,0,0.27778,0.13743,5,6,7,8,26,2,0,0,0,2
9411,mmcbdklbfcmaeaof.co.uk,dga,3.48171,6,14,22,1,0.42857,0.15826,5,1,0,0,6,3,1,0,0,4
8713,m0momk2o2s60.org,dga,3.15564,3,7,16,1,0.42857,0.19723,0,0,0,0,0,1,0,0,0,1
4908,5aa25954e40ffb18984989b59487dfe054549e213a2e64a12187f8deb5a4cb5.us-east-1.prod.service.minerva.devices.a2z.com,legit,4.52492,25,32,110,0,0.78125,0.04114,18,8,4,3,33,13,5,1,0,19
2000,vpaid.doubleverify.com,legit,3.91398,8,12,22,0,0.66667,0.17791,5,0,0,0,5,5,2,0,0,7
8166,mxqpqrkmd.tv,dga,3.25163,0,11,12,1,0.0,0.27097,0,0,0,0,0,0,0,0,0,0
7564,mkktpaejmodedhcuk.com,dga,3.55852,6,14,21,1,0.42857,0.16945,1,0,0,0,1,2,0,0,0,2
9634,ofc21tobi0kfklepgpw6qve.ddns.net,dga,4.35141,6,20,32,1,0.3,0.13598,5,1,0,0,6,6,4,3,2,15
7815,idlungybpnjugwpk.eu,dga,3.68188,5,13,19,1,0.38462,0.19378,0,0,0,0,0,0,0,0,0,0
8990,shitpiss.ch,dga,2.66353,2,8,11,1,0.25,0.24214,1,0,0,0,1,2,0,0,0,2
18,bing.com,legit,3.0,2,5,8,0,0.4,0.375,1,0,0,0,1,1,1,0,0,2
7853,intentionlecturewisesound.com,dga,3.60748,12,16,29,1,0.75,0.1244,11,1,0,0,12,12,4,2,0,18
9058,fztyma.com.ar,dga,3.2389,3,8,13,1,0.375,0.24915,3,2,1,0,6,3,2,1,0,6
4350,comcluster.cxense.com,legit,3.40399,6,13,21,0,0.46154,0.16209,8,1,0,0,9,8,3,0,0,11
550,ci3.googleusercontent.com,legit,3.62347,9,13,25,0,0.69231,0.14494,10,8,4,3,25,7,3,0,0,10
9943,nvrpdr4rvke14lsxez.cn,dga,3.78494,2,15,21,1,0.13333,0.18024,0,0,0,0,0,0,0,0,0,0
7033,ispevirtutisfacile.com,dga,3.73216,9,12,22,1,0.75,0.16964,2,0,0,0,2,4,0,0,0,4
7806,isktkue51bul58k17dscuk67a67hqcvkzl68h34.com,dga,4.43489,7,21,43,1,0.33333,0.10314,1,0,0,0,1,1,0,0,0,1
6717,christiveraamomnium.com,dga,3.62118,9,13,23,1,0.69231,0.15744,5,0,0,0,5,10,3,0,2,15
2482,llnwi.net,legit,2.72548,2,6,9,0,0.33333,0.30283,0,0,0,0,0,0,0,0,0,0
2790,minkatu.com,legit,3.27761,4,6,11,0,0.66667,0.29796,3,0,0,0,3,3,0,0,0,3
4050,opecloud.com,legit,3.02206,5,6,12,0,0.83333,0.25184,2,3,2,1,8,1,0,0,0,1
6763,seenogiwineddei.ddns.net,dga,3.06977,9,13,24,1,0.69231,0.12791,6,1,0,0,7,10,5,3,2,20
9301,abasbkpbuyqvggftd.tw,dga,3.78418,3,16,20,1,0.1875,0.18921,0,0,0,0,0,1,0,0,0,1
5590,vicictac.ru,dga,2.84535,4,6,11,1,0.66667,0.25867,2,0,0,0,2,3,0,0,0,3
7763,mnbfaefccafbceob.com,dga,3.04644,6,13,20,1,0.46154,0.15232,1,0,0,0,1,2,0,0,0,2
5323,qxayaofyup.com,dga,3.37878,5,8,14,1,0.625,0.24134,1,0,0,0,1,0,0,0,0,0
4070,clicktale.net,legit,3.08506,4,8,13,0,0.5,0.23731,4,0,0,0,4,3,0,0,0,3
6193,dxpgomjalm.com,dga,3.32486,3,10,14,1,0.3,0.23749,0,0,0,0,0,1,0,0,0,1
8501,uqgqzeedwc.com,dga,3.37878,4,9,14,1,0.44444,0.24134,1,0,0,0,1,1,0,0,0,1
1009,pull-cmaf-l16-sg01.tiktokcdn.com,legit,4.17923,5,18,32,0,0.27778,0.1306,5,6,9,9,29,3,0,0,0,3
282,www.microsoft.com,legit,3.17512,4,11,17,0,0.36364,0.18677,6,8,7,6,27,2,0,0,0,2
9449,gsqfobb.biz,dga,3.02717,2,8,11,1,0.25,0.2752,0,0,0,0,0,0,0,0,0,0
8705,ytakgjeydvwpa.biz,dga,3.85217,4,12,17,1,0.33333,0.2266,1,0,0,0,1,1,0,0,0,1
6814,diwexjrstf.com,dga,3.80735,3,10,14,1,0.3,0.27195,1,0,0,0,1,1,0,0,0,1
4929,sync.jivox.com,legit,3.37878,3,9,14,0,0.33333,0.24134,0,0,0,0,0,0,0,0,0,0
6417,jfpmnkn.cc,dga,2.92193,0,9,10,1,0.0,0.29219,0,0,0,0,0,0,0,0,0,0
141,clients6.google.com,legit,3.47135,6,10,19,0,0.6,0.1827,5,6,4,3,18,2,1,0,0,3
5886,jvtnjnbhmgxxghlqgxxkrd.com,dga,3.90217,1,24,26,1,0.04167,0.15008,0,0,0,0,0,0,0,0,0,0
3250,images.ctfassets.net,legit,3.24644,6,12,20,0,0.5,0.16232,6,1,0,0,7,6,1,0,0,7
6724,wrpkruduftfr.online,dga,3.68188,5,13,19,1,0.38462,0.19378,0,0,0,0,0,0,0,0,0,0
5368,mziakxxeieemqaxags.biz,dga,3.41309,9,12,22,1,0.75,0.15514,0,0,0,0,0,1,0,0,0,1
2700,cw.addthis.com,legit,3.37878,3,9,14,0,0.33333,0.24134,2,0,0,0,2,2,0,0,0,2
1955,adx.ads.vungle.com,legit,3.68354,5,10,18,0,0.5,0.20464,5,1,0,0,6,1,0,0,0,1
8493,wdctmydfwnikepfkr.cc,dga,3.68418,2,17,20,1,0.11765,0.18421,0,0,0,0,0,1,0,0,0,1
7339,uqktkraubrqyga.org,dga,3.35021,5,12,18,1,0.41667,0.18612,1,0,0,0,1,1,0,0,0,1
9340,tracker-medieval.it,dga,3.57662,7,10,19,1,0.7,0.18824,3,0,0,0,3,4,1,0,0,5
3121,carrierbundle.itunes.apple.com,legit,3.85656,11,16,30,0,0.6875,0.12855,9,4,3,2,18,9,0,0,0,9
4310,ins.connatix.com,legit,3.20282,5,9,16,0,0.55556,0.20018,7,2,0,0,9,6,3,0,0,9
3205,array605.prod.do.dsp.mp.microsoft.com,legit,3.71259,8,20,37,0,0.4,0.10034,12,12,10,9,43,5,2,0,0,7
750,geo.moatads.com,legit,3.1899,6,7,15,0,0.85714,0.21266,6,0,0,0,6,3,0,0,0,3
9206,quivocabuliliceautemhlic.com,dga,3.61058,13,14,28,1,0.92857,0.12895,5,1,0,0,6,6,0,0,0,6
9013,wvixijsncxypu85.ddns.net,dga,3.97018,4,16,24,1,0.25,0.16542,2,1,0,0,3,4,3,2,2,11
1582,px-cloud.net,legit,3.58496,3,7,12,0,0.42857,0.29875,2,3,2,1,8,0,0,0,0,0
7966,alexandreamillicent.net,dga,3.38162,9,13,23,1,0.69231,0.14703,10,2,0,0,12,10,2,0,0,12
3961,adobedc.net,legit,3.0958,4,6,11,0,0.66667,0.28144,2,0,0,0,2,2,0,0,0,2
4301,moengage.com,legit,2.9183,5,6,12,0,0.83333,0.24319,2,1,0,0,3,2,0,0,0,2
2885,infolinks.com,legit,3.2389,4,8,13,0,0.5,0.24915,2,0,0,0,2,1,0,0,0,1
4680,watsonc.events.data.microsoft.com,legit,3.70304,10,19,33,0,0.52632,0.11221,13,9,7,6,35,8,1,0,0,9
7798,ordercover.net,dga,2.98523,5,8,14,1,0.625,0.21323,2,0,0,0,2,5,2,0,0,7
9095,dnagdlnxwdxrekyhlk.com,dga,3.87966,3,18,22,1,0.16667,0.17635,2,0,0,0,2,2,0,0,0,2
8659,m59j56i65aui35k57pvlwgqarf52h24nqh24axnr.net,dga,4.51001,7,20,44,1,0.35,0.1025,0,0,0,0,0,1,0,0,0,1
8773,qcokbjcfksor.ru,dga,3.37356,3,11,15,1,0.27273,0.2249,1,0,0,0,1,2,0,0,0,2
7281,peqetjvvtmjr.biz,dga,3.5,3,12,16,1,0.25,0.21875,0,0,0,0,0,1,0,0,0,1
3931,smartasset.com,legit,3.03915,4,9,14,0,0.44444,0.21708,3,0,0,0,3,6,1,0,0,7
1290,bfmio.com,legit,2.72548,3,5,9,0,0.6,0.30283,1,0,0,0,1,1,0,0,0,1
4407,api.atlassian.com,legit,3.26393,7,8,17,0,0.875,0.192,4,1,1,0,6,5,1,0,0,6
4660,squarespace-cdn.com,legit,3.68188,6,11,19,0,0.54545,0.19378,5,1,0,0,6,6,1,0,0,7
6839,hahoreh.info,dga,3.02206,5,6,12,1,0.83333,0.25184,1,0,0,0,1,2,0,0,0,2
9884,cnwmlruoyggiifg.co.uk,dga,3.6897,6,13,21,1,0.46154,0.1757,2,1,0,0,3,1,1,0,0,2
8352,ygjjniorguonm.com,dga,3.33718,5,11,17,1,0.45455,0.1963,1,0,0,0,1,3,0,0,0,3
5010,cdjimfjspm.com,dga,3.18201,2,11,14,1,0.18182,0.22729,1,0,0,0,1,0,0,0,0,0
706,globalsign.com,legit,3.37878,4,9,14,0,0.44444,0.24134,1,0,0,0,1,1,0,0,0,1
5496,cm4egys2saou.org,dga,3.625,5,8,16,1,0.625,0.22656,1,0,0,0,1,0,0,0,0,0
3846,cloudfront-labs.amazonaws.com,legit,3.89246,9,17,29,0,0.52941,0.13422,9,4,5,4,22,4,0,0,0,4
693,code.jquery.com,legit,3.37356,5,8,15,0,0.625,0.2249,3,0,0,0,3,3,0,0,0,3
5652,bpbguuamnd.com,dga,3.37878,4,9,14,1,0.44444,0.24134,1,0,0,0,1,2,0,0,0,2
2235,3-courier.push.apple.com,legit,3.77206,8,11,24,0,0.72727,0.15717,9,4,3,2,18,4,0,0,0,4
1209,sc-prod.net,legit,3.45943,2,7,11,0,0.28571,0.31449,2,2,1,0,5,0,1,0,0,1
7810,rrhjhyyfjruviwyun.me,dga,3.54644,4,15,20,1,0.26667,0.17732,0,0,0,0,0,0,0,0,0,0
8358,ktwpviluovbctqxbe.tw,dga,3.78418,4,15,20,1,0.26667,0.18921,0,0,0,0,0,1,0,0,0,1
3013,lkqd.net,legit,3.0,1,6,8,0,0.16667,0.375,0,0,0,0,0,0,0,0,0,0
3763,time.cloudflare.com,legit,3.61635,7,10,19,0,0.7,0.19033,6,3,3,2,14,4,0,0,0,4
3998,pull-flv-f1-gcp01.tiktokcdn.com,legit,4.04243,4,19,31,0,0.21053,0.1304,4,6,9,9,28,2,0,0,0,2
5390,pbraetsfwnnvwsvnr.com,dga,3.78494,3,17,21,1,0.17647,0.18024,1,0,0,0,1,2,0,0,0,2
836,gsas.apple.com,legit,3.23593,4,8,14,0,0.5,0.23114,6,4,3,2,15,2,0,0,0,2
3589,adsymptotic.com,legit,3.37356,4,10,15,0,0.4,0.2249,4,0,0,0,4,2,0,0,0,2
6582,vtnwbsn.org,dga,3.27761,1,9,11,1,0.11111,0.29796,0,0,0,0,0,0,0,0,0,0
6038,iqu8xwft1a1wgc3ach.cn,dga,3.88018,4,12,21,1,0.33333,0.18477,0,0,0,0,0,1,0,0,0,1
4352,ads.creative-serving.com,legit,3.80351,8,13,24,0,0.61538,0.15848,12,1,1,1,15,8,4,1,0,13
8063,mddkfrghmfmojorwgxgmjfiwslvw.net,dga,4.05423,4,27,32,1,0.14815,0.12669,0,0,0,0,0,2,0,0,0,2
7061,orxpmowcc.com,dga,2.81507,3,9,13,1,0.33333,0.21654,0,0,0,0,0,1,0,0,0,1
4355,js.hscollectedforms.net,legit,3.67531,5,16,23,0,0.3125,0.1598,5,0,0,0,5,6,0,0,0,6
9477,kumiwkmcsccuouii.org,dga,3.30869,8,11,20,1,0.72727,0.16543,2,0,0,0,2,1,0,0,0,1
8111,pufojyg.info,dga,3.25163,4,7,12,1,0.57143,0.27097,0,0,0,0,0,0,0,0,0,0
5698,growthchiptextpersuadedemand.com,dga,4.01532,10,21,32,1,0.47619,0.12548,6,0,0,0,6,9,2,0,0,11
5772,upskirt-ranging.in,dga,3.41938,5,11,18,1,0.45455,0.18997,2,0,0,0,2,3,1,0,0,4
2573,cdn.honey.io,legit,3.08496,4,6,12,0,0.66667,0.25708,3,2,1,0,6,3,1,0,0,4
9389,memguguiwcymao.biz,dga,3.57243,7,10,18,1,0.7,0.19847,1,0,0,0,1,2,0,5,4,11
7767,alexandriaanthonyson.net,dga,3.51789,9,14,24,1,0.64286,0.14658,3,0,0,0,3,5,1,0,0,6
3545,dc.albtls.t.co,legit,3.03915,2,9,14,0,0.22222,0.21708,3,0,0,0,3,0,0,0,0,0
2055,web.whatsapp.com,legit,3.5,4,10,16,0,0.4,0.21875,3,1,0,0,4,1,0,0,0,1
1552,online-metrix.net,legit,3.29277,6,9,17,0,0.66667,0.19369,3,0,0,0,3,5,1,0,0,6
2324,klaviyo.com,legit,3.27761,4,6,11,0,0.66667,0.29796,0,0,0,0,0,1,0,0,0,1
161,cc.skype.com,legit,3.02206,2,8,12,0,0.25,0.25184,0,0,0,0,0,0,0,0,0,0
3178,xg4ken.com,legit,3.32193,2,6,10,0,0.33333,0.33219,1,0,0,0,1,1,0,0,0,1
8673,qkqwuyygacgmucgk.org,dga,3.42193,4,15,20,1,0.26667,0.1711,0,0,0,0,0,1,0,0,0,1
4271,chartboost.com,legit,3.18201,4,9,14,0,0.44444,0.22729,2,0,0,0,2,2,1,1,0,4
6254,bicomftmfvku.biz,dga,3.5,4,11,16,1,0.36364,0.21875,2,1,0,0,3,3,1,0,0,4
9773,hahudis.info,dga,3.25163,5,6,12,1,0.83333,0.27097,0,0,0,0,0,1,0,0,0,1
3347,impactradius-event.com,legit,3.91398,8,12,22,0,0.66667,0.17791,5,1,0,0,6,4,2,0,0,6
46,prod.netflix.com,legit,3.75,4,10,16,0,0.4,0.23438,4,3,2,1,10,2,1,0,0,3
8210,fzbuefbz.com.do,dga,3.24022,4,9,15,1,0.44444,0.21601,2,2,1,0,5,2,2,1,0,5
1064,cs.admanmedia.com,legit,3.17512,6,9,17,0,0.66667,0.18677,5,0,0,0,5,3,0,0,0,3
5833,nofotycywos.eu,dga,3.32486,5,8,14,1,0.625,0.23749,1,0,0,0,1,0,0,0,0,0
1265,prod.mozaws.net,legit,3.64022,4,9,15,0,0.44444,0.24268,4,3,2,1,10,0,1,0,0,1
2987,extremereach.io,legit,3.24022,7,7,15,0,1.0,0.21601,3,0,0,0,3,5,1,0,0,6
1478,adition.com,legit,3.0958,5,5,11,0,1.0,0.28144,3,0,0,0,3,3,2,1,0,6
9975,bleuhszvih.com,dga,3.6645,4,9,14,1,0.44444,0.26175,1,0,0,0,1,1,0,0,0,1
4314,alt3-mtalk.google.com,legit,3.46328,6,11,21,0,0.54545,0.16492,3,5,4,3,15,2,0,0,0,2
8800,i8i4mge02ga0.net,dga,3.5,5,5,16,1,1.0,0.21875,1,0,0,0,1,1,0,0,0,1
5997,pqfuusekck.com,dga,3.37878,4,9,14,1,0.44444,0.24134,2,0,0,0,2,1,0,0,0,1
5520,e51nrmre21pwb18jwgxg33e61pvfuayn30i65i55.com,dga,4.51603,8,19,44,1,0.42105,0.10264,1,0,0,0,1,1,0,0,0,1
3126,wildcard.moatads.com.edgekey.net,legit,3.85141,10,18,32,0,0.55556,0.12036,11,5,3,1,20,8,2,1,0,11
1213,sct.sc-prod.net,legit,3.37356,2,10,15,0,0.2,0.2249,2,2,1,0,5,0,1,0,0,1
6671,puniwup.info,dga,2.9183,5,6,12,1,0.83333,0.24319,0,0,0,0,0,1,0,0,0,1
217,www.msftconnecttest.com,legit,3.24053,4,17,23,0,0.23529,0.14089,6,1,0,0,7,7,2,0,0,9
3083,array804.prod.do.dsp.mp.microsoft.com,legit,3.71259,8,20,37,0,0.4,0.10034,12,12,10,9,43,5,2,0,0,7
3294,wu.ec.azureedge.net,legit,3.28137,8,8,19,0,1.0,0.1727,4,2,1,2,9,4,0,0,0,4
3474,gfx.ms,legit,2.58496,0,5,6,0,0.0,0.43083,0,0,0,0,0,0,0,0,0,0
915,us.main.endpoint.ingress.rapid7.com,legit,3.80458,11,18,35,0,0.61111,0.1087,12,1,0,0,13,7,3,0,0,10
6123,ywigfcuiwcymao.net,dga,3.72548,6,11,18,1,0.54545,0.20697,1,0,0,0,1,1,0,5,4,10
2956,pull-f5-tt02.fcdn.us.tiktokv.com.c.worldfcdn2.com,legit,4.11418,7,29,49,0,0.24138,0.08396,8,10,9,5,32,5,2,1,0,8
6122,ueszxztokz.com,dga,3.32486,4,9,14,1,0.44444,0.23749,1,1,0,0,2,1,0,0,0,1
4990,consent.config.office.com,legit,3.27327,8,14,25,0,0.57143,0.13093,9,7,4,3,23,7,4,0,0,11
8305,bfwxdgjqtdcc.in,dga,3.64022,1,13,15,1,0.07692,0.24268,0,0,0,0,0,0,0,0,0,0
8884,armistempuscano.com,dga,3.57662,7,11,19,1,0.63636,0.18824,4,0,0,0,4,8,1,0,0,9
8847,libispopulusquod.com,dga,3.44644,8,11,20,1,0.72727,0.17232,2,0,0,0,2,1,0,0,0,1
8072,roaeatagumirjx.net,dga,3.57243,8,9,18,1,0.88889,0.19847,5,0,0,0,5,4,0,0,0,4
2160,csm.da.us.criteo.net,legit,3.52193,6,10,20,0,0.6,0.1761,6,0,0,0,6,4,0,0,0,4
1356,edge.e2ro.com,legit,3.02699,5,5,13,0,1.0,0.23285,4,2,1,0,7,2,0,0,0,2
7119,anabihkr3x5tol1dily8gtw.ddns.net,dga,4.30423,6,20,32,1,0.3,0.13451,2,1,0,0,3,5,3,3,2,13
2212,17-courier.push.apple.com,legit,3.86347,8,11,25,0,0.72727,0.15454,9,4,3,2,18,4,0,0,0,4
8981,glasscorner.net,dga,3.37356,4,10,15,1,0.4,0.2249,2,0,0,0,2,6,1,0,0,7
5204,aoodbbakbamnalld.de,dga,3.11583,7,11,19,1,0.63636,0.16399,2,0,0,0,2,1,0,0,0,1
8917,wwxonenf.com,dga,3.08496,3,8,12,1,0.375,0.25708,2,0,0,0,2,3,1,0,0,4
3509,f.akamaiedge.net,legit,3.28064,7,7,16,0,1.0,0.20504,5,5,5,3,18,4,0,0,0,4
2789,he.lijit.com,legit,3.25163,4,6,12,0,0.66667,0.27097,2,0,0,0,2,1,0,0,0,1
3491,live.streamtheworld.com,legit,3.79509,7,14,23,0,0.5,0.165,6,0,0,0,6,6,0,0,0,6
558,stickyadstv.com,legit,3.50689,3,11,15,0,0.27273,0.23379,5,0,0,0,5,3,0,0,0,3
3285,e8652.dscx.akamaiedge.net,legit,3.86347,8,10,25,0,0.8,0.15454,7,5,5,3,20,5,0,0,0,5
3020,t.paypal.com,legit,3.08496,3,7,12,0,0.42857,0.25708,0,0,0,0,0,0,0,0,0,0
6828,nzphwuom.com,dga,3.25163,3,8,12,1,0.375,0.27097,0,0,0,0,0,1,0,0,0,1
427,aax.amazon-adsystem.com,legit,3.55119,8,12,23,0,0.66667,0.1544,8,1,3,3,15,6,0,0,0,6
5108,lufigwir.com,dga,3.4183,4,7,12,1,0.57143,0.28486,0,0,0,0,0,0,0,0,0,0
1834,api.amazonvideo.com,legit,3.43162,9,8,19,0,1.125,0.18061,6,2,4,3,15,4,0,0,0,4
5701,emvibaro.ddns.net,dga,3.61687,5,10,17,1,0.5,0.21276,3,1,0,0,4,6,4,3,2,15
8586,5w2bgxbuuw6mzt44lp.biz,dga,3.87966,3,13,22,1,0.23077,0.17635,0,0,0,0,0,0,0,0,0,0
6807,rlwivrioqoqlixdx.eu,dga,3.47135,7,11,19,1,0.63636,0.1827,1,0,0,0,1,1,0,0,0,1
2449,pus3-collabhubrtc.officeapps.live.com,legit,4.10082,11,21,37,0,0.52381,0.11083,10,5,4,3,22,6,0,0,0,6
1873,array610.prod.do.dsp.mp.microsoft.com,legit,3.71259,8,20,37,0,0.4,0.10034,12,12,10,9,43,5,2,0,0,7
8568,twbagglvhmvhcegda.cc,dga,3.54644,3,16,20,1,0.1875,0.17732,1,0,0,0,1,1,0,0,0,1
9940,doteoqaf.ru,dga,3.27761,5,5,11,1,1.0,0.29796,1,0,0,0,1,1,0,0,0,1
4771,pangolin16.sgsnssdk.com,legit,3.70813,4,15,23,0,0.26667,0.16122,2,0,0,0,2,3,0,0,0,3
5896,sjtsnhhlixquwclfg.me,dga,4.02193,3,16,20,1,0.1875,0.2011,1,0,0,0,1,0,0,0,0,0
772,qualtrics.com,legit,3.54659,4,8,13,0,0.5,0.27281,1,0,0,0,1,2,0,0,0,2
4514,execute-api.us-west-2.amazonaws.com,legit,3.92172,13,15,35,0,0.86667,0.11205,10,2,4,3,19,7,1,0,0,8
7792,wupteogu.ru,dga,3.02717,5,5,11,1,1.0,0.2752,1,0,0,0,1,1,0,0,0,1
4563,consentcdn.cookiebot.com,legit,3.31977,8,14,24,0,0.57143,0.13832,9,5,1,0,15,6,4,0,0,10
734,zoom.us,legit,2.52164,3,3,7,0,1.0,0.36023,1,0,0,0,1,1,0,0,0,1
4674,images.squarespace-cdn.com,legit,3.81507,9,14,26,0,0.64286,0.14673,8,2,0,0,10,8,1,0,0,9
1963,avast.com,legit,2.9477,3,5,9,0,0.6,0.32752,1,1,0,0,2,2,0,0,0,2
6027,cegoflacgif.com,dga,3.1899,5,9,15,1,0.55556,0.21266,2,0,0,0,2,3,0,0,0,3
3497,e8960.b.akamaiedge.net,legit,3.66353,8,7,22,0,1.14286,0.16652,5,5,5,3,18,4,0,0,0,4
2901,tags.srv.stackadapt.com,legit,3.46858,5,15,23,0,0.33333,0.15081,5,0,0,0,5,3,0,0,0,3
8651,hffcjliuchlqwklt.com,dga,3.64644,3,16,20,1,0.1875,0.18232,1,0,0,0,1,0,0,0,0,0
384,gspe79-ssl.ls.apple.com,legit,3.46858,4,13,23,0,0.30769,0.15081,6,4,3,2,15,1,0,0,0,1
7028,csngsxchinst.ru,dga,3.32323,2,12,15,1,0.16667,0.22155,2,0,0,0,2,3,0,0,0,3
3365,dynamic.criteo.com,legit,3.46132,6,10,18,0,0.6,0.1923,6,1,0,0,7,6,1,0,0,7
6226,lndcafmfebcmmofa.co,dga,3.28663,5,13,19,1,0.38462,0.17298,1,0,0,0,1,2,0,0,0,2
5573,cukio6gqg2wi.top,dga,3.625,5,8,16,1,0.625,0.22656,0,0,0,0,0,0,0,0,0,0
1381,globalredir.akadns.net,legit,3.69785,7,13,22,0,0.53846,0.16808,6,3,4,3,16,4,1,0,0,5
7417,477wpdokt6jh514s4v.biz,dga,4.15239,2,11,22,1,0.18182,0.18874,0,0,0,0,0,0,0,0,0,0
1400,api16-core-useast5.us.tiktokv.com,legit,4.0438,11,14,33,0,0.78571,0.12254,11,7,4,3,25,8,0,0,0,8
1197,attachments.office.net,legit,3.42512,7,13,22,0,0.53846,0.15569,8,5,4,3,20,6,1,0,0,7
6813,rotgtcn.cc,dga,2.64644,1,8,10,1,0.125,0.26464,1,0,0,0,1,0,0,0,0,0
3751,manage.agent-cluster2.prod.us001-prod.arcticwolf.net,legit,4.27978,14,27,52,0,0.51852,0.0823,15,6,3,4,28,10,3,0,0,13
1342,p16-sign-sg.tiktokcdn.com,legit,3.84386,4,15,25,0,0.26667,0.15375,4,6,7,6,23,3,0,0,0,3
6774,classlunchswingrepairsleep.com,dga,3.8314,9,20,30,1,0.45,0.12771,3,0,0,0,3,5,2,0,2,9
5219,riddenclear.net,dga,3.1899,5,9,15,1,0.55556,0.21266,3,0,0,0,3,7,0,0,0,7
2706,onedscolprdwus13.westus.cloudapp.azure.com,legit,3.98709,13,23,42,0,0.56522,0.09493,17,4,3,4,28,7,2,0,0,9
2620,a1091.dscw154.akamai.net,legit,3.85539,6,8,24,0,0.75,0.16064,5,3,4,3,15,3,0,0,0,3
681,safesearch.googleapis.com,legit,3.64307,10,13,25,0,0.76923,0.14572,7,6,4,4,21,6,0,0,0,6
7748,i6qbs8yhcv54sxabwlk.ddns.net,dga,4.35182,3,19,28,1,0.15789,0.15542,2,1,0,0,3,4,3,2,2,11
8173,dvc39c59o11hwo11kypqiwo61fwdqawbwmxhz.info,dga,4.31567,7,24,42,1,0.29167,0.10275,0,0,0,0,0,0,0,0,0,0
9751,bnegclwoagtinx.su,dga,3.85217,5,11,17,1,0.45455,0.2266,2,0,0,0,2,3,0,0,0,3
440,c.apple.news,legit,3.08496,3,7,12,0,0.42857,0.25708,5,4,3,2,14,1,0,0,0,1
6640,ncvdvpowdvwhuujkj.net,dga,3.6897,4,16,21,1,0.25,0.1757,0,0,0,0,0,0,0,0,0,0
3590,dscf.akamaiedge.net,legit,3.53689,7,10,19,0,0.7,0.18615,6,5,5,3,19,4,0,0,0,4
1770,com.rocket-cdn.com,legit,3.2391,4,11,18,0,0.36364,0.17995,4,3,1,0,8,4,1,0,0,5
9222,magovef.info,dga,3.25163,5,6,12,1,0.83333,0.27097,1,0,0,0,1,2,1,0,0,3
7692,bozgoqfa.ru,dga,3.27761,4,6,11,1,0.66667,0.29796,0,0,0,0,0,0,0,0,0,0
1888,acrobat.com,legit,2.91398,4,6,11,0,0.66667,0.26491,3,1,0,0,4,2,0,0,0,2
9939,apqxlqvvjvwelkgpd.com,dga,3.88018,3,17,21,1,0.17647,0.18477,1,0,0,0,1,1,0,0,0,1
9130,violationscrack.in,dga,3.46132,7,10,18,1,0.7,0.1923,5,0,0,0,5,7,3,2,1,13
6598,ivitsajkbjfjch.org,dga,3.79465,4,13,18,1,0.30769,0.21081,0,0,0,0,0,1,0,0,0,1
4392,alt5-mtalk.google.com,legit,3.46328,6,11,21,0,0.54545,0.16492,3,5,4,3,15,2,0,0,0,2
7437,hslrdovguvxfjmrfvl.com,dga,3.78875,3,18,22,1,0.16667,0.17222,0,0,0,0,0,0,0,0,0,0
1360,widgets.outbrain.com,legit,3.92193,7,11,20,0,0.63636,0.1961,5,1,0,0,6,4,0,0,0,4
2773,stats.wp.com,legit,3.08496,2,8,12,0,0.25,0.25708,4,0,0,0,4,3,0,0,0,3
2580,p.placed.com,legit,3.08496,3,7,12,0,0.42857,0.25708,4,0,0,0,4,4,0,0,0,4
9403,syndication-phase.az,dga,3.78418,7,11,20,1,0.63636,0.18921,5,0,0,0,5,8,3,2,1,14
6445,maximillianblackburn.net,dga,3.62581,8,15,24,1,0.53333,0.15108,3,0,0,0,3,5,0,0,0,5
5003,ixekrihagimau.ddns.net,dga,3.78875,8,12,22,1,0.66667,0.17222,3,1,0,0,4,6,3,3,2,14
2271,pull-f5-vr-sg01.tiktokcdn.com.c.worldfcdn.com,legit,4.21443,6,28,45,0,0.21429,0.09365,6,10,12,10,38,5,2,1,0,8
4764,cdn.mwbsys.com,legit,3.23593,1,11,14,0,0.09091,0.23114,3,2,1,0,6,1,0,0,0,1
8859,ogqkyoqegiakmkks.org,dga,3.34644,6,13,20,1,0.46154,0.16732,0,0,0,0,0,0,0,0,0,0
5515,5xong07reny4cxu4q6o.ddns.net,dga,4.09307,5,15,28,1,0.33333,0.14618,5,1,0,0,6,7,4,3,2,16
2078,crl.comodoca.com,legit,2.75,5,9,16,0,0.55556,0.17188,3,2,1,0,6,3,2,1,0,6
313,kt-prod.ess.apple.com,legit,3.65376,5,12,21,0,0.41667,0.17399,10,7,5,3,25,2,2,0,0,4
7491,throwsincomplete.yt,dga,3.78714,5,13,19,1,0.38462,0.19932,6,2,0,0,8,7,1,0,0,8
8895,btrgppooshabtiegk.com,dga,3.78494,6,14,21,1,0.42857,0.18024,3,0,0,0,3,1,0,0,0,1
1766,init.supersonicads.com,legit,3.66353,8,12,22,0,0.66667,0.16652,6,0,0,0,6,8,1,0,0,9
4760,login.wikimedia.org,legit,3.51109,8,9,19,0,0.88889,0.18479,3,0,0,0,3,2,0,0,0,2
1925,urs.microsoft.com,legit,3.21953,5,10,17,0,0.5,0.18938,7,8,7,6,28,2,0,0,0,2
4745,s.twitter.com,legit,3.18083,3,8,13,0,0.375,0.24468,4,0,0,0,4,3,1,0,0,4
7891,tdownjkjxttkbeguhgavwgujf.ru,dga,3.98523,6,21,28,1,0.28571,0.14233,0,0,0,0,0,1,0,0,0,1
8640,vereipsiustimlitmorsive.com,dga,3.50028,11,15,27,1,0.73333,0.12964,6,0,0,0,6,8,2,0,0,10
204,edge-mqtt.facebook.com,legit,3.66353,7,12,22,0,0.58333,0.16652,4,2,1,0,7,4,0,0,0,4
7979,gnfoycbxaewsslhjq.in,dga,4.12193,4,15,20,1,0.26667,0.2061,0,0,0,0,0,0,0,0,0,0
5357,fobatuz.info,dga,3.25163,5,6,12,1,0.83333,0.27097,1,0,0,0,1,1,0,0,0,1
5998,xlfmddtunoapyjhc.eu,dga,4.0374,5,13,19,1,0.38462,0.21249,1,0,0,0,1,1,0,0,0,1
6349,enblbkmfbllcedna.net,dga,3.37095,4,15,20,1,0.26667,0.16855,4,0,0,0,4,4,0,0,0,4
3770,prod.cms.msn.com,legit,3.03064,2,11,16,0,0.18182,0.18942,6,3,2,1,12,0,1,0,0,1
7360,inexjqt.cc,dga,3.12193,2,7,10,1,0.28571,0.31219,1,0,0,0,1,2,1,0,0,3
3431,array508.prod.do.dsp.mp.microsoft.com,legit,3.71259,8,20,37,0,0.4,0.10034,12,12,10,9,43,5,2,0,0,7
712,images-na.ssl-images-amazon.com,legit,3.52308,11,15,31,0,0.73333,0.11365,5,2,3,2,12,5,0,0,0,5
2237,21-courier.push.apple.com,legit,3.86347,8,11,25,0,0.72727,0.15454,9,4,3,2,18,4,0,0,0,4
9612,erqofkxwnwqlliri.info,dga,3.49923,6,14,21,1,0.42857,0.16663,3,0,0,0,3,2,0,0,0,2
7376,wj12yt1pg87ve0et70a.ddns.net,dga,4.03915,4,14,28,1,0.28571,0.14426,2,1,0,0,3,6,4,3,2,15
7983,rionncnwbe.com,dga,3.18201,4,9,14,1,0.44444,0.22729,1,0,0,0,1,3,1,0,0,4
2330,res.cloudinary.com,legit,3.72548,6,10,18,0,0.6,0.20697,7,3,3,2,15,4,1,0,0,5
3816,crl4.digicert.com,legit,3.45482,4,10,17,0,0.4,0.20322,5,1,0,0,6,4,0,0,0,4
5005,djqrmauttlloabj.com,dga,3.61635,5,13,19,1,0.38462,0.19033,2,0,0,0,2,1,0,0,0,1
1935,wu-bg-shim.trafficmanager.net,legit,4.00436,8,17,29,0,0.47059,0.13808,6,3,1,3,13,6,1,0,0,7
589,browser.events.data.msn.com,legit,3.66193,7,16,27,0,0.4375,0.13563,10,2,0,0,12,7,2,0,0,9
9276,keqrwcuymrdypdyhxngaonn.com,dga,4.0323,5,21,27,1,0.2381,0.14934,1,0,0,0,1,1,0,0,0,1
1331,cdn.walkme.com,legit,3.37878,3,9,14,0,0.33333,0.24134,2,2,1,0,5,1,0,0,0,1
736,courier-push-apple.com.akadns.net,legit,4.0438,11,17,33,0,0.64706,0.12254,13,9,9,9,40,7,3,1,0,11
344,ocsp.r2m02.amazontrust.com,legit,3.69026,6,14,26,0,0.42857,0.14193,8,1,3,3,15,4,0,0,0,4
8190,ugysyku8ewaw.org,dga,3.5,5,9,16,1,0.55556,0.21875,0,0,0,0,0,0,0,0,0,0
332,adobe.io,legit,2.75,5,2,8,0,2.5,0.34375,1,0,0,0,1,1,0,0,0,1
8498,dxhzqe.dynserv.com,dga,3.83659,3,13,18,1,0.23077,0.21314,4,1,1,0,6,4,6,5,4,19
7176,ragulipaakvi.ddns.net,dga,3.78494,7,12,21,1,0.58333,0.18024,4,1,0,0,5,5,4,3,2,14
70,edge.skype.com,legit,3.32486,4,8,14,0,0.5,0.23749,3,2,1,0,6,2,0,0,0,2
9476,mbghmpkdl.cc,dga,3.25163,0,11,12,1,0.0,0.27097,0,0,0,0,0,0,0,0,0,0
5208,ogumdohge.com,dga,3.02699,5,7,13,1,0.71429,0.23285,1,0,0,0,1,1,0,0,0,1
619,westus.cloudapp.azure.com,legit,3.78347,9,13,25,0,0.69231,0.15134,12,4,3,4,23,3,1,0,0,4
4689,pxl.jivox.com,legit,3.2389,3,8,13,0,0.375,0.24915,0,0,0,0,0,0,0,0,0,0
2912,onedscolprdcus06.centralus.cloudapp.azure.com,legit,3.91643,14,25,45,0,0.56,0.08703,19,5,3,4,31,8,3,0,0,11
6180,janmiwoq.ru,dga,3.45943,4,6,11,1,0.66667,0.31449,1,0,0,0,1,2,0,0,0,2
5045,capitalhuntdealsmokeboxclue.com,dga,3.99373,12,18,31,1,0.66667,0.12883,5,1,0,0,6,5,1,0,0,6
2294,www.netflix.com,legit,3.45656,3,10,15,0,0.3,0.23044,1,0,0,0,1,2,0,0,0,2
6434,mahjzquizl.com,dga,3.52164,4,9,14,1,0.44444,0.25155,1,0,0,0,1,1,0,0,0,1
9529,vojuzem.info,dga,3.4183,5,6,12,1,0.83333,0.28486,0,0,0,0,0,1,0,0,0,1
603,cloudsink.net,legit,3.54659,4,8,13,0,0.5,0.27281,4,3,2,1,10,2,0,0,0,2
6856,weatherspace.net,dga,3.25,6,9,16,1,0.66667,0.20312,4,0,0,0,4,5,2,1,1,9
5159,iqkqldvupavv.sc,dga,3.45656,3,11,15,1,0.27273,0.23044,0,0,0,0,0,0,0,0,0,0
4291,onedscolprduks03.uksouth.cloudapp.azure.com,legit,4.02536,14,23,43,0,0.6087,0.09361,13,4,3,4,24,5,1,0,0,6
6207,rainsizerepairtreewonder.com,dga,3.59399,12,15,28,1,0.8,0.12836,5,0,0,0,5,9,1,0,2,12
7022,fosohwoflor.com,dga,2.99958,5,9,15,1,0.55556,0.19997,2,1,0,0,3,1,0,0,0,1
8958,marivom.su,dga,3.12193,4,5,10,1,0.8,0.31219,1,0,0,0,1,4,0,0,0,4
9803,soerwmucp.net,dga,3.54659,4,8,13,1,0.5,0.27281,1,0,0,0,1,1,0,0,0,1
6802,hogukaosbooreho.ddns.net,dga,3.60123,9,13,24,1,0.69231,0.15005,4,1,0,0,5,6,4,3,2,15
1014,pull-cmaf-f16-tt02.tiktokcdn.com,legit,4.07782,5,18,32,0,0.27778,0.12743,5,6,9,7,27,3,0,0,0,3
1218,d.adroll.com,legit,2.9183,3,7,12,0,0.42857,0.24319,4,0,0,0,4,0,0,0,0,0
7113,quickhers.net,dga,3.54659,4,8,13,1,0.5,0.27281,2,0,0,0,2,2,2,0,0,4
96,stats.g.doubleclick.net,legit,3.76227,6,14,23,0,0.42857,0.16358,9,0,0,0,9,7,0,0,0,7
9337,qyliciunkjjpsr.org,dga,3.83659,4,13,18,1,0.30769,0.21314,2,0,0,0,2,1,0,0,0,1
9304,geouvsiugkeq.net,dga,3.45282,7,8,16,1,0.875,0.2158,2,0,0,0,2,2,0,3,2,7
3275,v0cdn.net,legit,2.9477,1,6,9,0,0.16667,0.32752,2,1,0,0,3,1,0,0,0,1
4120,amazon.map.fastly.net,legit,3.49923,6,12,21,0,0.5,0.16663,7,2,3,2,14,5,0,0,0,5
8708,jupdeove.ru,dga,3.0958,5,5,11,1,1.0,0.28144,0,0,0,0,0,2,1,0,0,3
9011,nmnxadxdnf.com,dga,3.03915,2,11,14,1,0.18182,0.21708,2,0,0,0,2,1,0,0,0,1
7023,ecclesiepecca.com,dga,2.93395,7,9,17,1,0.77778,0.17259,2,0,0,0,2,5,0,0,0,5
3968,pus4-collabhubrtc.officeapps.live.com,legit,4.10082,11,21,37,0,0.52381,0.11083,10,5,4,3,22,6,0,0,0,6
2293,shared.officeapps.live.com,legit,3.79622,9,14,26,0,0.64286,0.14601,11,5,4,3,23,7,0,0,0,7
3723,hb.yellowblue.io,legit,3.20282,6,8,16,0,0.75,0.20018,1,0,0,0,1,1,0,0,0,1
4054,mus.cisco.com,legit,2.71929,4,7,13,0,0.57143,0.20918,4,0,0,0,4,2,0,0,0,2
4299,europe-west1-gcp.api.snapchat.com,legit,3.9832,10,17,33,0,0.58824,0.1207,8,2,1,0,11,3,2,0,0,5
9247,mcpudufqbex.cc,dga,3.32486,3,10,14,1,0.3,0.23749,0,0,0,0,0,1,3,2,2,8
4624,uk-script.dotmetrics.net,legit,3.75163,6,15,24,0,0.4,0.15632,3,0,0,0,3,4,0,0,0,4
2013,firestore.googleapis.com,legit,3.63684,10,12,24,0,0.83333,0.15154,9,6,4,4,23,7,2,0,0,9
5928,a4u0awuki8uk.net,dga,3.45282,7,5,16,1,1.4,0.2158,0,0,0,0,0,0,0,0,0,0
5710,vplaiaeeahoaawgk.eu,dga,3.38664,11,7,19,1,1.57143,0.17824,2,0,0,0,2,2,0,0,0,2
1988,spot.im,legit,2.80735,2,4,7,0,0.5,0.40105,0,0,0,0,0,0,0,0,0,0
7694,uswqakuwkyaoskso.org,dga,3.30869,7,12,20,1,0.58333,0.16543,1,0,0,0,1,0,0,0,0,0
1875,array803.prod.do.dsp.mp.microsoft.com,legit,3.71259,8,20,37,0,0.4,0.10034,12,12,10,9,43,5,2,0,0,7
9710,ijlrwtggexfkmc.org,dga,3.79465,3,14,18,1,0.21429,0.21081,1,0,0,0,1,1,0,0,0,1
9745,jmmssahresvhuyovnat.ki,dga,3.87966,6,15,22,1,0.4,0.17635,3,0,0,0,3,3,1,0,0,4
3168,sync1.intentiq.com,legit,3.46132,4,11,18,0,0.36364,0.1923,5,1,0,0,6,4,1,1,0,6
9350,suggestsmembers.tf,dga,3.12799,4,13,18,1,0.30769,0.17378,4,0,0,0,4,7,2,0,0,9
2539,tanium.com,legit,3.12193,4,5,10,0,0.8,0.31219,1,0,0,0,1,3,0,0,0,3
5276,oqbefuwe.com,dga,3.25163,5,6,12,1,0.83333,0.27097,0,0,0,0,0,1,1,0,0,2
2927,beacon-sjc2.rubiconproject.com,legit,3.85324,9,17,30,0,0.52941,0.12844,6,2,0,0,8,7,2,0,0,9
8843,kutensypalw.jp,dga,3.6645,3,10,14,1,0.3,0.26175,2,0,0,0,2,3,0,0,0,3
441,aa.google.com,legit,2.87314,6,5,13,0,1.2,0.22101,2,5,4,3,14,1,0,0,0,1
628,spotxchange.com,legit,3.64022,4,10,15,0,0.4,0.24268,1,0,0,0,1,2,1,0,0,3
1982,us-east1-aws-acc.api.snapchat.com,legit,3.68017,10,16,33,0,0.625,0.11152,7,3,1,0,11,5,1,0,0,6
6693,yksythkbgspkdyip.eu,dga,3.53689,3,15,19,1,0.2,0.18615,0,0,0,0,0,0,0,0,0,0
5226,jlkcfyqhktd.tv,dga,3.52164,0,13,14,1,0.0,0.25155,0,0,0,0,0,0,0,0,0,0
4773,azad.adsrvr.org,legit,3.00624,4,9,15,0,0.44444,0.20042,4,0,0,0,4,0,0,0,0,0
4666,sharepoint.com.dual-spo-0003.spo-msedge.net,legit,4.11778,12,20,43,0,0.6,0.09576,9,5,3,1,18,9,2,1,0,12
3399,usdal2.icloud-content.com,legit,3.78347,8,13,25,0,0.61538,0.15134,9,5,2,1,17,5,2,0,0,7
7674,efuovbpnt.lu,dga,3.4183,4,7,12,1,0.57143,0.28486,1,0,0,0,1,0,0,0,0,0
5982,gahyfus.com,dga,3.45943,3,7,11,1,0.42857,0.31449,1,0,0,0,1,0,0,0,0,0
8684,cymgclv.yi.org,dga,3.23593,2,10,14,1,0.2,0.23114,0,0,0,0,0,0,0,0,0,0
4059,carbonblack.io,legit,3.23593,5,8,14,0,0.625,0.23114,1,0,0,0,1,5,0,0,0,5
9887,omueqojpuaabaerq.eu,dga,3.28663,11,7,19,1,1.57143,0.17298,1,0,0,0,1,2,0,0,0,2
3080,cdn-gl.imrworldwide.com,legit,3.62118,5,15,23,0,0.33333,0.15744,2,1,0,0,3,3,0,0,0,3
8087,mflacknddbnnlaaa.cc,dga,3.11583,4,14,19,1,0.28571,0.16399,0,0,0,0,0,4,0,0,0,4
8283,fiphksndhx.com,dga,3.6645,2,11,14,1,0.18182,0.26175,0,0,0,0,0,1,0,0,0,1
4543,office.net.edgekey.net,legit,3.26558,8,11,22,0,0.72727,0.14844,6,6,4,2,18,6,0,0,0,6
7638,ioemrdqnompglimxp.su,dga,3.78418,6,13,20,1,0.46154,0.18921,1,0,0,0,1,2,0,0,0,2
4844,e9957.e4.akamaiedge.net,legit,3.51837,9,6,23,0,1.5,0.15297,5,5,5,3,18,4,0,0,0,4
66,apple-dns.net,legit,3.2389,3,8,13,0,0.375,0.24915,5,4,2,1,12,3,1,0,0,4
9492,kwykgayjpertekksdrc.com,dga,3.82791,4,18,23,1,0.22222,0.16643,2,0,0,0,2,2,0,0,0,2
2269,eu-u.openx.net,legit,3.03915,6,5,14,0,1.2,0.21708,1,0,0,0,1,1,0,0,0,1
7094,hcvqdmnbxtkwwvlvo.com,dga,3.78494,2,18,21,1,0.11111,0.18024,0,0,0,0,0,0,0,0,0,0
2311,createpdf.acrobat.com,legit,3.46328,7,12,21,0,0.58333,0.16492,7,1,0,0,8,5,1,0,0,6
5901,jrfjookfwtovdtgr.info,dga,3.49923,5,15,21,1,0.33333,0.16663,1,0,0,0,1,0,0,0,0,0
9010,oteyubxowxjh.org,dga,3.57782,5,10,16,1,0.5,0.22361,1,0,0,0,1,1,0,0,0,1
7430,xbrhswmdgd.yi.org,dga,3.61687,2,13,17,1,0.15385,0.21276,1,0,0,0,1,0,0,0,0,0
3608,surveywall-api.survata.com,legit,3.93121,9,14,26,0,0.64286,0.1512,4,1,1,0,6,4,0,0,0,4
1677,api22-core.tiktokv.com,legit,3.69785,7,10,22,0,0.7,0.16808,7,6,4,3,20,4,0,0,0,4
5617,musirgafl.com,dga,3.54659,4,8,13,1,0.5,0.27281,1,0,0,0,1,1,0,0,0,1
7941,fdflfbodofbcfncc.website,dga,3.45499,5,18,24,1,0.27778,0.14396,1,0,0,0,1,0,0,0,0,0
484,people-pa.googleapis.com,legit,3.38684,10,11,24,0,0.90909,0.14112,6,7,4,4,21,3,0,0,0,3
2569,b-code.liadm.com,legit,3.375,5,8,16,0,0.625,0.21094,4,0,0,0,4,2,0,0,0,2
2189,1.oca.nflxvideo.net,legit,3.68188,6,9,19,0,0.66667,0.19378,0,0,0,0,0,2,0,0,0,2
584,ads.stickyadstv.com,legit,3.47135,4,13,19,0,0.30769,0.1827,6,0,0,0,6,3,0,0,0,3
9859,narolsa.com,dga,3.0958,4,6,11,1,0.66667,0.28144,1,0,0,0,1,1,0,0,0,1
2242,5-courier.push.apple.com,legit,3.77206,8,11,24,0,0.72727,0.15717,9,4,3,2,18,4,0,0,0,4
4960,appcues.net,legit,3.0958,4,6,11,0,0.66667,0.28144,3,1,0,0,4,1,0,0,0,1
352,match.adsrvr.org,legit,3.45282,3,11,16,0,0.27273,0.2158,5,0,0,0,5,2,0,0,0,2
6815,emcucaeuuwkiiwyc.org,dga,3.54644,9,10,20,1,0.9,0.17732,0,0,0,0,0,2,0,0,0,2
1666,sni.global.fastly.net,legit,3.55852,5,13,21,0,0.38462,0.16945,2,1,0,0,3,3,0,0,0,3
2792,imageproxy.us.criteo.net,legit,3.85539,9,12,24,0,0.75,0.16064,9,2,0,0,11,5,1,0,0,6
8199,suaigiturfacilequamnummo.com,dga,3.75343,13,14,28,1,0.92857,0.13405,2,0,0,0,2,5,1,0,0,6
6884,cazxjvamnjkzqcaxhtkaumnpga.biz,dga,3.96141,7,22,30,1,0.31818,0.13205,1,0,0,0,1,2,0,0,0,2
6024,veiqohoj.ru,dga,3.27761,5,5,11,1,1.0,0.29796,0,0,0,0,0,1,0,0,0,1
133,blob.core.windows.net,legit,3.55852,6,12,21,0,0.5,0.16945,6,1,0,0,7,5,1,0,0,6
3435,prod.ocws1.live.com.akadns.net,legit,3.96141,8,16,30,0,0.5,0.13205,10,9,9,9,37,5,4,1,0,10
1378,rt.applovin.com,legit,3.50689,4,9,15,0,0.44444,0.23379,6,3,2,1,12,1,0,0,0,1
9829,luxkabeh.ru,dga,3.27761,4,6,11,1,0.66667,0.29796,0,0,0,0,0,1,0,0,0,1
5976,qmpxbqyeqdop.pw,dga,3.27291,2,12,15,1,0.16667,0.21819,0,0,0,0,0,0,0,0,0,0
8413,egnicusdumu.com,dga,3.32323,6,8,15,1,0.75,0.22155,2,0,0,0,2,2,0,0,0,2
4454,o2r2hew432.execute-api.us-east-1.amazonaws.com,legit,4.21402,16,17,46,0,0.94118,0.09161,10,3,4,3,20,8,0,0,0,8
5621,nitkvnpfxgnvboalvm.com,dga,3.84535,4,17,22,1,0.23529,0.17479,0,0,0,0,0,2,0,0,0,2
3258,cds.connatix.com,legit,3.32782,4,10,16,0,0.4,0.20799,8,2,0,0,10,4,3,0,0,7
5467,rkisllp.dynserv.com,dga,3.82687,3,14,19,1,0.21429,0.20141,4,1,1,0,6,5,5,5,4,19
9794,rpywfjryorayjxsrhxt.ac,dga,3.60694,3,18,22,1,0.16667,0.16395,1,0,0,0,1,2,0,0,0,2
6334,ugafewreinr.ddns.net,dga,3.54644,6,12,20,1,0.5,0.17732,4,1,0,0,5,6,3,2,1,12
5760,o11lqn60p32fwoqm59dse11eqa17ita27hzhsaq.com,dga,4.47,9,19,43,1,0.47368,0.10395,3,0,0,0,3,3,1,0,0,4
6402,drlrozgrg13g63jwhsbsa37b38p52brg13mxov.com,dga,4.36566,4,25,42,1,0.16,0.10394,1,0,0,0,1,0,0,0,0,0
8330,gksbzzbsgy.cc,dga,2.93121,0,12,13,1,0.0,0.22548,0,0,0,0,0,0,0,0,0,0
6925,sukulkuiwcymao.biz,dga,3.68354,7,10,18,1,0.7,0.20464,1,0,0,0,1,2,0,5,4,11
5259,kewttsjnyl.com,dga,3.6645,2,11,14,1,0.18182,0.26175,0,0,0,0,0,0,0,0,0,0
2600,discord.gg,legit,2.92193,2,7,10,0,0.28571,0.29219,1,0,0,0,1,3,0,0,0,3
2720,time.google.com,legit,3.05656,6,7,15,0,0.85714,0.20377,4,5,4,3,16,2,0,0,0,2
7079,qjokrdooycqd.net,dga,3.45282,4,11,16,1,0.36364,0.2158,1,0,0,0,1,0,0,0,0,0
3888,emea.presence.teams.microsoft.com,legit,3.47547,12,17,33,0,0.70588,0.10532,18,9,7,6,40,11,2,1,0,14
882,excel-telemetry.officeapps.live.com,legit,3.81739,12,19,35,0,0.63158,0.10907,10,5,4,3,22,9,0,0,0,9
7652,rynenogupez.eu,dga,3.18201,6,7,14,1,0.85714,0.22729,1,0,0,0,1,2,0,0,0,2
7373,iecoirfuguivdceftfnd.com,dga,3.65727,9,14,24,1,0.64286,0.15239,2,0,0,0,2,4,0,0,0,4
4432,i.ctnsnet.com,legit,3.08506,3,8,13,0,0.375,0.23731,1,0,0,0,1,3,0,0,0,3
1269,enterpriseregistration.windows.net,legit,3.48851,12,20,34,0,0.6,0.1026,13,2,0,0,15,14,10,2,1,27
7805,isucnutsa.com,dga,3.2389,5,7,13,1,0.71429,0.24915,0,0,0,0,0,2,0,0,0,2
6522,fkskltnbxhly.me,dga,3.64022,1,13,15,1,0.07692,0.24268,0,0,0,0,0,0,0,0,0,0
5265,a2ix16edy61f1xg.ddns.net,dga,3.77206,4,12,24,1,0.33333,0.15717,3,1,0,0,4,5,3,3,2,13
8066,ffcndfafblaaoaeo.co.uk,dga,3.33421,9,11,22,1,0.81818,0.15156,2,1,0,0,3,3,1,0,0,4
4737,fp-vp.azureedge.net,legit,3.61635,6,10,19,0,0.6,0.19033,5,2,1,2,10,3,0,0,0,3
2978,play-cdn.itunes-apple.com.akadns.net,legit,3.90576,10,20,36,0,0.5,0.10849,12,11,10,9,42,9,3,1,0,13
382,everesttech.net,legit,2.81592,5,9,15,0,0.55556,0.18773,5,0,0,0,5,7,4,0,0,11
2516,sdk.split.io,legit,3.08496,3,7,12,0,0.42857,0.25708,2,0,0,0,2,1,0,0,0,1
5251,luttherconcedunt.com,dga,3.44644,6,13,20,1,0.46154,0.17232,6,1,0,0,7,5,3,1,0,9
55,edge.microsoft.com,legit,3.46132,6,10,18,0,0.6,0.1923,9,10,8,6,33,4,0,0,0,4
2543,tasks-pa.clients6.google.com,legit,3.86933,8,15,28,0,0.53333,0.13819,7,6,4,3,20,4,1,0,0,5
1199,app.launchdarkly.com,legit,3.68418,5,13,20,0,0.38462,0.18421,3,1,0,0,4,2,0,0,0,2
9027,hhooonetkkgx.biz,dga,3.45282,5,10,16,1,0.5,0.2158,2,0,0,0,2,3,2,0,0,5
6709,quodverborumthesauri.com,dga,3.82393,10,13,24,1,0.76923,0.15933,2,0,0,0,2,5,1,0,0,6
1456,samsungcloud.com,legit,3.375,5,10,16,0,0.5,0.21094,3,3,2,1,9,2,0,0,0,2
5099,ekxdufxllm.com,dga,3.37878,3,10,14,1,0.3,0.24134,0,0,0,0,0,0,0,0,0,0
5250,anfneeabaodnbnob.online,dga,3.02229,10,12,23,1,0.83333,0.1314,2,0,0,0,2,4,0,0,0,4
5938,udmhaxobct.yi.org,dga,3.85217,5,10,17,1,0.5,0.2266,0,0,0,0,0,0,0,0,0,0
2098,1533248697.rsc.cdn77.org,legit,3.93872,1,8,24,0,0.125,0.16411,3,1,0,0,4,1,0,0,0,1
9670,dodafbedcfnloklc.de,dga,3.30056,5,13,19,1,0.38462,0.17371,2,0,0,0,2,2,0,0,0,2
7868,asa86kuo6sic.net,dga,3.625,6,6,16,1,1.0,0.22656,1,0,0,0,1,3,0,0,0,3
970,2be4.phicdn.net,legit,3.50689,3,8,15,0,0.375,0.23379,3,1,0,0,4,3,0,0,0,3
122,ocsp.pki.goog,legit,2.87314,4,7,13,0,0.57143,0.22101,1,0,0,0,1,0,0,0,0,0
4252,default.exp-tas.com,legit,3.82687,6,10,19,0,0.6,0.20141,1,0,0,0,1,3,0,0,0,3
6718,gojkdufqbex.com,dga,3.77356,4,10,15,1,0.4,0.25157,0,0,0,0,0,1,3,2,2,8
8078,lyryjuj.com,dga,3.0958,2,8,11,1,0.25,0.28144,0,0,0,0,0,0,0,0,0,0
9987,primispapapa.com,dga,2.95282,6,9,16,1,0.66667,0.18455,3,0,0,0,3,3,0,0,0,3
7636,nconcionatorescompuquas.com,dga,3.5562,11,15,27,1,0.73333,0.13171,5,2,0,0,7,8,4,0,0,12
1826,com.c.worldfcdn.com,legit,3.11583,3,13,19,0,0.23077,0.16399,4,3,1,0,8,4,1,0,0,5
1297,nf.smartscreen.microsoft.com,legit,3.50274,7,18,28,0,0.38889,0.1251,9,8,7,6,30,6,0,0,0,6
4830,ir.ebaystatic.com,legit,3.49923,6,9,17,0,0.66667,0.20584,5,0,0,0,5,5,1,0,0,6
6237,vapatipe.ru,dga,3.0958,5,5,11,1,1.0,0.28144,3,0,0,0,3,2,1,0,0,3
4357,bumlam.com,legit,2.84644,3,6,10,0,0.5,0.28464,1,0,0,0,1,2,0,0,0,2
2113,1971296482.rsc.cdn77.org,legit,3.77206,1,8,24,0,0.125,0.15717,3,1,0,0,4,1,0,0,0,1
504,bidr.io,legit,2.52164,3,3,7,0,1.0,0.36023,0,0,0,0,0,0,0,0,0,0
147,scorecardresearch.com,legit,3.11828,7,13,21,0,0.53846,0.14849,5,0,0,0,5,9,1,0,0,10
1133,gcdn.2mdn.net,legit,3.02699,1,9,13,0,0.11111,0.23285,2,2,1,0,5,1,0,0,0,1
3800,cdn.evgnet.com,legit,3.23593,3,9,14,0,0.33333,0.23114,2,2,1,0,5,3,0,0,0,3
1350,csm.va.us.criteo.net,legit,3.52193,6,10,20,0,0.6,0.1761,5,0,0,0,5,3,0,0,0,3
6307,olpebusaoshiec.ddns.net,dga,3.76227,8,13,23,1,0.61538,0.16358,3,1,0,0,4,5,3,2,2,12
1503,gvt3.com,legit,3.0,1,5,8,0,0.2,0.375,0,0,0,0,0,0,0,0,0,0
6363,dufinweco.com,dga,3.39275,5,7,13,1,0.71429,0.26098,2,0,0,0,2,3,0,0,0,3
5885,conffacitgratiepapales.com,dga,3.74833,10,15,26,1,0.66667,0.14417,8,1,0,0,9,9,2,0,0,11
2268,pull-f5-vr-va01.tiktokcdn.com.c.worldfcdn.com,legit,4.16999,7,27,45,0,0.25926,0.09267,6,10,12,10,38,5,2,1,0,8
6451,bamffbckdcfmcfad.com,dga,2.98418,3,16,20,1,0.1875,0.14921,2,0,0,0,2,1,0,0,0,1
9344,wt38cbit3bstc0u.ddns.net,dga,3.6683,3,15,24,1,0.2,0.15285,3,1,0,0,4,6,3,3,2,14
1698,ml314.com,legit,2.9477,1,4,9,0,0.25,0.32752,0,0,0,0,0,0,0,0,0,0
4175,bixby-client.aibixby.com,legit,3.58496,7,14,24,0,0.5,0.14937,4,1,0,0,5,1,1,0,0,2
3602,amer.ng.msg.teams-msgapi.trafficmanager.net,legit,3.61816,12,25,43,0,0.48,0.08414,12,4,2,3,21,9,1,0,0,10
5569,boipmuiwruluaqa.ddns.net,dga,3.97018,9,13,24,1,0.69231,0.16542,2,1,0,0,3,4,4,3,2,13
8628,pfaozzva.com,dga,3.08496,4,7,12,1,0.57143,0.25708,0,0,0,0,0,0,0,0,0,0
6636,bldmtmilxcxy.pw,dga,3.50689,1,13,15,1,0.07692,0.23379,1,0,0,0,1,1,0,0,0,1
6160,eupddnxyavfwm.com,dga,3.85217,4,12,17,1,0.33333,0.2266,1,0,0,0,1,2,1,0,0,3
1319,salesforceliveagent.com,legit,3.74095,9,13,23,0,0.69231,0.16265,8,2,0,0,10,9,1,0,0,10
5340,tipsolveshineparticipate.com,dga,3.72647,11,16,28,1,0.6875,0.13309,6,0,0,0,6,9,2,0,0,11
5712,cmbuofqolvtktsgbqrwfubyozrgjrpv.com,dga,4.17186,6,28,35,1,0.21429,0.1192,1,0,0,0,1,0,0,0,0,0
813,mixpanel.com,legit,3.4183,4,7,12,0,0.57143,0.28486,1,0,0,0,1,4,0,0,0,4
2871,adx.opera.com,legit,3.2389,5,6,13,0,0.83333,0.24915,3,0,0,0,3,2,0,0,0,2
551,tlx.3lift.com,legit,3.2389,2,8,13,0,0.25,0.24915,1,0,0,0,1,0,0,0,0,0
2442,farm.plista.com,legit,3.50689,4,9,15,0,0.44444,0.23379,4,0,0,0,4,4,1,0,0,5
9348,ngunxcycquawhkdx.eu,dga,3.68188,5,13,19,1,0.38462,0.19378,0,0,0,0,0,0,0,0,0,0
7258,ppnnqmyoqfglwi.de,dga,3.73452,3,13,17,1,0.23077,0.21968,1,0,0,0,1,0,0,0,0,0
909,fb.com,legit,2.58496,1,4,6,0,0.25,0.43083,0,0,0,0,0,0,0,0,0,0
3755,j.mrpdata.net,legit,3.2389,3,8,13,0,0.375,0.24915,3,0,0,0,3,2,0,0,0,2
879,1-courier.push.apple.com,legit,3.77206,8,11,24,0,0.72727,0.15717,9,4,3,2,18,4,0,0,0,4
6138,a37hrb38c19kufqd30o61osh34hwfwoyczd10n40.com,dga,4.48171,6,21,44,1,0.28571,0.10186,0,0,0,0,0,0,0,0,0,0
1845,se2.itunes.apple.com,legit,3.64644,7,9,20,0,0.77778,0.18232,8,4,3,2,17,5,0,0,0,5
9277,bdwwyqryxhhq.ru,dga,3.24022,1,13,15,1,0.07692,0.21601,0,0,0,0,0,0,0,0,0,0
2793,collect.tealiumiq.com,legit,3.36804,8,11,21,0,0.72727,0.16038,7,0,0,0,7,6,0,0,0,6
4750,cdn-lb.vungle.com,legit,3.61687,3,11,17,0,0.27273,0.21276,3,2,0,0,5,2,0,0,0,2
5197,leoxavanreosida.ddns.net,dga,3.54248,9,13,24,1,0.69231,0.1476,4,1,0,0,5,8,4,3,2,17
1092,match.deepintent.com,legit,3.44644,6,12,20,0,0.5,0.17232,8,1,0,0,9,7,1,1,0,9
3990,internal.dradis.netflix.com,legit,3.78212,8,16,27,0,0.5,0.14008,9,0,0,0,9,8,1,1,0,10
3885,eu.criteo.net,legit,3.02699,6,5,13,0,1.2,0.23285,3,0,0,0,3,3,0,0,0,3
2605,ebay.com,legit,3.0,3,4,8,0,0.75,0.375,0,0,0,0,0,0,0,0,0,0
4603,cloud.us,legit,2.75,3,4,8,0,0.75,0.34375,2,3,2,1,8,0,0,0,0,0
9806,schedulelows.ps,dga,3.32323,4,10,15,1,0.4,0.22155,3,0,0,0,3,3,0,0,0,3
1493,is1-ssl.mzstatic.com,legit,3.42193,4,12,20,0,0.33333,0.1711,6,0,0,0,6,6,1,0,0,7
1243,sync.adkernel.com,legit,3.61687,4,11,17,0,0.36364,0.21276,3,0,0,0,3,3,0,0,0,3
6152,grandfatherblameadoptchallenge.com,dga,3.84145,11,22,34,1,0.5,0.11298,9,0,0,0,9,11,3,1,1,16
4126,adaptv.advertising.com,legit,3.78875,7,13,22,0,0.53846,0.17222,6,0,0,0,6,6,2,0,0,8
5118,whiosphedghi.com,dga,3.45282,5,10,16,1,0.5,0.2158,1,1,0,0,2,1,0,0,0,1
8540,vilgirhu.ru,dga,2.91398,4,6,11,1,0.66667,0.26491,0,0,0,0,0,0,0,0,0,0
2296,ice.360yield.com,legit,3.5,5,6,16,0,0.83333,0.21875,3,1,0,0,4,3,0,0,0,3
4800,teams-office-com.s-0005.s-msedge.net,legit,3.78453,9,16,36,0,0.5625,0.10513,10,8,5,2,25,10,1,0,0,11
9361,qs6064ywu0io.net,dga,3.75,4,6,16,1,0.66667,0.23438,0,0,0,0,0,0,0,0,0,0
1300,sync-t1.taboola.com,legit,3.57662,5,10,19,0,0.5,0.18824,3,0,0,0,3,2,0,0,0,2
2257,20-courier.push.apple.com,legit,3.86347,8,11,25,0,0.72727,0.15454,9,4,3,2,18,4,0,0,0,4
5798,gjjmiaiajseewuunjx.eu,dga,3.36804,10,10,21,1,1.0,0.16038,2,0,0,0,2,2,0,0,0,2
6768,iayvjdbnfqncujuqq.net,dga,3.74899,5,15,21,1,0.33333,0.17852,0,0,0,0,0,0,0,0,0,0
7997,xauvasmwuamravb.org,dga,3.40582,7,11,19,1,0.63636,0.17925,2,0,0,0,2,3,0,0,0,3
3661,valid.origin-apple.com.akadns.net,legit,3.96834,11,17,33,0,0.64706,0.12025,13,9,9,9,40,8,3,1,0,12
5718,su4taf8mdkgf7t2yzb.net,dga,4.15239,3,14,22,1,0.21429,0.18874,1,0,0,0,1,2,0,0,0,2
6269,topuxkxoolocpwgme.com,dga,3.45853,7,13,21,1,0.53846,0.16469,2,0,0,0,2,0,0,0,0,0
5096,ggfqyuiiuycg.com,dga,3.20282,5,10,16,1,0.5,0.20018,0,0,0,0,0,0,0,0,0,0
8725,pqcfnksobchq.com,dga,3.45282,2,13,16,1,0.15385,0.2158,0,0,0,0,0,0,0,0,0,0
623,fontawesome.com,legit,3.32323,6,8,15,0,0.75,0.22155,4,0,0,0,4,4,0,0,0,4
3249,events.attentivemobile.com,legit,3.48468,10,14,26,0,0.71429,0.13403,8,1,0,0,9,7,1,0,0,8
868,ad.turn.com,legit,3.27761,3,6,11,0,0.5,0.29796,3,0,0,0,3,0,1,0,0,1
2272,pixel-eu.rubiconproject.com,legit,3.8562,10,14,27,0,0.71429,0.14282,6,2,0,0,8,5,2,0,0,7
5146,h7i665xhctw53vitp1.ru,dga,3.91613,3,10,21,1,0.3,0.18648,0,0,0,0,0,1,0,0,0,1
5398,chartcluebuildmessmarket.com,dga,3.86933,9,18,28,1,0.5,0.13819,2,0,0,0,2,4,2,1,0,7
8827,nosplenariecharitatis.com,dga,3.70347,10,14,25,1,0.71429,0.14814,6,1,0,0,7,10,3,1,0,14
982,pki-goog.l.google.com,legit,3.13686,7,10,21,0,0.7,0.14937,2,5,4,3,14,1,0,0,0,1
1349,va.us.criteo.net,legit,3.45282,6,7,16,0,0.85714,0.2158,5,0,0,0,5,3,0,0,0,3
9929,bhfefiiwmfweoiyw.eu,dga,3.2469,8,10,19,1,0.8,0.17089,0,0,0,0,0,0,0,0,0,0
5528,tokmjokeslowocv.com,dga,3.3211,6,12,19,1,0.5,0.17479,2,1,0,0,3,1,0,0,0,1
944,pull-f5-vr-gcp01.tiktokcdn.com,legit,4.1899,4,18,30,0,0.22222,0.13966,4,6,9,9,28,2,0,0,0,2
8842,aou864q82gqg.net,dga,3.625,4,6,16,1,0.66667,0.22656,1,0,0,0,1,0,0,0,0,0
4277,glb.sls.prod.dcat.dsp.trafficmanager.net,legit,3.90869,8,26,40,0,0.30769,0.09772,14,7,4,5,30,9,2,0,0,11
6686,aladlcaccbcabfdb.net,dga,3.08418,5,14,20,1,0.35714,0.15421,1,0,0,0,1,3,0,0,0,3
5920,fndgsujawdjddtgl.eu,dga,3.51109,4,14,19,1,0.28571,0.18479,0,0,0,0,0,3,0,0,0,3
7750,josephineblackbourne.net,dga,3.88684,9,14,24,1,0.64286,0.16195,3,0,0,0,3,5,1,0,0,6
1866,sandbox.itunes.apple.com,legit,3.88684,8,13,24,0,0.61538,0.16195,7,4,3,2,16,6,1,0,0,7
5249,djhvtxtklbfoajwkt.pw,dga,3.78418,2,17,20,1,0.11765,0.18921,0,0,0,0,0,0,0,0,0,0
5722,nqvzhdyr.net,dga,3.4183,1,10,12,1,0.1,0.28486,0,0,0,0,0,0,0,0,0,0
1831,deliveryengine.adswizz.com,legit,3.90217,9,15,26,0,0.6,0.15008,8,0,0,0,8,7,2,0,0,9
3675,impact-ad.jp,legit,3.25163,3,7,12,0,0.42857,0.27097,1,0,0,0,1,1,0,0,0,1
9863,takenhigh.net,dga,3.08506,4,8,13,1,0.5,0.23731,2,0,0,0,2,2,0,0,0,2
5752,cesocgqwygkuiamm.org,dga,3.78418,6,13,20,1,0.46154,0.18921,3,0,0,0,3,3,0,0,0,3
8105,took-donate.mo,dga,3.09307,6,6,14,1,1.0,0.22093,4,0,0,0,4,3,1,0,0,4
1084,kv501.prod.do.dsp.mp.microsoft.com,legit,3.69381,6,19,34,0,0.31579,0.10864,11,12,10,9,42,3,2,0,0,5
2248,liveperson.net,legit,3.32486,5,8,14,0,0.625,0.23749,3,0,0,0,3,3,1,0,0,4
9752,bpqmciybjcnuxvtdhda.com,dga,4.05596,4,18,23,1,0.22222,0.17635,0,0,0,0,0,0,0,0,0,0
7773,82wecek28q4a.org,dga,3.625,4,6,16,1,0.66667,0.22656,1,0,0,0,1,2,0,0,0,2
2755,proxyserverecs-1736642167.us-east-1.elb.amazonaws.com,legit,4.42615,13,22,53,0,0.59091,0.08351,12,4,4,3,23,12,5,1,0,18
9112,hdyljjqgkpycpyi.org,dga,3.68188,2,16,19,1,0.125,0.19378,0,0,0,0,0,0,0,0,0,0
5626,ofyvlxdryle.com,dga,3.50689,3,11,15,1,0.27273,0.23379,2,0,0,0,2,1,0,0,0,1
1655,footprints-pa.googleapis.com,legit,3.79434,10,15,28,0,0.66667,0.13551,8,6,4,4,22,5,1,0,0,6
2689,edge-itunes-apple.com.akadns.net,legit,3.87893,11,16,32,0,0.6875,0.12122,13,11,10,9,43,10,3,1,0,14
6748,ruhanean.ru,dga,2.73216,5,5,11,1,1.0,0.24838,1,0,0,0,1,3,0,0,0,3
3651,grs.dbankcloud.eu,legit,3.73452,5,10,17,0,0.5,0.21968,4,3,2,1,10,2,0,0,0,2
5317,ldcpnuvswiflqpcdp.com,dga,3.74899,3,17,21,1,0.17647,0.17852,1,0,0,0,1,0,0,0,0,0
9121,dhfxasc6cdnjnh43yl.com,dga,3.97057,2,16,22,1,0.125,0.18048,2,1,0,0,3,2,0,0,0,2
9221,nmeakflbnabflddm.com,dga,3.48418,4,15,20,1,0.26667,0.17421,1,0,0,0,1,2,0,0,0,2
5127,fmolcmafcmadndff.com,dga,2.98418,4,15,20,1,0.26667,0.14921,3,0,0,0,3,3,0,0,0,3
6684,hiunsaasufpi.ddns.net,dga,3.46328,7,12,21,1,0.58333,0.16492,3,1,0,0,4,6,4,3,2,15
8385,fulocwu.com,dga,2.91398,4,6,11,1,0.66667,0.26491,1,0,0,0,1,0,0,0,0,0
9763,mtuiqkpe.net,dga,3.25163,4,7,12,1,0.57143,0.27097,0,0,0,0,0,0,0,0,0,0
2996,ssl.fastly.net,legit,3.03915,2,10,14,0,0.2,0.21708,1,1,0,0,2,2,0,0,0,2
4744,eum-orange-saas.instana.io,legit,3.50354,12,10,26,0,1.2,0.13475,6,0,0,0,6,9,0,0,0,9
5872,xrcxsmifdtsmeblc.eu,dga,3.72161,4,14,19,1,0.28571,0.19587,1,0,0,0,1,1,0,0,0,1
6516,ipe8gt1dwn5tobcxa4ejavq.ddns.net,dga,4.28064,7,19,32,1,0.36842,0.13377,2,1,0,0,3,4,3,3,2,12
6400,w6c68ec2wuou.net,dga,3.375,5,6,16,1,0.83333,0.21094,1,0,0,0,1,1,0,0,0,1
9042,gociddit.com,dga,2.9183,4,7,12,1,0.57143,0.24319,0,0,0,0,0,2,0,0,0,2
3528,us.tvsquared.com,legit,3.625,5,9,16,0,0.55556,0.22656,5,0,0,0,5,3,0,0,0,3
1480,services.sfb.trafficmanager.net,legit,3.67115,9,19,31,0,0.47368,0.11842,10,5,2,4,21,9,3,1,0,13
2998,gti.trellix.com,legit,3.37356,4,9,15,0,0.44444,0.2249,4,0,0,0,4,3,0,0,0,3
7539,osrgpoonogokmoqn.info,dga,3.13487,8,12,21,1,0.66667,0.14928,2,0,0,0,2,1,0,0,0,1
5895,lqmmsjulquvgvxvj.eu,dga,3.32636,4,14,19,1,0.28571,0.17507,0,0,0,0,0,0,0,0,0,0
5313,0y4igasi0m8e.top,dga,3.75,5,6,16,1,0.83333,0.23438,0,0,0,0,0,2,0,0,0,2
5708,licerevispecicerte.com,dga,3.26104,9,12,22,1,0.75,0.14823,6,1,0,0,7,7,1,0,0,8
7427,hisoeqaniha.ddns.net,dga,3.38418,7,11,20,1,0.63636,0.16921,2,1,0,0,3,7,4,3,2,16
223,dns.opendns.com,legit,3.05656,3,10,15,0,0.3,0.20377,3,1,0,0,4,4,1,1,0,6
4158,v1.akaquill.net,legit,3.50689,5,7,15,0,0.71429,0.23379,1,2,1,0,4,0,0,0,0,0
9208,bnzv.com.jm,dga,3.0958,1,8,11,1,0.125,0.28144,2,2,1,0,5,2,2,1,0,5
3071,ak.sail-horizon.com,legit,3.68188,7,9,19,0,0.77778,0.19378,1,0,0,0,1,3,0,0,0,3
5986,forcespitediscountlunchresist.com,dga,3.80138,11,21,33,1,0.52381,0.11519,10,0,0,0,10,11,2,0,0,13
9808,confidencetableslipbottle.com,dga,3.71938,10,18,29,1,0.55556,0.12825,8,1,0,0,9,9,2,1,0,12
8241,cdlqymtiytsu.in,dga,3.50689,3,11,15,1,0.27273,0.23379,2,0,0,0,2,2,0,0,0,2
8899,baecodcdffdbcoaf.com,dga,3.00869,6,13,20,1,0.46154,0.15043,2,0,0,0,2,2,0,0,0,2
5243,qfvnxlsyjw.com,dga,3.80735,1,12,14,1,0.08333,0.27195,0,0,0,0,0,0,0,0,0,0
5092,artconfirmdraftlinkliftscratch.com,dga,3.72674,8,25,34,1,0.32,0.10961,7,1,0,0,8,6,1,0,0,7
6300,vgguflvlpnzg.com,dga,3.45282,2,13,16,1,0.15385,0.2158,0,0,0,0,0,0,0,0,0,0
3989,samsungcloudsolution.net,legit,3.62581,9,14,24,0,0.64286,0.15108,6,3,2,1,12,4,2,1,0,7
8650,axwawaafri.ddns.net,dga,3.40582,6,11,19,1,0.54545,0.17925,2,1,0,0,3,5,4,3,2,14
5756,aselmuhehu.ddns.net,dga,3.36609,6,11,19,1,0.54545,0.17716,3,1,0,0,4,7,3,3,2,15
3660,shb.richaudience.com,legit,3.68418,7,11,20,0,0.63636,0.18421,3,0,0,0,3,4,2,1,0,7
432,storage.googleapis.com,legit,3.51603,9,11,22,0,0.81818,0.15982,9,7,4,4,24,7,0,0,0,7
4731,fp-vp-nocache.azureedge.net,legit,3.88046,9,14,27,0,0.64286,0.14372,5,2,1,2,10,5,0,0,0,5
5781,g274ybor1vihgf3.ddns.net,dga,4.25163,3,14,24,1,0.21429,0.17715,2,1,0,0,3,5,3,2,2,12
9816,klafmijcivswgps.net,dga,4.0374,4,14,19,1,0.28571,0.21249,1,0,0,0,1,2,0,0,0,2
5173,misahgotde.com,dga,3.52164,5,8,14,1,0.625,0.25155,1,0,0,0,1,3,0,0,0,3
819,fp2e7a.wpc.phicdn.net,legit,3.65376,4,12,21,0,0.33333,0.17399,3,1,0,0,4,2,0,0,0,2
823,iadsdk.apple.com,legit,3.5,5,9,16,0,0.55556,0.21875,7,4,3,2,16,1,0,0,0,1
4083,streaming.split.io,legit,3.57243,6,10,18,0,0.6,0.19847,8,0,0,0,8,7,1,0,0,8
8120,msujmrxacb.com,dga,3.32486,3,10,14,1,0.3,0.23749,0,0,0,0,0,2,0,0,0,2
7228,mgy0ekuwa8io.top,dga,3.875,6,7,16,1,0.85714,0.24219,0,0,0,0,0,0,0,0,0,0
4140,reminders-pa.googleapis.com,legit,3.81008,10,14,27,0,0.71429,0.14111,9,6,4,4,23,10,1,0,0,11
3558,tv.edgekey.net,legit,2.95021,4,8,14,0,0.5,0.21073,2,2,1,0,5,2,0,0,0,2
4812,mshop.amazon.dev,legit,3.5,5,9,16,0,0.55556,0.21875,5,1,3,3,12,3,0,0,0,3
7179,hrqhtaqgzc.com,dga,3.37878,2,11,14,1,0.18182,0.24134,1,0,0,0,1,1,0,0,0,1
5261,hrthsdlesrvekceb.eu,dga,3.51109,5,13,19,1,0.38462,0.18479,3,0,0,0,3,4,0,0,0,4
465,lijit.com,legit,2.9477,3,5,9,0,0.6,0.32752,1,0,0,0,1,1,0,0,0,1
7346,nosehave.net,dga,3.02206,5,6,12,1,0.83333,0.25184,1,0,0,0,1,2,0,0,0,2
2782,wildcard46.go-mpulse.net.edgekey.net,legit,4.16257,10,19,36,0,0.52632,0.11563,4,3,1,0,8,7,0,0,0,7
7300,nirxugea.ru,dga,3.0958,5,5,11,1,1.0,0.28144,2,0,0,0,2,3,0,0,0,3
4528,tapjoy.com,legit,3.12193,3,6,10,0,0.5,0.31219,2,0,0,0,2,1,0,0,0,1
8965,sewrelwaigkmhxdbp.tw,dga,3.98418,4,15,20,1,0.26667,0.19921,2,0,0,0,2,3,0,0,0,3
6233,gmkegwugiqeyuiyo.org,dga,3.42193,8,11,20,1,0.72727,0.1711,0,0,0,0,0,0,0,0,0,0
1836,s.w.org,legit,2.52164,1,4,7,0,0.25,0.36023,1,0,0,0,1,0,0,0,0,0
3709,prod.detectportal.prod.cloudops.mozgcp.net,legit,3.70199,11,26,42,0,0.42308,0.08814,11,7,6,4,28,7,1,0,0,8
8592,mcbcbddnabacafdc.de,dga,2.90531,4,14,19,1,0.28571,0.15291,1,0,0,0,1,4,1,0,0,5
3967,content.powerapps.com,legit,3.46328,6,13,21,0,0.46154,0.16492,9,3,0,0,12,6,2,0,0,8
9696,cinemdi.com,dga,2.91398,4,6,11,1,0.66667,0.26491,1,0,0,0,1,3,1,0,0,4
8271,isacgef.com,dga,3.27761,4,6,11,1,0.66667,0.29796,1,0,0,0,1,3,0,0,0,3
778,sync.outbrain.com,legit,3.61687,5,10,17,0,0.5,0.21276,3,0,0,0,3,2,0,0,0,2
5131,yqyavpxkfrqcpvyen.com,dga,3.78494,3,17,21,1,0.17647,0.18024,1,0,0,0,1,1,0,0,0,1
9681,3hfcmsi2fae51syidm.com,dga,3.87966,5,12,22,1,0.41667,0.17635,0,0,0,0,0,1,0,0,0,1
1056,pull-flv-f77-sg01.tiktokcdn.com,legit,4.19582,4,18,31,0,0.22222,0.13535,4,6,9,9,28,2,0,0,0,2
5372,yztdwbswx.com,dga,3.54659,1,11,13,1,0.09091,0.27281,0,0,0,0,0,0,0,0,0,0
5552,lymifo.info,dga,2.91398,4,6,11,1,0.66667,0.26491,1,0,0,0,1,1,0,0,0,1
5274,adohgatd.com,dga,3.08496,4,7,12,1,0.57143,0.25708,2,0,0,0,2,1,0,0,0,1
7726,gqueqaewcegyyymm.org,dga,3.40869,6,13,20,1,0.46154,0.17043,1,0,0,0,1,1,0,0,0,1
8796,daaenbccnbbdcama.com,dga,2.98418,6,13,20,1,0.46154,0.14921,3,1,0,0,4,4,0,0,0,4
5619,xajqygn.org,dga,3.27761,2,8,11,1,0.25,0.29796,0,0,0,0,0,0,0,0,0,0
5482,kafseico.ru,dga,3.45943,5,5,11,1,1.0,0.31449,3,0,0,0,3,3,0,0,0,3
172,demdex.net,legit,2.64644,3,6,10,0,0.5,0.26464,0,0,0,0,0,2,0,0,0,2
2682,static2.sharepointonline.com,legit,3.77094,10,15,28,0,0.66667,0.13468,10,0,0,0,10,10,2,0,0,12
8833,krmdrjkta.com,dga,3.2389,2,10,13,1,0.2,0.24915,1,0,0,0,1,1,0,0,0,1
2091,track.hubspot.com,legit,3.61687,4,11,17,0,0.36364,0.21276,1,0,0,0,1,2,1,0,0,3
7013,kkskstcbjeem.info,dga,3.57247,4,12,17,1,0.33333,0.21015,1,0,0,0,1,2,0,0,0,2
6583,mbhtsgamuaeettbfu.cc,dga,3.48418,6,13,20,1,0.46154,0.17421,1,0,0,0,1,2,0,0,0,2
8162,jcmyisvnleoknjqo.eu,dga,3.82687,6,12,19,1,0.5,0.20141,1,0,0,0,1,2,0,0,0,2
4784,api.drift.com,legit,3.39275,4,7,13,0,0.57143,0.26098,3,1,1,0,5,2,1,0,0,3
6338,djtujkntbeljjfqs.eu,dga,3.51109,4,14,19,1,0.28571,0.18479,1,0,0,0,1,2,0,0,0,2
8611,amountobject.net,dga,3.32782,6,9,16,1,0.66667,0.20799,3,0,0,0,3,2,0,0,0,2
8681,8eka86ce0isu.top,dga,3.75,6,5,16,1,1.2,0.23438,1,0,0,0,1,3,0,0,0,3
2071,geomobileservices-pa.googleapis.com,legit,3.71546,15,17,35,0,0.88235,0.10616,11,8,5,5,29,10,2,1,0,13
9227,scottishdownloaded.net,dga,3.53831,7,14,22,1,0.5,0.16083,5,0,0,0,5,5,0,0,0,5
5631,xoocraovkevo.ddns.net,dga,3.53517,7,12,21,1,0.58333,0.16834,5,1,0,0,6,5,4,3,2,14
8635,kusisueaeiegmeic.org,dga,3.38418,11,8,20,1,1.375,0.16921,3,0,0,0,3,5,0,0,0,5
1915,gpi3.life360.com,legit,3.625,4,6,16,0,0.66667,0.22656,2,0,0,0,2,0,0,0,0,0
5316,evmmhu.am,dga,2.6416,3,5,9,1,0.6,0.29351,0,0,0,0,0,0,0,0,0,0
488,pendo.io,legit,2.75,4,3,8,0,1.33333,0.34375,1,0,0,0,1,2,0,0,0,2
3330,r.turn.com,legit,2.92193,2,6,10,0,0.33333,0.29219,1,0,0,0,1,0,1,0,0,1
4987,securly.com,legit,3.27761,3,7,11,0,0.42857,0.29796,1,0,0,0,1,2,0,0,0,2
5192,64ceclmcpf42oqiqhe.biz,dga,3.87966,5,12,22,1,0.41667,0.17635,1,0,0,0,1,2,0,0,0,2
239,nleditor.osi.office.net,legit,3.43576,9,11,23,0,0.81818,0.14938,5,4,4,3,16,7,0,0,0,7
3757,android.prod.cloud.netflix.com,legit,3.77356,9,17,30,0,0.52941,0.12579,7,7,6,4,24,4,2,0,0,6
9224,fqb38b68gqdzozn40dxiunzoshwlwp32csnw.net,dga,4.53418,5,26,40,1,0.19231,0.11335,0,0,0,0,0,0,1,0,0,1
6491,plzsttn.dyndns.org,dga,3.46132,1,15,18,1,0.06667,0.1923,4,1,0,0,5,5,3,4,3,15
8093,qwqcawaoyo6g.org,dga,3.20282,5,9,16,1,0.55556,0.20018,0,0,0,0,0,1,0,0,0,1
8603,gva0u8ipqbu43de850utshw.ddns.net,dga,4.26532,7,16,32,1,0.4375,0.13329,2,1,0,0,3,5,3,3,2,13
1936,trial-eum-clientnsv4-s.akamaihd.net,legit,3.99287,11,18,35,0,0.61111,0.11408,7,4,4,3,18,5,1,0,0,6
1207,safelinks.protection.outlook.com,legit,3.78064,12,17,32,0,0.70588,0.11814,11,2,1,0,14,6,3,1,1,11
9082,mpnqtgfqbex.com,dga,3.64022,2,12,15,1,0.16667,0.24268,0,0,0,0,0,1,3,2,1,7
7654,lsnhtrzepz.com,dga,3.6645,2,11,14,1,0.18182,0.26175,0,0,0,0,0,0,0,0,0,0
7072,catlvcgew.ir,dga,3.4183,3,8,12,1,0.375,0.28486,2,0,0,0,2,3,0,0,0,3
3783,platform.dbankcloud.ru,legit,3.82307,6,14,22,0,0.42857,0.17378,5,3,2,1,11,5,0,0,0,5
5438,sdwrkn52clmvut5tkb5.ddns.net,dga,3.9138,2,20,28,1,0.1,0.13978,2,1,0,0,3,4,3,2,2,11
2286,match.adsby.bidtheatre.com,legit,3.69026,7,16,26,0,0.4375,0.14193,7,0,0,0,7,4,0,0,0,4
9646,hoxinaje.ru,dga,3.45943,5,5,11,1,1.0,0.31449,1,0,0,0,1,1,0,0,0,1
1613,www.microsoft.com-c-3.edgekey.net,legit,3.94546,8,18,33,0,0.44444,0.11956,10,12,9,6,37,6,2,1,0,9
5209,wgdbgo.biz,dga,2.92193,2,7,10,1,0.28571,0.29219,0,0,0,0,0,0,0,0,0,0
1057,musicstatus.itunes.apple.com,legit,3.58362,10,15,28,0,0.66667,0.12799,12,4,3,2,21,9,0,0,0,9
8810,amaflefbdfkckkfm.com,dga,3.24644,4,15,20,1,0.26667,0.16232,3,1,0,0,4,3,0,0,0,3
7546,dyebm.me,dga,2.5,2,5,8,1,0.4,0.3125,0,0,0,0,0,0,0,0,0,0
3389,collect.igodigital.com,legit,3.32218,8,12,22,0,0.66667,0.15101,3,0,0,0,3,5,1,0,0,6
1034,pull-cmaf-f77-va01.tiktokcdn.com,legit,4.14032,6,17,32,0,0.35294,0.12938,5,6,9,9,29,3,0,0,0,3
8055,jvbcaunyur.com,dga,3.52164,4,9,14,1,0.44444,0.25155,0,0,0,0,0,1,0,0,0,1
7570,chainquarterassumereacthappen.com,dga,3.73775,13,19,33,1,0.68421,0.11327,9,1,0,0,10,11,4,0,0,15
5425,snwpyly6w8aledkxkbu.ddns.net,dga,3.96772,4,20,28,1,0.2,0.1417,4,1,0,0,5,6,3,3,2,14
9252,puryxuv.com,dga,3.27761,3,7,11,1,0.42857,0.29796,0,0,0,0,0,0,0,0,0,0
7634,exnexkxp.yi.org,dga,3.32323,4,9,15,1,0.44444,0.22155,1,0,0,0,1,1,0,0,0,1
4212,rtb-us-west.linkedin.com,legit,4.00163,6,14,24,0,0.42857,0.16673,6,0,0,0,6,4,1,0,0,5
2102,a1390.us.akamai.net,legit,3.57662,7,5,19,0,1.4,0.18824,5,3,4,3,15,2,0,0,0,2
7348,14ym1gpyivq6pup6jl.cn,dga,3.88018,2,13,21,1,0.15385,0.18477,0,0,0,0,0,0,0,0,0,0
8435,pgojydtxofch.net,dga,3.75,3,12,16,1,0.25,0.23438,1,0,0,0,1,0,0,0,0,0
2028,d.aa.online-metrix.net,legit,3.53831,8,10,22,0,0.8,0.16083,5,0,0,0,5,5,1,0,0,6
7000,pdyilvfm.net,dga,3.58496,2,9,12,1,0.22222,0.29875,0,0,0,0,0,0,0,0,0,0
7949,xqbpsyidomlp.ru,dga,3.77356,3,11,15,1,0.27273,0.25157,0,0,0,0,0,1,0,0,0,1
5531,dk6gj66aabs7b8xb3l.biz,dga,3.78875,3,12,22,1,0.25,0.17222,0,0,0,0,0,0,0,0,0,0
6705,vfgpyclsfjrvxnfv.eu,dga,3.74741,2,16,19,1,0.125,0.19723,0,0,0,0,0,0,0,0,0,0
9353,fnfoadcmflembomo.org,dga,3.44644,6,13,20,1,0.46154,0.17232,2,0,0,0,2,3,0,0,0,3
8709,vsnxercpyoovyqot.com,dga,3.62193,5,14,20,1,0.35714,0.1811,2,0,0,0,2,1,0,0,0,1
6667,cymvcgtq.net,dga,3.25163,1,10,12,1,0.1,0.27097,0,0,0,0,0,0,0,0,0,0
2075,p16-sg.tiktokcdn.com,legit,3.82193,3,12,20,0,0.25,0.1911,4,6,7,6,23,2,0,0,0,2
185,api-noam.flightproxy.teams.microsoft.com,legit,4.02507,12,23,40,0,0.52174,0.10063,15,10,7,6,38,5,1,0,0,6
3032,ats-wrapper.privacymanager.io,legit,3.81093,10,16,29,0,0.625,0.13141,8,3,0,3,14,8,0,1,0,9
742,unrulymedia.com,legit,3.64022,6,8,15,0,0.75,0.24268,1,0,0,0,1,1,0,0,0,1
7651,obqopkdsholapet.com,dga,3.72161,6,12,19,1,0.5,0.19587,2,0,0,0,2,2,0,5,5,12
782,choices.trustarc.com,legit,3.42193,6,12,20,0,0.5,0.1711,8,1,0,0,9,6,0,0,0,6
3237,ssp.behave.com,legit,3.37878,4,8,14,0,0.5,0.24134,1,0,0,0,1,2,0,0,0,2
7215,5pwvarel165pg6sn1lk.ddns.net,dga,3.99468,3,17,28,1,0.17647,0.14267,3,1,0,0,4,7,3,2,2,14
9351,christinacharnette.net,dga,3.20899,7,14,22,1,0.5,0.14586,4,0,0,0,4,10,3,1,2,16
9995,gmuamhodwdtu.to,dga,3.24022,5,9,15,1,0.55556,0.21601,1,0,0,0,1,1,0,0,0,1
6682,vpgetilunudjuluy.eu,dga,3.42637,8,10,19,1,0.8,0.18034,2,0,0,0,2,3,0,0,0,3
9469,channellandscaperingtree.com,dga,3.75343,9,18,28,1,0.5,0.13405,5,0,0,0,5,10,5,0,0,15
5691,awgzmva.co.cr,dga,3.2389,3,8,13,1,0.375,0.24915,2,1,0,0,3,1,1,0,0,2
7875,sufferededen.eu,dga,2.73291,7,7,15,1,1.0,0.18219,4,0,0,0,4,6,1,0,0,7
1289,vtrk.doubleverify.com,legit,3.91613,6,13,21,0,0.46154,0.18648,4,0,0,0,4,5,2,0,0,7
9056,y82c2kqoa8yk.top,dga,3.375,3,8,16,1,0.375,0.21094,0,0,0,0,0,0,0,0,0,0
8299,kejuwyx.info,dga,3.58496,4,7,12,1,0.57143,0.29875,0,0,0,0,0,0,0,0,0,0
863,kv601.prod.do.dsp.mp.microsoft.com,legit,3.69381,6,19,34,0,0.31579,0.10864,11,12,10,9,42,3,2,0,0,5
9607,ttnwtktnwufiewebfieah.ac,dga,3.52206,8,15,24,1,0.53333,0.14675,1,0,0,0,1,1,0,0,0,1
5570,nqrogxkngrqhk.biz,dga,3.49923,2,14,17,1,0.14286,0.20584,1,0,0,0,1,0,0,0,0,0
5450,knowdare.net,dga,3.25163,4,7,12,1,0.57143,0.27097,1,0,0,0,1,2,0,0,0,2
3927,securepubads46.g.doubleclick.net,legit,4.05423,10,17,32,0,0.58824,0.12669,9,0,0,0,9,6,0,0,0,6
6703,lygesar.info,dga,3.58496,4,7,12,1,0.57143,0.29875,2,0,0,0,2,3,0,0,0,3
9063,psllh56ob8htxeiig6.cn,dga,4.01137,4,12,21,1,0.33333,0.19102,0,0,0,0,0,0,0,0,0,0
2412,papi.walkme.com,legit,3.37356,5,8,15,0,0.625,0.2249,2,1,1,0,4,0,0,0,0,0
9546,xgnbygnsthmyx.ru,dga,3.5,1,14,16,1,0.07143,0.21875,1,0,0,0,1,2,0,0,0,2
336,ads.linkedin.com,legit,3.5,5,9,16,0,0.55556,0.21875,6,0,0,0,6,2,0,0,0,2
1686,cell.nr-data.net,legit,3.25,4,9,16,0,0.44444,0.20312,3,0,0,0,3,4,0,0,0,4
8793,hegebxtzbkfrovktv.com,dga,3.82089,4,16,21,1,0.25,0.18195,2,0,0,0,2,1,0,0,0,1
14,login.microsoftonline.com,legit,3.47908,9,14,25,0,0.64286,0.13916,10,8,7,6,31,5,1,0,0,6
3782,i18n-pglstatp.com,legit,3.85217,3,10,17,0,0.3,0.2266,3,0,0,0,3,3,0,0,0,3
9207,w25vo2e0101xahm6yvs.ddns.net,dga,4.1645,4,14,28,1,0.28571,0.14873,3,1,0,0,4,4,3,3,2,12
6764,moriturisintercelumquam.com,dga,3.63397,11,15,27,1,0.73333,0.13459,6,0,0,0,6,11,3,1,0,15
157,facebook.net,legit,3.25163,5,6,12,0,0.83333,0.27097,2,0,0,0,2,2,0,0,0,2
4631,grs.dbankcloud.asia,legit,3.68188,6,11,19,0,0.54545,0.19378,4,3,2,1,10,2,0,0,0,2
8185,usrumqqqvztrjqt.biz,dga,3.40582,3,15,19,1,0.2,0.17925,1,0,0,0,1,0,0,0,0,0
1301,aefd.nelreports.net,legit,3.40582,6,11,19,0,0.54545,0.17925,2,0,0,0,2,4,0,0,0,4
3582,rewardsplatform.microsoft.com,legit,3.7285,8,19,29,0,0.42105,0.12857,10,8,7,6,31,7,0,0,0,7
3214,quota.fe.apple-dns.net,legit,3.66353,7,11,22,0,0.63636,0.16652,8,5,3,2,18,4,1,0,0,5
8421,llffabnfbomefbce.co.uk,dga,3.42512,6,14,22,1,0.42857,0.15569,4,1,0,0,5,3,1,0,0,4
7664,lymytex.com,dga,3.0958,2,8,11,1,0.25,0.28144,1,0,0,0,1,1,0,0,0,1
679,ap.lijit.com,legit,3.25163,4,6,12,0,0.66667,0.27097,3,0,0,0,3,1,0,0,0,1
3691,collegeboard.org,legit,3.20282,6,9,16,0,0.66667,0.20018,3,0,0,0,3,4,0,0,0,4
6398,1ran7dstujenqbi.ddns.net,dga,3.72018,5,15,24,1,0.33333,0.15501,6,1,0,0,7,8,4,3,2,17
9079,dacefdfklallaand.com,dga,3.24644,6,13,20,1,0.46154,0.16232,1,0,0,0,1,5,1,0,0,6
7770,fynv6r7v2n62mfqn77.biz,dga,3.66353,1,13,22,1,0.07692,0.16652,0,0,0,0,0,0,0,0,0,0
7607,quisproximusutilessu.com,dga,3.55351,10,13,24,1,0.76923,0.14806,6,1,0,0,7,5,2,0,0,7
8879,kxobwgfuzs.com,dga,3.6645,3,10,14,1,0.3,0.26175,0,0,0,0,0,0,0,0,0,0
8175,leijtigmgrkwsewy.eu,dga,3.68188,6,12,19,1,0.5,0.19378,3,0,0,0,3,3,0,0,0,3
2529,truoptik.com,legit,3.25163,4,7,12,0,0.57143,0.27097,1,1,0,0,2,1,0,0,0,1
1210,api.facebook.com,legit,3.32782,7,7,16,0,1.0,0.20799,4,1,1,0,6,2,0,0,0,2
9055,volopatotej.eu,dga,3.18201,7,6,14,1,1.16667,0.22729,3,0,0,0,3,2,0,0,0,2
2786,ls2-apple.com.akadns.net,legit,3.77206,6,13,24,0,0.46154,0.15717,10,9,9,9,37,5,3,1,0,9
5081,voting-defeat.in,dga,3.5,6,8,16,1,0.75,0.21875,4,0,0,0,4,5,1,0,0,6
5258,montgomeryconstable.net,dga,3.60967,7,15,23,1,0.46667,0.15694,7,1,0,0,8,8,1,0,0,9
1141,telemetry.mozilla.org,legit,3.46328,7,12,21,0,0.58333,0.16492,3,0,0,0,3,6,0,0,0,6
5350,ddakcecfbnbofbke.net,dga,3.34644,5,14,20,1,0.35714,0.16732,2,0,0,0,2,3,0,0,0,3
3871,time-ios.apple.com,legit,3.50326,7,8,18,0,0.875,0.19463,7,4,3,2,16,2,0,0,0,2
8686,ibqfdbykxydvbd.to,dga,3.41042,2,14,17,1,0.14286,0.20061,0,0,0,0,0,0,0,0,0,0
7745,st666jt53du7f7yvcz.ru,dga,3.88018,2,11,21,1,0.18182,0.18477,1,0,0,0,1,1,0,0,0,1
5975,okkoolnuevmi.ddns.net,dga,3.55852,7,12,21,1,0.58333,0.16945,4,1,0,0,5,5,4,3,2,14
3210,b-cdn.net,legit,2.9477,1,6,9,0,0.16667,0.32752,2,1,0,0,3,1,0,0,0,1
3693,autodesk.com,legit,3.4183,5,6,12,0,0.83333,0.28486,1,0,0,0,1,2,0,0,0,2
7588,txlwdgx.info,dga,3.4183,2,9,12,1,0.22222,0.28486,0,0,0,0,0,0,0,0,0,0
2448,servenobid.com,legit,3.52164,5,8,14,0,0.625,0.25155,3,1,1,0,5,4,2,1,0,7
3810,apr-52dd2-0503.edgecastdns.net,legit,3.88173,5,14,30,0,0.35714,0.12939,6,4,1,0,11,9,1,0,0,10
6021,faeloedkecalkbal.website,dga,3.53832,10,13,24,1,0.76923,0.14743,2,0,0,0,2,4,0,0,0,4
4145,prod.us-east-1.forester.a2z.com,legit,3.88905,9,14,31,0,0.64286,0.12545,11,4,2,1,18,8,4,0,0,12
2186,samsungosp.com,legit,3.18201,4,9,14,0,0.44444,0.22729,1,0,0,0,1,2,0,0,0,2
3801,adp.com,legit,2.80735,2,4,7,0,0.5,0.40105,1,0,0,0,1,0,0,0,0,0
4500,tinypass.com,legit,3.4183,3,8,12,0,0.375,0.28486,2,0,0,0,2,3,1,0,0,4
5606,qyopxmtwfsff.net,dga,3.57782,2,13,16,1,0.15385,0.22361,0,0,0,0,0,0,0,0,0,0
4808,vidible.tv,legit,2.92193,3,6,10,0,0.5,0.29219,1,0,0,0,1,1,0,0,0,1
7709,impactfeatureoccasionstand.com,dga,3.72323,12,17,30,1,0.70588,0.12411,6,0,0,0,6,13,3,0,0,16
7240,gfzk.sh,dga,2.80735,0,6,7,1,0.0,0.40105,0,0,0,0,0,0,0,0,0,0
3759,mxpnl.com,legit,2.9477,1,7,9,0,0.14286,0.32752,0,0,0,0,0,0,0,0,0,0
4735,beacons-handoff.gcp.gvt2.com,legit,4.01219,6,17,28,0,0.35294,0.14329,5,2,0,0,7,8,2,0,0,10
1767,ad.gt,legit,2.32193,1,3,5,0,0.33333,0.46439,1,0,0,0,1,0,0,0,0,0
4684,platform-ecst.linkedin.com,legit,4.00813,7,16,26,0,0.4375,0.15416,6,0,0,0,6,7,0,0,0,7
4150,bing.net,legit,2.75,2,5,8,0,0.4,0.34375,1,0,0,0,1,1,1,0,0,2
2062,ags.privatelink.msidentity.com,legit,3.9899,9,18,30,0,0.5,0.133,10,2,0,0,12,10,2,0,0,12
9352,aomkacdooamcelnf.info,dga,3.40399,9,11,21,1,0.81818,0.16209,4,0,0,0,4,5,0,0,0,5
8600,lfcfembfddafakdc.com,dga,3.24644,4,15,20,1,0.26667,0.16232,0,0,0,0,0,2,0,0,0,2
536,m365cdn.nel.measure.office.net,legit,3.89474,9,14,30,0,0.64286,0.12982,9,6,5,3,23,9,0,0,0,9
9414,bifkudtmvimkprkey.cc,dga,3.78418,4,15,20,1,0.26667,0.18921,1,0,0,0,1,0,0,0,0,0
420,oauthaccountmanager.googleapis.com,legit,3.7719,15,17,34,0,0.88235,0.11094,11,7,4,7,29,9,0,0,0,9
1994,trkn.us,legit,2.80735,1,5,7,0,0.2,0.40105,0,0,0,0,0,0,0,0,0,0
2518,dnacdn.net,legit,2.64644,2,7,10,0,0.28571,0.26464,2,1,0,0,3,2,0,0,0,2
5709,qptbgvcgvnjvkqqk.com,dga,3.54644,1,18,20,1,0.05556,0.17732,0,0,0,0,0,0,0,0,0,0
1522,supersonicads.com,legit,3.57247,6,10,17,0,0.6,0.21015,5,0,0,0,5,6,1,0,0,7
6215,gamewakeradioretirecharge.com,dga,3.5611,13,15,29,1,0.86667,0.1228,7,0,0,0,7,10,1,1,0,12
985,pull-flv-l10-sg01.tiktokcdn.com,legit,4.09114,4,18,31,0,0.22222,0.13197,4,6,9,9,28,2,0,0,0,2
2918,e7801.dscd.akamaiedge.net,legit,3.75327,8,10,25,0,0.8,0.15013,9,5,5,3,22,5,0,0,0,5
7123,awxlgomcn.com,dga,3.2389,3,9,13,1,0.33333,0.24915,0,0,0,0,0,1,0,0,0,1
493,aa.agkn.com,legit,2.84535,4,5,11,0,0.8,0.25867,1,0,0,0,1,0,0,0,0,0
8923,edergamsec.com,dga,3.18201,5,8,14,1,0.625,0.22729,4,0,0,0,4,6,0,0,0,6
3746,powerschool.com,legit,3.24022,5,9,15,0,0.55556,0.21601,2,0,0,0,2,1,1,0,0,2
1751,adrta.com,legit,2.9477,3,5,9,0,0.6,0.32752,2,0,0,0,2,1,0,0,0,1
7087,lapffmntpt.net,dga,3.03915,2,11,14,1,0.18182,0.21708,2,0,0,0,2,1,0,0,0,1
3309,market-trk.com,legit,3.23593,3,9,14,0,0.33333,0.23114,1,0,0,0,1,3,0,0,0,3
4071,prime-video.amazon.dev,legit,3.60694,9,10,22,0,0.9,0.16395,5,1,3,3,12,5,0,0,0,5
3756,oauth.reddit.com,legit,3.5,6,8,16,0,0.75,0.21875,2,0,0,0,2,4,0,0,0,4
2779,0.datadog.pool.ntp.org,legit,3.27761,6,11,22,0,0.54545,0.14898,6,0,0,0,6,3,0,0,0,3
3150,tp.47cf2c8c9-frontier.amazon.com,legit,4.07782,7,16,32,0,0.4375,0.12743,9,1,3,3,16,5,0,0,0,5
2533,example.org,legit,3.27761,4,6,11,0,0.66667,0.29796,3,1,0,0,4,2,0,0,0,2
6211,broloitshikkdrrqi.com,dga,3.61781,6,14,21,1,0.42857,0.17228,2,0,0,0,2,1,0,0,0,1
2287,m.youtube.com,legit,3.08506,5,6,13,0,0.83333,0.23731,1,0,0,0,1,1,0,0,0,1
5509,fogonpcwtr.com,dga,3.32486,3,10,14,1,0.3,0.23749,1,0,0,0,1,1,0,0,0,1
7453,gsybpsmvyfndfybi.eu,dga,3.68188,3,15,19,1,0.2,0.19378,0,0,0,0,0,1,0,0,0,1
5464,imiradpom.ddns.net,dga,3.46132,5,11,18,1,0.45455,0.1923,5,2,0,0,7,7,3,2,2,14
1563,northeurope.cloudapp.azure.com,legit,3.71441,12,15,30,0,0.8,0.12381,10,4,3,4,21,2,0,0,0,2
3359,gamepass.com,legit,3.08496,4,7,12,0,0.57143,0.25708,1,0,0,0,1,2,1,0,0,3
3428,smp-device-content.g.aaplimg.com,legit,3.90564,9,18,32,0,0.5,0.12205,11,3,0,0,14,7,2,0,0,9
6776,gotosuxb.ru,dga,3.0958,4,6,11,1,0.66667,0.28144,0,0,0,0,0,1,0,0,0,1
6489,dukoqnuc.ru,dga,3.02717,4,6,11,1,0.66667,0.2752,0,0,0,0,0,0,0,0,0,0
4478,monetate.net,legit,2.62581,5,6,12,0,0.83333,0.21882,4,0,0,0,4,6,2,0,0,8
7952,iappjdxntcvffpkfq.com,dga,3.84423,3,17,21,1,0.17647,0.18306,3,1,0,0,4,0,0,0,0,0
9855,verbumqsicutessequiaest.com,dga,3.61582,11,15,27,1,0.73333,0.13392,6,0,0,0,6,8,3,0,0,11
2106,a507.us.akamai.net,legit,3.46132,7,5,18,0,1.4,0.1923,5,3,4,3,15,2,0,0,0,2
3965,api.edge.bamgrid.com,legit,3.48418,7,10,20,0,0.7,0.17421,6,3,2,0,11,4,0,0,0,4
2899,a1819.z.akamai.net,legit,3.35021,6,5,18,0,1.2,0.18612,3,3,4,3,13,2,0,0,0,2
4850,aaxads.com,legit,2.84644,4,5,10,0,0.8,0.28464,2,0,0,0,2,0,0,0,0,0
3735,hb-api.omnitagjs.com,legit,3.82193,6,11,20,0,0.54545,0.1911,3,1,1,0,5,4,1,0,0,5
1069,scontent.cdninstagram.com,legit,3.54347,6,17,25,0,0.35294,0.14174,13,3,0,0,16,12,2,0,0,14
7019,ahudc2ilgdan72y.ddns.net,dga,3.80351,5,14,24,1,0.35714,0.15848,2,1,0,0,3,5,3,2,2,12
1255,innovid.com,legit,2.91398,4,6,11,0,0.66667,0.26491,1,0,0,0,1,1,0,0,0,1
2462,ocsp.comodoca.com.cdn.cloudflare.net,legit,3.57592,11,20,36,0,0.55,0.09933,8,8,6,3,25,7,2,1,0,10
9192,township-dependence.ki,dga,3.60694,7,13,22,1,0.53846,0.16395,2,0,0,0,2,5,1,1,0,7
276,acdc-direct.office.com,legit,3.38627,7,12,22,0,0.58333,0.15392,5,4,4,3,16,5,0,0,0,5
787,pippio.com,legit,2.44644,4,5,10,0,0.8,0.24464,2,0,0,0,2,0,0,0,0,0
1529,app.adjust.com,legit,3.37878,4,8,14,0,0.5,0.24134,7,1,0,0,8,1,0,0,0,1
7777,o6ce86sqg282.net,dga,3.5,3,6,16,1,0.5,0.21875,1,0,0,0,1,1,0,0,0,1
6810,winterconsultdistricttowel.com,dga,3.64441,9,20,30,1,0.45,0.12148,8,1,0,0,9,12,3,1,0,16
935,tags.tiqcdn.com,legit,3.50689,3,10,15,0,0.3,0.23379,6,2,0,0,8,3,0,0,0,3
302,s.amazon-adsystem.com,legit,3.52257,6,12,21,0,0.5,0.16774,9,1,3,3,16,6,0,0,0,6
9075,curitastructuramquod.com,dga,3.40727,9,14,24,1,0.64286,0.14197,4,1,0,0,5,7,2,0,0,9
3280,sdk.iad-06.braze.com,legit,3.88418,5,9,20,0,0.55556,0.19421,2,0,0,0,2,1,0,0,0,1
1018,pull-flv-f77-tt02.fcdn.us.tiktokv.com,legit,4.06717,5,21,37,0,0.2381,0.10992,6,7,7,4,24,2,0,0,0,2
2047,countvoncount.goguardian.com,legit,3.48166,11,15,28,0,0.73333,0.12435,4,1,0,0,5,4,0,0,0,4
2633,ck-ie.com,legit,2.9477,3,4,9,0,0.75,0.32752,0,0,0,0,0,0,0,0,0,0
686,centralus.cloudapp.azure.com,legit,3.77094,10,15,28,0,0.66667,0.13468,14,5,3,4,26,4,2,0,0,6
8933,ewotdirnafs.com,dga,3.77356,5,9,15,1,0.55556,0.25157,0,0,0,0,0,0,0,0,0,0
8456,dgfoogfhp.com,dga,3.02699,3,9,13,1,0.33333,0.23285,1,1,0,0,2,0,0,0,0,0
437,drive.google.com,legit,3.32782,6,8,16,0,0.75,0.20799,3,5,4,3,15,3,0,0,0,3
4786,mads.amazon.com,legit,3.00624,5,8,15,0,0.625,0.20042,7,1,3,3,14,3,0,0,0,3
5632,kuysaymuaakockge.org,dga,3.44644,8,11,20,1,0.72727,0.17232,1,0,0,0,1,1,0,0,0,1
3060,update.sharethru.com,legit,3.62193,7,11,20,0,0.63636,0.1811,4,0,0,0,4,5,1,0,0,6
3743,agent-cluster1.prod.us001-prod.arcticwolf.net,legit,4.19708,11,24,45,0,0.45833,0.09327,13,6,3,2,24,8,3,0,0,11
4363,aadmsa.trafficmanager.net,legit,3.46347,9,14,25,0,0.64286,0.13854,7,3,1,3,14,6,1,0,0,7
7719,rwxtmjuskencutmrf.tw,dga,3.68418,3,16,20,1,0.1875,0.18421,2,0,0,0,2,1,0,0,0,1
2431,infinitedata-pa.googleapis.com,legit,3.81506,13,14,30,0,0.92857,0.12717,10,6,4,4,24,10,0,0,0,10
8500,oqagigexuvciaca.ddns.net,dga,3.80351,9,13,24,1,0.69231,0.15848,3,1,0,0,4,7,4,3,2,16
1759,detectportal.firefox.com,legit,3.65727,8,14,24,0,0.57143,0.15239,3,0,0,0,3,7,0,0,0,7
8518,kymzg13pzmqk47ozhyb38n30irg23h24jravj36.net,dga,4.58058,4,24,43,1,0.16667,0.10653,1,0,0,0,1,1,0,0,0,1
6022,casinestimabilecasuumloc.com,dga,3.55666,12,15,28,1,0.8,0.12702,7,0,0,0,7,12,2,0,0,14
7961,prvyajfhlq.com,dga,3.80735,2,11,14,1,0.18182,0.27195,1,0,0,0,1,0,0,0,0,0
9954,ftjeoalov.com,dga,3.33468,5,7,13,1,0.71429,0.25651,1,0,0,0,1,0,0,0,0,0
2044,slackb.com,legit,3.12193,2,7,10,0,0.28571,0.31219,0,0,0,0,0,2,0,0,0,2
2444,wikimedia.org,legit,3.33468,6,6,13,0,1.0,0.25651,1,0,0,0,1,1,0,0,0,1
5216,jihpldcbrjon.xyz,dga,3.875,2,13,16,1,0.15385,0.24219,2,0,0,0,2,1,0,0,0,1
8285,mvmygpkiyjqcifu.org,dga,3.82687,4,14,19,1,0.28571,0.20141,0,0,0,0,0,0,0,0,0,0
8291,lcslapgdmtft.eu,dga,3.64022,3,11,15,1,0.27273,0.24268,1,0,0,0,1,1,0,0,0,1
198,osi.office.net,legit,3.09307,6,6,14,0,1.0,0.22093,3,4,4,3,14,3,0,0,0,3
5356,hbhrjgxxhpmbngabd.cc,dga,3.54644,1,18,20,1,0.05556,0.17732,0,0,0,0,0,0,0,0,0,0
4690,lgincdnvzeuno.azureedge.net,legit,3.65823,10,15,27,0,0.66667,0.13549,7,3,1,2,13,5,0,0,0,5
83,prod.do.dsp.mp.microsoft.com,legit,3.25436,6,17,28,0,0.35294,0.11623,11,11,9,8,39,3,2,0,0,5
4453,track.celtra.com,legit,3.20282,4,10,16,0,0.4,0.20018,3,0,0,0,3,4,1,0,0,5
9783,qwyfbrorehlbj.com,dga,3.73452,3,13,17,1,0.23077,0.21968,2,0,0,0,2,2,0,0,0,2
1589,appsflyersdk.com,legit,3.75,3,12,16,0,0.25,0.23438,3,1,0,0,4,1,1,0,0,2
7695,sufficitsolverentur.com,dga,3.74095,8,14,23,1,0.57143,0.16265,5,3,1,0,9,7,4,0,0,11
2783,skimresources.com,legit,3.21953,6,10,17,0,0.6,0.18938,4,0,0,0,4,3,1,0,0,4
5602,whndtnqaadejmw.com,dga,3.61437,4,13,18,1,0.30769,0.2008,1,0,0,0,1,2,0,0,0,2
8683,mtpiomnansnan.cc,dga,3.125,4,11,16,1,0.36364,0.19531,1,0,0,0,1,3,2,4,3,12
4916,prd.ags.akadns.net,legit,3.30827,4,11,18,0,0.36364,0.18379,6,3,4,3,16,2,1,0,0,3
9654,statimdevotam.com,dga,3.29277,6,10,17,1,0.6,0.19369,5,0,0,0,5,6,1,0,0,7
1950,criteo-sync.teads.tv,legit,3.68418,5,12,20,0,0.41667,0.18421,6,0,0,0,6,4,0,0,0,4
3501,tiktokv.com.c.bytefcdn-oversea.com,legit,3.92541,9,20,34,0,0.45,0.11545,9,8,5,3,25,9,5,1,0,15
5596,lathatso.ru,dga,3.0958,4,6,11,1,0.66667,0.28144,1,0,0,0,1,2,0,0,0,2
7034,xigof5hekg5kgij3v5.cn,dga,3.74899,4,12,21,1,0.33333,0.17852,1,0,0,0,1,0,0,0,0,0
1274,platform.hicloud.com,legit,3.68418,6,12,20,0,0.5,0.18421,5,3,2,1,11,4,0,0,0,4
6361,vonycic.com,dga,2.84535,3,7,11,1,0.42857,0.25867,2,0,0,0,2,2,0,0,0,2
2398,oath.com,legit,2.75,3,4,8,0,0.75,0.34375,1,0,0,0,1,1,0,0,0,1
9777,qsuuyljeaejp.sx,dga,3.37356,5,9,15,1,0.55556,0.2249,1,0,0,0,1,2,0,0,0,2
5389,eweuvepbmpeknlauleqwi.kz,dga,3.68456,9,14,24,1,0.64286,0.15352,1,0,0,0,1,3,0,0,0,3
4154,net.edgesuite.net,legit,2.88955,7,8,17,0,0.875,0.16997,4,2,1,0,7,8,0,0,0,8
849,pixel.quantserve.com,legit,3.98418,7,11,20,0,0.63636,0.19921,4,1,1,0,6,5,2,1,0,8
9061,qpkvdxelhrlhkwhl.jp,dga,3.53689,1,17,19,1,0.05882,0.18615,0,0,0,0,0,1,0,0,0,1
8033,outsideprofileclueridediscover.com,dga,3.6794,15,18,34,1,0.83333,0.10822,8,1,0,0,9,10,4,0,0,14
5815,xudikur.info,dga,3.25163,5,6,12,1,0.83333,0.27097,0,0,0,0,0,0,0,0,0,0
2358,mimecast.com,legit,3.02206,4,7,12,0,0.57143,0.25184,2,1,0,0,3,5,0,0,0,5
6309,cwboriacwxl.com,dga,3.32323,4,10,15,1,0.4,0.22155,0,0,0,0,0,3,0,0,0,3
4625,ipcdn.g.aaplimg.com,legit,3.36609,5,11,19,0,0.45455,0.17716,6,2,1,0,9,1,0,0,0,1
4508,bis.vidazoo.com,legit,3.32323,6,7,15,0,0.85714,0.22155,2,0,0,0,2,1,0,0,0,1
8903,6ttw6ukkjd4w84jd53.cn,dga,3.72565,1,12,21,1,0.08333,0.17741,0,0,0,0,0,0,0,0,0,0
6604,jabqwkgl.com,dga,3.58496,2,9,12,1,0.22222,0.29875,0,0,0,0,0,0,0,0,0,0
8712,4uweg28iguo6.net,dga,3.625,6,5,16,1,1.2,0.22656,0,0,0,0,0,0,0,0,0,0
3653,crl.microsoft.com,legit,3.17512,4,11,17,0,0.36364,0.18677,6,8,7,6,27,2,0,0,0,2
7189,sdqwkvthyo.com,dga,3.6645,2,11,14,1,0.18182,0.26175,0,0,0,0,0,0,0,0,0,0
3426,addinsinstallation.store.office.com,legit,3.70716,13,19,35,0,0.68421,0.10592,12,4,4,3,23,14,3,2,1,20
2807,cdn-checkout.joinhoney.com,legit,3.67141,8,15,26,0,0.53333,0.14121,5,1,0,0,6,5,1,0,0,6
1041,deepintent.com,legit,3.18201,5,8,14,0,0.625,0.22729,5,1,0,0,6,4,1,1,0,6
9726,newositearqa.ddns.net,dga,3.46328,7,12,21,1,0.58333,0.16492,4,1,0,0,5,10,4,3,2,19
4825,api.kochava.com,legit,3.1899,6,7,15,0,0.85714,0.21266,2,1,1,0,4,0,1,0,0,1
8020,qidvfqqoggnx.com,dga,3.45282,3,12,16,1,0.25,0.2158,0,0,0,0,0,0,0,0,0,0
7056,fodorwofd.com,dga,2.77736,4,8,13,1,0.5,0.21364,1,0,0,0,1,1,0,0,0,1
9519,c2mtmrc438c4k0u2i2mbgru.ddns.net,dga,4.11673,4,18,32,1,0.22222,0.12865,2,1,0,0,3,4,3,3,2,12
7943,gmg2o2ki4q0y.top,dga,3.625,3,8,16,1,0.375,0.22656,0,0,0,0,0,0,0,0,0,0
711,gs-loc.ls-apple.com.akadns.net,legit,3.76474,7,17,30,0,0.41176,0.12549,11,9,9,9,38,5,3,1,0,9
4513,webcast22-ws-useast1a.tiktokv.com,legit,3.93061,9,17,33,0,0.52941,0.11911,6,6,4,3,19,6,0,0,0,6
8699,ljdyrjyyalhpgqsl.eu,dga,3.64215,3,15,19,1,0.2,0.19169,0,0,0,0,0,0,0,0,0,0
6607,rtcmatdrwg.com,dga,3.23593,2,11,14,1,0.18182,0.23114,2,0,0,0,2,2,0,0,0,2
7711,jspslsbvsmbcdnoxfdz.com,dga,3.74095,2,20,23,1,0.1,0.16265,2,1,0,0,3,1,0,0,0,1
7100,dlychhmu.com,dga,3.08496,2,9,12,1,0.22222,0.25708,0,0,0,0,0,0,0,0,0,0
335,taboola.com,legit,2.84535,5,5,11,0,1.0,0.25867,2,0,0,0,2,2,0,0,0,2
8883,hnshxxp.cx,dga,2.64644,0,9,10,1,0.0,0.26464,0,0,0,0,0,1,0,0,0,1
2369,sync-dmp.mobtrakk.com,legit,3.78494,3,15,21,0,0.2,0.18024,3,0,0,0,3,1,1,0,0,2
9709,tractpast.lv,dga,3.02206,2,9,12,1,0.22222,0.25184,2,1,0,0,3,4,1,0,0,5
8369,mbkxwrc2obyxmxy.ddns.net,dga,3.88684,2,19,24,1,0.10526,0.16195,2,1,0,0,3,4,3,2,2,11
3235,adc3-launch.adcolony.com,legit,3.52206,7,13,24,0,0.53846,0.14675,5,0,0,0,5,3,0,0,0,3
9702,jacquettakingsley.net,dga,3.74899,7,13,21,1,0.53846,0.17852,3,0,0,0,3,5,1,0,0,6
9757,gvqesrsdqqa.cc,dga,3.18201,2,11,14,1,0.18182,0.22729,1,0,0,0,1,1,0,0,0,1
2429,array612.prod.do.dsp.mp.microsoft.com,legit,3.71259,8,20,37,0,0.4,0.10034,12,12,10,9,43,5,2,0,0,7
2011,cdn.quantummetric.com,legit,3.55852,6,13,21,0,0.46154,0.16945,4,2,1,0,7,5,0,0,0,5
8234,k11hitnh7iib4j4qci.com,dga,3.73216,5,11,22,1,0.45455,0.16964,0,0,0,0,0,1,0,0,0,1
817,grammarly.io,legit,3.08496,4,7,12,0,0.57143,0.25708,3,0,0,0,3,4,0,0,0,4
2059,wikipedia.org,legit,3.33468,6,6,13,0,1.0,0.25651,1,0,0,0,1,1,0,0,0,1
2733,matchadsrvr.yieldmo.com,legit,3.79509,6,15,23,0,0.4,0.165,4,0,0,0,4,3,1,0,0,4
8207,southoctober.net,dga,3.28064,6,9,16,1,0.66667,0.20504,2,0,0,0,2,2,0,0,0,2
8001,8qseoqoe06s6.org,dga,3.20282,5,6,16,1,0.83333,0.20018,1,0,0,0,1,1,0,0,0,1
1526,crb.kargo.com,legit,3.08506,3,8,13,0,0.375,0.23731,1,0,0,0,1,1,0,0,0,1
1118,cdn.flashtalking.com,legit,3.82193,4,14,20,0,0.28571,0.1911,4,2,1,0,7,5,1,0,0,6
8638,asvxhs.biz,dga,3.12193,2,7,10,1,0.28571,0.31219,0,0,0,0,0,1,0,0,0,1
8310,groupdare.net,dga,3.39275,5,7,13,1,0.71429,0.26098,3,0,0,0,3,2,0,0,0,2
266,rlcdn.com,legit,2.9477,1,7,9,0,0.14286,0.32752,2,1,0,0,3,1,0,0,0,1
527,phicdn.net,legit,3.12193,2,7,10,0,0.28571,0.31219,3,1,0,0,4,2,0,0,0,2
4269,tracking.crazyegg.com,legit,3.65376,5,14,21,0,0.35714,0.17399,4,0,0,0,4,3,2,0,0,5
7842,pineupefuti.ddns.net,dga,3.24644,7,11,20,1,0.63636,0.16232,5,1,0,0,6,7,5,3,2,17
9665,ykuanbv.mw,dga,3.32193,2,7,10,1,0.28571,0.33219,0,0,0,0,0,1,0,0,0,1
3451,analytics.ff.avast.com,legit,3.51603,6,13,22,0,0.46154,0.15982,5,1,0,0,6,5,0,0,0,5
7183,pozvokso.ru,dga,3.02717,4,6,11,1,0.66667,0.2752,0,0,0,0,0,0,0,0,0,0
4443,achm-main-ha-a-nlb-1d0e22049c746ef1.elb.us-east-2.amazonaws.com,legit,4.37933,16,24,63,0,0.66667,0.06951,8,2,3,3,16,9,0,0,0,9
5844,vocygam.com,dga,2.91398,3,7,11,1,0.42857,0.26491,1,0,0,0,1,1,0,0,0,1
4953,westus3.cloudapp.azure.com,legit,3.87314,9,13,26,0,0.69231,0.14897,11,4,3,4,22,3,1,0,0,4
4449,shavar.prod.mozaws.net,legit,3.75444,6,13,22,0,0.46154,0.17066,4,4,3,2,13,1,1,0,0,2
1707,pull-f5-va01.fcdn.us.tiktokv.com,legit,4.1875,6,17,32,0,0.35294,0.13086,6,7,7,4,24,2,0,0,0,2
8359,ltztjtr.mooo.com,dga,2.95282,4,10,16,1,0.4,0.18455,2,0,0,0,2,0,1,2,1,4
9108,uoyggiyqqieiymwi.org,dga,3.24644,8,11,20,1,0.72727,0.16232,0,0,0,0,0,0,0,0,0,0
1775,getpocket.com,legit,3.08506,4,8,13,0,0.5,0.23731,1,0,0,0,1,2,0,0,0,2
2404,o167200.ingest.sentry.io,legit,3.80351,6,9,24,0,0.66667,0.15848,7,1,0,0,8,6,3,0,0,9
5658,qfooebthxim.com,dga,3.45656,5,9,15,1,0.55556,0.23044,1,0,0,0,1,0,0,0,0,0
5739,djosgivlhmuisbyku.me,dga,3.92193,6,13,20,1,0.46154,0.1961,0,0,0,0,0,1,0,0,0,1
386,outlook.ha.office365.com,legit,3.73644,9,9,24,0,1.0,0.15568,6,4,4,3,17,2,0,0,0,2
6335,mgsmcwiq.info,dga,3.39275,3,9,13,1,0.33333,0.26098,0,0,0,0,0,0,0,0,0,0
6036,ufkkbelotlxo.net,dga,3.375,5,10,16,1,0.5,0.21094,1,0,0,0,1,2,0,0,0,2
671,setup.icloud.com,legit,3.5,6,8,16,0,0.75,0.21875,5,3,2,1,11,3,0,0,0,3
9434,eicttaestsosdv.info,dga,3.43162,7,11,19,1,0.63636,0.18061,4,0,0,0,4,4,1,0,0,5
5814,unafsuhnatd.com,dga,3.50689,5,9,15,1,0.55556,0.23379,1,0,0,0,1,2,0,0,0,2
3923,weighted.com.akadns.net,legit,3.76227,7,13,23,0,0.53846,0.16358,8,6,7,7,28,6,3,1,0,10
6975,suo6gykesaw2.top,dga,3.75,5,8,16,1,0.625,0.23438,1,0,0,0,1,2,0,0,0,2
8316,yofrmddmfiij.com,dga,3.20282,4,11,16,1,0.36364,0.20018,1,0,0,0,1,1,0,0,0,1
8636,gn54ade6mhm4eni.ddns.net,dga,3.60539,5,13,24,1,0.38462,0.15022,4,1,0,0,5,7,4,3,2,16
9040,bajeosei.ru,dga,3.27761,6,4,11,1,1.5,0.29796,1,0,0,0,1,1,0,0,0,1
2709,enterprise-eudb.activity.windows.com,legit,4.07243,12,20,36,0,0.6,0.11312,9,1,0,0,10,11,3,0,0,14
8955,fmukq.com.tt,dga,3.08496,2,8,12,1,0.25,0.25708,2,2,1,0,5,2,2,1,0,5
4428,api.hubspot.com,legit,3.50689,5,8,15,0,0.625,0.23379,2,1,1,0,4,0,0,0,0,0
2441,redd.it,legit,2.52164,2,4,7,0,0.5,0.36023,2,0,0,0,2,3,0,0,0,3
7735,kililrux.ru,dga,2.73216,4,6,11,1,0.66667,0.24838,1,0,0,0,1,0,0,0,0,0
7967,ceqoulnopa.ddns.net,dga,3.57662,6,11,19,1,0.54545,0.18824,4,1,0,0,5,5,4,3,2,14
5518,conditionexchangeblockhold.com,dga,3.76141,10,19,30,1,0.52632,0.12538,5,1,0,0,6,8,5,1,0,14
7517,qswmdrwrncneerh.com,dga,3.47135,3,15,19,1,0.2,0.1827,1,0,0,0,1,2,0,0,0,2
2392,array614.prod.do.dsp.mp.microsoft.com,legit,3.71259,8,20,37,0,0.4,0.10034,12,12,10,9,43,5,2,0,0,7
1160,azurefd.net,legit,3.27761,4,6,11,0,0.66667,0.29796,1,0,0,1,2,1,0,0,0,1
6959,bqyvfz.to,dga,3.16993,1,7,9,1,0.14286,0.35221,0,0,0,0,0,0,0,0,0,0
3469,s1.symcb.com,legit,2.9183,1,8,12,0,0.125,0.24319,0,0,0,0,0,0,0,0,0,0
2170,c-msedge.net,legit,3.18872,3,7,12,0,0.42857,0.26573,3,2,1,0,6,3,0,0,0,3
675,w55c.net,legit,2.75,1,4,8,0,0.25,0.34375,0,0,0,0,0,0,0,0,0,0
144,googleadservices.com,legit,3.54644,8,11,20,0,0.72727,0.17732,10,6,4,4,24,7,2,1,0,10
5927,ljjenmqw.com,dga,3.25163,2,9,12,1,0.22222,0.27097,1,0,0,0,1,1,0,0,0,1
5367,86oy8e42s24m.top,dga,3.5,3,5,16,1,0.6,0.21875,0,0,0,0,0,0,0,0,0,0
2536,teams.live.com,legit,3.37878,5,7,14,0,0.71429,0.24134,5,0,0,0,5,4,0,0,0,4
301,gsp85-ssl.ls.apple.com,legit,3.4474,3,13,22,0,0.23077,0.1567,6,4,3,2,15,1,0,0,0,1
1174,dns.google,legit,2.92193,3,6,10,0,0.5,0.29219,1,1,0,0,2,2,1,0,0,3
7036,e82gu8ycucus.net,dga,3.32782,5,7,16,1,0.71429,0.20799,1,0,0,0,1,0,0,0,0,0
3794,d2s7q6s2.hwcdn.net,legit,3.61437,1,11,18,0,0.09091,0.2008,2,1,0,0,3,1,0,0,0,1
704,mask-api.icloud.com,legit,3.61635,7,9,19,0,0.77778,0.19033,6,4,3,1,14,3,0,0,0,3
9381,sucking-portable.cn,dga,4.0374,5,12,19,1,0.41667,0.21249,3,0,0,0,3,5,1,0,0,6
7737,aohqujoobisewksw.eu,dga,3.57662,9,9,19,1,1.0,0.18824,2,0,0,0,2,2,0,0,0,2
6340,flierstream.net,dga,3.32323,5,9,15,1,0.55556,0.22155,6,0,0,0,6,5,1,0,0,6
9594,tusohgetla.com,dga,3.52164,5,8,14,1,0.625,0.25155,2,0,0,0,2,3,0,0,0,3
3232,content.dellsupportcenter.com,legit,3.53851,8,19,29,0,0.42105,0.12202,9,2,0,0,11,11,3,0,0,14
5538,crctratcrkwf.ru,dga,2.92323,2,12,15,1,0.16667,0.19488,3,0,0,0,3,2,1,0,0,3
8523,fobiqab.su,dga,3.12193,4,5,10,1,0.8,0.31219,0,0,0,0,0,0,0,0,0,0
2853,fa000000006.resources.office.net,legit,3.45282,9,11,32,0,0.81818,0.1079,7,4,4,3,18,4,1,0,0,5
2562,a.slack-edge.com,legit,3.5,5,8,16,0,0.625,0.21875,2,2,1,0,5,4,0,0,0,4
4986,brightcloud.com,legit,3.64022,4,10,15,0,0.4,0.24268,2,3,2,1,8,1,0,0,0,1
1886,gcc.teams.microsoft.com,legit,3.38162,6,14,23,0,0.42857,0.14703,11,8,7,6,32,5,0,0,0,5
9703,smith-partnerships.ac,dga,3.59447,5,14,21,1,0.35714,0.17117,2,0,0,0,2,5,1,0,0,6
9323,ecclesiispotredimsuntp.com,dga,3.66123,9,16,26,1,0.5625,0.14082,5,0,0,0,5,8,0,0,0,8
1619,eu-west-1.amazonaws.com,legit,3.70813,8,10,23,0,0.8,0.16122,6,1,3,3,13,5,1,0,0,6
6928,averagestringcakeborderavoid.com,dga,3.78891,13,18,32,1,0.72222,0.1184,6,1,0,0,7,11,4,0,0,15
2024,shftr.adnxs.net,legit,3.37356,2,11,15,0,0.18182,0.2249,3,0,0,0,3,1,0,0,0,1
8682,ykjwhfw.me,dga,3.12193,1,8,10,1,0.125,0.31219,0,0,0,0,0,0,0,0,0,0
8926,2v5xcs8qbzxoikvmd7.biz,dga,4.00489,3,14,22,1,0.21429,0.18204,0,0,0,0,0,0,0,0,0,0
5970,gmurkvc.co.vi,dga,3.2389,3,8,13,1,0.375,0.24915,2,1,0,0,3,1,1,0,0,2
7902,bldxdgezuslydzzpkido.com,dga,3.88684,5,18,24,1,0.27778,0.16195,2,1,0,0,3,1,0,0,0,1
9830,u0e4iwm4agyc.net,dga,3.75,5,7,16,1,0.71429,0.23438,0,0,0,0,0,0,0,0,0,0
6840,fskwrhdiv.gd,dga,3.4183,1,10,12,1,0.1,0.28486,0,0,0,0,0,0,0,0,0,0
5547,drnvprwurdmktcuh.eu,dga,3.64215,4,14,19,1,0.28571,0.19169,1,0,0,0,1,0,0,0,0,0
795,mobile.pipe.aria.microsoft.com,legit,3.61506,12,14,30,0,0.85714,0.1205,10,8,7,6,31,5,0,0,0,5
5558,ezbeqjvfq.com,dga,3.39275,3,9,13,1,0.33333,0.26098,0,0,0,0,0,1,0,0,0,1
6675,thenfine.net,dga,2.62581,4,7,12,1,0.57143,0.21882,2,0,0,0,2,3,1,0,0,4
6534,iqemsswoucowiqqq.org,dga,3.38418,7,12,20,1,0.58333,0.16921,2,0,0,0,2,2,0,0,0,2
6115,yuwoqdafcwlpgqtgy.tw,dga,3.68418,3,16,20,1,0.1875,0.18421,0,0,0,0,0,0,0,0,0,0
6419,puvydap.com,dga,3.27761,3,7,11,1,0.42857,0.29796,1,0,0,0,1,0,0,0,0,0
6535,thatinvestigate.jp,dga,3.39215,6,11,18,1,0.54545,0.18845,6,0,0,0,6,7,3,0,0,10
9882,ijgtbgvnyvqtlk.pw,dga,3.73452,1,15,17,1,0.06667,0.21968,0,0,0,0,0,0,0,0,0,0
8778,gwxq.com.bs,dga,3.27761,1,8,11,1,0.125,0.29796,2,2,1,0,5,2,2,1,0,5
5076,u6s676w8gpm8cng.ddns.net,dga,3.77206,2,14,24,1,0.14286,0.15717,2,1,0,0,3,4,3,3,2,12
7226,a57cwgqgqbwe51n20avbteudyc59etnugzkv.com,dga,4.44644,8,23,40,1,0.34783,0.11116,1,0,0,0,1,2,0,0,0,2
5278,gdrasjv.dyndns.org,dga,3.35021,2,14,18,1,0.14286,0.18612,3,1,0,0,4,6,3,4,3,16
8075,hrx7alci417cssedfx.com,dga,3.97057,4,13,22,1,0.30769,0.18048,2,0,0,0,2,2,0,0,0,2
2371,xboxlive.com,legit,3.25163,4,7,12,0,0.57143,0.27097,1,0,0,0,1,1,0,0,0,1
1709,syncservice.protection.outlook.com,legit,3.74116,12,19,34,0,0.63158,0.11003,13,4,2,1,20,8,5,2,1,16
9790,ehrpxvdtvdtqp.com,dga,3.61687,2,14,17,1,0.14286,0.21276,0,0,0,0,0,0,0,0,0,0
6413,evhviumtpyqv.org,dga,3.70282,4,11,16,1,0.36364,0.23143,0,0,0,0,0,0,0,0,0,0
355,newrelic.com,legit,3.25163,4,7,12,0,0.57143,0.27097,3,0,0,0,3,4,0,0,0,4
4280,bam.nr-data.net.cdn.cloudflare.net,legit,3.6794,9,19,34,0,0.47368,0.10822,9,5,4,2,20,9,0,0,0,9
678,image8.pubmatic.com,legit,3.57662,7,9,19,0,0.77778,0.18824,5,1,0,0,6,5,1,0,0,6
8549,ukwgcfdsfd.com,dga,3.37878,2,11,14,1,0.18182,0.24134,1,0,0,0,1,0,0,0,0,0
9081,susuntargutisopus.com,dga,3.43994,8,12,21,1,0.66667,0.16381,4,0,0,0,4,5,0,0,0,5
8929,mgtyhyeoya.info,dga,3.45656,5,9,15,1,0.55556,0.23044,0,0,0,0,0,0,0,1,0,1
1277,qualys.com,legit,3.32193,3,6,10,0,0.5,0.33219,0,0,0,0,0,0,0,0,0,0
5863,32yfulepqp18ifq.ddns.net,dga,4.00163,4,14,24,1,0.28571,0.16673,3,1,0,0,4,5,3,3,2,13
1644,stun.l.google.com,legit,3.29277,5,9,17,0,0.55556,0.19369,3,5,4,3,15,2,0,0,0,2
6841,eouomoq4ysu0.net,dga,3.45282,7,6,16,1,1.16667,0.2158,1,0,0,0,1,2,0,0,0,2
3368,connectivitycheck.cbg-app.huawei.com,legit,4.00952,11,21,36,0,0.52381,0.11138,7,2,0,0,9,6,1,0,0,7
6900,wbtahddcsldefiobo.com,dga,3.74899,6,14,21,1,0.42857,0.17852,1,0,0,0,1,3,0,0,0,3
5965,hawoquw.info,dga,3.25163,5,6,12,1,0.83333,0.27097,0,0,0,0,0,0,0,0,0,0
7981,pspqyyuy8nqjkkm7fj.ru,dga,3.6897,2,16,21,1,0.125,0.1757,0,0,0,0,0,0,0,0,0,0
1012,pull-o5-gcp01.tiktokcdn.com,legit,3.95823,5,15,27,0,0.33333,0.1466,4,6,9,9,28,2,0,0,0,2
8258,ajxsforulrjeoiyw.eu,dga,3.72161,8,10,19,1,0.8,0.19587,0,0,0,0,0,1,0,0,0,1
8273,lfirvgtlhjppqt.com,dga,3.83659,2,15,18,1,0.13333,0.21314,1,0,0,0,1,0,0,0,0,0
1852,vae-bid.adsrvr.org,legit,3.46132,5,10,18,0,0.5,0.1923,4,0,0,0,4,0,0,0,0,0
9424,qdniodse.tv,dga,3.27761,3,7,11,1,0.42857,0.29796,3,0,0,0,3,3,0,0,0,3
2858,nexus.ensighten.com,legit,3.53689,6,11,19,0,0.54545,0.18615,4,0,0,0,4,5,0,0,0,5
3692,33across-match.dotomi.com,legit,3.54347,7,13,25,0,0.53846,0.14174,6,2,1,0,9,6,0,0,0,6
2225,nexusrules.live.com.akadns.net,legit,3.85656,10,16,30,0,0.625,0.12855,11,6,7,8,32,8,3,1,0,12
1532,vortex-win.data.microsoft.com,legit,3.90937,9,16,29,0,0.5625,0.13481,11,8,7,6,32,8,0,0,0,8
7702,uetwwwrdpype.com,dga,3.45282,4,11,16,1,0.36364,0.2158,0,0,0,0,0,1,0,0,0,1
6394,scrigrzwmkq.yi.org,dga,3.57243,3,13,18,1,0.23077,0.19847,1,0,0,0,1,1,0,0,0,1
7729,yhytsnkpk4shule.ddns.net,dga,3.60539,3,18,24,1,0.16667,0.15022,4,1,0,0,5,5,4,3,2,14
7511,kxmatbirkghehetma.su,dga,3.72193,6,13,20,1,0.46154,0.1861,2,0,0,0,2,3,0,0,0,3
6415,cuekomavuitcda.com,dga,3.46132,8,9,18,1,0.88889,0.1923,2,0,0,0,2,3,0,0,0,3
5056,secretscopying.com,dga,3.57243,5,12,18,1,0.41667,0.19847,5,0,0,0,5,6,1,0,0,7
1102,search.namequery.com,legit,3.58418,7,11,20,0,0.63636,0.17921,4,0,0,0,4,5,0,0,0,5
7641,citikok.info,dga,2.85539,5,6,12,1,0.83333,0.23795,1,1,0,0,2,2,0,0,0,2
3193,sdk.iad-03.braze.com,legit,3.88418,5,9,20,0,0.55556,0.19421,2,0,0,0,2,1,0,0,0,1
988,pull-f5-sg01.ttlivecdn.com,legit,4.20987,4,15,26,0,0.26667,0.16192,4,1,2,1,8,3,0,0,0,3
167,ng.msg.teams.microsoft.com,legit,3.48853,6,16,26,0,0.375,0.13417,11,8,7,6,32,5,0,0,0,5
6926,responded-plug.ac,dga,3.73452,5,10,17,1,0.5,0.21968,5,0,0,0,5,6,1,0,0,7
4975,pico.eset.com,legit,3.08506,5,6,13,0,0.83333,0.23731,5,0,0,0,5,5,0,0,0,5
2688,onedscolprdwus06.westus.cloudapp.azure.com,legit,3.98709,13,23,42,0,0.56522,0.09493,17,4,3,4,28,7,2,0,0,9
8532,medicinediewheeldoubtstudy.com,dga,3.76141,12,17,30,1,0.70588,0.12538,5,0,0,0,5,6,1,0,0,7
3450,pull-flv-l11-sg01.tiktokcdn.com,legit,4.06678,4,18,31,0,0.22222,0.13119,4,6,9,9,28,2,0,0,0,2
9908,mupxeicu.ru,dga,3.02717,5,5,11,1,1.0,0.2752,1,0,0,0,1,1,0,0,0,1
1980,gateway-asset.icloud-content.com,legit,3.90564,11,17,32,0,0.64706,0.12205,10,5,2,1,18,9,4,0,0,13
2227,25-courier.push.apple.com,legit,3.86347,8,11,25,0,0.72727,0.15454,9,4,3,2,18,4,0,0,0,4
1417,prod.cloudops.mozgcp.net,legit,3.68872,6,15,24,0,0.4,0.1537,8,6,5,3,22,0,1,0,0,1
8980,e8y4yk64ise4.org,dga,3.45282,4,6,16,1,0.66667,0.2158,1,0,0,0,1,2,0,0,0,2
1724,tvpixel.com,legit,3.45943,3,7,11,0,0.42857,0.31449,1,0,0,0,1,1,0,0,0,1
3468,open.spotify.com,legit,3.45282,5,9,16,0,0.55556,0.2158,2,0,0,0,2,2,0,0,0,2
5256,hawutlarw.com,dga,3.39275,4,8,13,1,0.5,0.26098,0,0,0,0,0,2,0,0,0,2
3781,southcentralus1-0.pushnp.svc.ms,legit,3.95034,6,19,31,0,0.31579,0.12743,7,1,0,0,8,3,2,0,0,5
8736,obywahdvadxspppy.eu,dga,3.68188,5,13,19,1,0.38462,0.19378,2,0,0,0,2,0,0,0,0,0
4418,googlemail.l.google.com,legit,2.9425,9,11,23,0,0.81818,0.12793,3,5,4,3,15,3,0,0,0,3
9628,qjrmjdhlpubis.com,dga,3.85217,3,13,17,1,0.23077,0.2266,0,0,0,0,0,1,0,0,0,1
1437,pushnp.svc.ms,legit,3.02699,1,10,13,0,0.1,0.23285,2,0,0,0,2,0,0,0,0,0
4008,alibaba.com,legit,2.84535,5,5,11,0,1.0,0.25867,1,0,0,0,1,0,0,0,0,0
5360,igfhdijelqjx.ru,dga,3.64022,4,10,15,1,0.4,0.24268,0,0,0,0,0,1,0,0,0,1
6308,lorehogu.ru,dga,2.91398,5,5,11,1,1.0,0.26491,2,0,0,0,2,2,0,0,0,2
1392,webcast16-normal-useast5.us.tiktokv.com,legit,4.20169,11,20,39,0,0.55,0.10774,8,6,4,3,21,8,0,0,0,8
9283,dxpah.com.gl,dga,3.4183,2,8,12,1,0.25,0.28486,2,2,1,0,5,2,2,1,0,5
9033,ejvb.co.ug,dga,3.12193,3,5,10,1,0.6,0.31219,2,1,0,0,3,1,1,0,0,2
8146,apcja4odmfgry4q4k2u0mte.ddns.net,dga,4.32782,6,19,32,1,0.31579,0.13524,5,1,0,0,6,5,4,3,2,14
7298,mrxttyxhmbgqlbrwgeil.com,dga,3.88684,3,20,24,1,0.15,0.16195,1,0,0,0,1,1,0,0,0,1
7282,bpzsqyubyv.com,dga,3.52164,2,11,14,1,0.18182,0.25155,0,0,0,0,0,0,0,0,0,0
3611,ck.inmobi.com,legit,2.93121,4,7,13,0,0.57143,0.22548,1,0,0,0,1,1,0,0,0,1
7880,chancebearchargetowervacation.com,dga,3.62836,13,19,33,1,0.68421,0.10995,7,0,0,0,7,13,6,4,1,24
8308,folekncoobfamfdc.com,dga,3.34644,6,13,20,1,0.46154,0.16732,4,0,0,0,4,3,0,0,0,3
6528,strangerbottlesentencepersuade.com,dga,3.67816,12,21,34,1,0.57143,0.10818,12,1,0,0,13,13,4,1,0,18
9853,xutanoj.info,dga,3.25163,5,6,12,1,0.83333,0.27097,1,0,0,0,1,2,0,0,0,2
8680,ahoiewlagn.com,dga,3.52164,6,7,14,1,0.85714,0.25155,0,0,0,0,0,1,0,0,0,1
3586,video.xx.fbcdn.net,legit,3.46132,4,11,18,0,0.36364,0.1923,2,1,0,0,3,2,0,0,0,2
9645,agnocelditu.com,dga,3.64022,6,8,15,1,0.75,0.24268,1,0,0,0,1,3,0,0,0,3
9533,pupeg.eu,dga,2.25,4,3,8,1,1.33333,0.28125,0,0,0,0,0,0,0,0,0,0
7454,visited-potato.ps,dga,3.33718,6,9,17,1,0.66667,0.1963,4,0,0,0,4,7,0,0,0,7
1991,p16-amd-va.tiktokcdn.com,legit,3.83496,5,13,24,0,0.38462,0.15979,5,6,7,6,24,3,0,0,0,3
7886,voqesovixainwat.ddns.net,dga,3.63684,8,14,24,1,0.57143,0.15154,5,1,0,0,6,7,3,2,1,13
7305,i2ghlgs7uv5beocpi3.ru,dga,4.1066,6,10,21,1,0.6,0.19555,1,0,0,0,1,1,0,0,0,1
1817,fc.yahoo.com,legit,2.85539,4,6,12,0,0.66667,0.23795,1,0,0,1,2,0,0,0,0,0
5717,campanasulit.com,dga,3.45282,6,9,16,1,0.66667,0.2158,2,0,0,0,2,6,0,0,0,6
5371,te3chaf8dezg.org,dga,3.75,4,9,16,1,0.44444,0.23438,1,0,0,0,1,2,1,0,0,3
260,yt3.ggpht.com,legit,3.2389,1,9,13,0,0.11111,0.24915,0,0,0,0,0,0,0,0,0,0
4887,klarnaservices.com,legit,3.61437,6,11,18,0,0.54545,0.2008,5,2,1,1,9,8,2,1,0,11
8225,waveinvitequotelipwaterdisappointed.com,dga,3.91402,17,21,39,1,0.80952,0.10036,9,1,0,0,10,9,2,1,0,12
9065,hacyqaz.net,dga,3.27761,3,7,11,1,0.42857,0.29796,0,0,0,0,0,1,0,0,0,1
4488,cat.da.us.criteo.com,legit,3.38418,7,9,20,0,0.77778,0.16921,7,0,0,0,7,6,0,0,0,6
326,cdn-apple.com,legit,3.39275,3,8,13,0,0.375,0.26098,6,4,2,1,13,2,0,0,0,2
9149,sportsdoctor.eu,dga,3.1899,5,9,15,1,0.55556,0.21266,0,0,0,0,0,1,0,0,0,1
5706,oebcaekbamlbeaac.cc,dga,2.90531,8,10,19,1,0.8,0.15291,2,0,0,0,2,5,0,0,0,5
9894,6gycm8yge4qk.top,dga,3.75,2,10,16,1,0.2,0.23438,1,0,0,0,1,1,0,0,0,1
9329,wncukolqi.dynserv.com,dga,4.01137,5,14,21,1,0.35714,0.19102,3,1,1,0,5,4,6,5,4,19
9900,mdmpaqmirhbkecxakr.net,dga,3.87966,5,16,22,1,0.3125,0.17635,1,0,0,0,1,2,0,0,0,2
9338,fedacwumdeh.com,dga,3.37356,5,9,15,1,0.55556,0.2249,1,0,0,0,1,3,0,0,0,3
3227,swdist.apple.com,legit,3.625,4,10,16,0,0.4,0.22656,6,4,3,2,15,3,1,0,0,4
5612,jsluyr.tv,dga,3.16993,1,7,9,1,0.14286,0.35221,0,0,0,0,0,0,0,0,0,0
4381,ml.cdn-apple.com,legit,3.375,3,10,16,0,0.3,0.21094,7,4,2,1,14,2,0,0,0,2
2846,id.crwdcntrl.net,legit,3.25,2,12,16,0,0.16667,0.20312,4,0,0,0,4,0,0,0,0,0
945,com.trafficmanager.net,legit,3.51603,7,13,22,0,0.53846,0.15982,7,5,2,3,17,8,2,0,0,10
1256,api16-normal-useast5.us.tiktokv.com,legit,4.1643,11,16,35,0,0.6875,0.11898,10,7,4,3,24,7,0,0,0,7
1647,beacon-iad2.rubiconproject.com,legit,3.90689,11,15,30,0,0.73333,0.13023,7,2,0,0,9,7,2,0,0,9
4549,latency.discord.media,legit,3.6897,7,12,21,0,0.58333,0.1757,5,0,0,0,5,8,1,0,0,9
7407,ydskogmnivjqmkhqf.pw,dga,4.02193,2,17,20,1,0.11765,0.2011,1,0,0,0,1,1,0,0,0,1
5753,wifedanger.org,dga,3.37878,5,8,14,1,0.625,0.24134,3,0,0,0,3,4,0,0,0,4
1242,cm.adform.net,legit,3.39275,3,8,13,0,0.375,0.26098,2,0,0,0,2,1,0,0,0,1
1641,ak.prd.aadg.trafficmanager.net,legit,3.56474,9,17,30,0,0.52941,0.11882,10,4,1,3,18,6,1,0,0,7
5987,qhihrsppvtt1cdp68l.ru,dga,3.88018,2,15,21,1,0.13333,0.18477,2,0,0,0,2,0,0,0,0,0
9730,taxationpenn.id,dga,3.1899,6,8,15,1,0.75,0.21266,5,0,0,0,5,5,3,2,1,11
5022,until-infant.ps,dga,3.32323,4,9,15,1,0.44444,0.22155,3,0,0,0,3,3,0,0,0,3
2173,csw.lenovo.com,legit,3.18201,4,8,14,0,0.5,0.22729,2,0,0,0,2,2,0,0,0,2
5103,wyycyagqjfegxukfu.su,dga,3.64644,5,14,20,1,0.35714,0.18232,0,0,0,0,0,0,0,0,0,0
3236,behave.com,legit,3.12193,4,5,10,0,0.8,0.31219,0,0,0,0,0,2,0,0,0,2
9285,lttyxrvdhtggdyuct.cc,dga,3.38418,1,18,20,1,0.05556,0.16921,0,0,0,0,0,0,0,0,0,0
7951,isorgemsa.com,dga,3.2389,5,7,13,1,0.71429,0.24915,1,0,0,0,1,4,0,0,0,4
3839,crl.apple.com,legit,3.08506,3,8,13,0,0.375,0.23731,6,4,3,2,15,1,0,0,0,1
1820,secure.gravatar.com,legit,3.43162,7,10,19,0,0.7,0.18061,6,0,0,0,6,7,0,0,0,7
7046,unixplaylist.net,dga,3.5,5,10,16,1,0.5,0.21875,3,0,0,0,3,4,1,0,0,5
927,sync.go.sonobi.com,legit,3.12799,5,10,18,0,0.5,0.17378,1,1,0,0,2,1,0,0,0,1
9137,vcxkrwxlbgdtvihy.com,dga,4.02193,2,17,20,1,0.11765,0.2011,0,0,0,0,0,0,0,0,0,0
5009,rycoquqawyw.eu,dga,3.23593,5,8,14,1,0.625,0.23114,1,0,0,0,1,1,0,0,0,1
889,loopme.me,legit,2.50326,4,4,9,0,1.0,0.27814,2,0,0,0,2,0,0,0,0,0
9254,gldujjospeby.ru,dga,3.64022,4,10,15,1,0.4,0.24268,0,0,0,0,0,0,0,0,0,0
1071,3gppnetwork.org,legit,3.37356,3,10,15,0,0.3,0.2249,1,0,0,0,1,3,0,0,0,3
4933,r.salesforceliveagent.com,legit,3.76386,9,14,25,0,0.64286,0.15055,8,2,0,0,10,9,1,0,0,10
3349,zoho.com,legit,2.40564,3,4,8,0,0.75,0.3007,0,0,0,0,0,0,0,0,0,0
8080,mebdszodtmqfbdaj1w.com,dga,3.84535,4,16,22,1,0.25,0.17479,1,0,0,0,1,0,0,0,0,0
1169,sync.intentiq.com,legit,3.33718,4,11,17,0,0.36364,0.1963,5,1,0,0,6,4,1,1,0,6
2523,combine.urbanairship.com,legit,3.72018,9,13,24,0,0.69231,0.15501,3,1,0,0,4,5,2,0,0,7
9719,wtehkxchchao.co.uk,dga,3.30827,5,11,18,1,0.45455,0.18379,3,1,0,0,4,2,2,0,0,4
4165,yotpo.com,legit,2.6416,3,5,9,0,0.6,0.29351,0,0,0,0,0,0,0,0,0,0
491,t.co,legit,2.0,1,2,4,0,0.5,0.5,0,0,0,0,0,0,0,0,0,0
5449,kakagufa.ru,dga,2.66353,5,5,11,1,1.0,0.24214,0,1,0,0,1,0,0,0,0,0
1786,rs.fullstory.com,legit,3.375,3,11,16,0,0.27273,0.21094,2,0,0,0,2,2,0,0,0,2
3023,skyapi.live.net,legit,3.50689,5,8,15,0,0.625,0.23379,3,1,1,0,5,1,0,0,0,1
6202,omyycscbmccl.com,dga,2.72722,2,13,16,1,0.15385,0.17045,0,0,0,0,0,1,0,0,0,1
3531,trk.clinch.co,legit,3.18083,2,9,13,0,0.22222,0.24468,3,0,0,0,3,1,0,0,0,1
2037,iphonesubmissions.apple.com,legit,3.63397,10,15,27,0,0.66667,0.13459,9,4,3,2,18,9,2,0,0,11
3543,hb.undertone.com,legit,3.5,5,9,16,0,0.55556,0.21875,2,0,0,0,2,5,1,0,0,6
7698,glkosalovz.com,dga,3.32486,4,9,14,1,0.44444,0.23749,1,0,0,0,1,0,0,0,0,0
4114,r4.res.office365.com.edgekey.net,legit,3.90252,9,14,32,0,0.64286,0.12195,10,9,7,4,30,8,3,1,0,12
3395,pull-flv-l16-tt01.tiktokcdn-us.com.atomile.com,legit,4.11641,10,24,46,0,0.41667,0.08949,12,9,12,11,44,7,2,1,0,10
2742,logs.datadoghq.com,legit,3.46132,5,11,18,0,0.45455,0.1923,6,0,0,0,6,3,0,0,0,3
764,prod.us-east-1.cxm-bcn.publisher-services.amazon.dev,legit,4.25633,14,28,52,0,0.5,0.08185,18,7,6,5,36,12,4,1,0,17
8151,xtfunilmytab.ir,dga,3.64022,4,10,15,1,0.4,0.24268,1,0,0,0,1,2,0,0,0,2
7276,qrwdox.net,dga,3.32193,2,7,10,1,0.28571,0.33219,0,0,0,0,0,0,0,0,0,0
7843,husbandobject.net,dga,3.61687,5,11,17,1,0.45455,0.21276,1,0,0,0,1,3,1,0,0,4
1288,api.twitter.com,legit,3.32323,5,8,15,0,0.625,0.22155,5,1,1,0,7,3,1,0,0,4
6532,snynsjgxwdo0grg.ddns.net,dga,3.57393,2,19,24,1,0.10526,0.14891,2,1,0,0,3,4,3,3,2,12
4151,match.justpremium.com,legit,3.63041,6,13,21,0,0.46154,0.17288,7,0,0,0,7,6,0,0,0,6
577,clients1.google.com,legit,3.47135,6,10,19,0,0.6,0.1827,5,6,4,3,18,2,1,0,0,3
7986,abuhemioyunwvmcd.eu,dga,3.78714,8,10,19,1,0.8,0.19932,2,0,0,0,2,2,0,0,0,2
7500,onguculd.com,dga,3.08496,4,7,12,1,0.57143,0.25708,1,0,0,0,1,1,0,0,0,1
4041,direct-events-collector.spot.im,legit,3.7442,9,18,31,0,0.5,0.12078,5,1,0,0,6,7,1,0,0,8
6625,eiecsgkuamkwscyg.org,dga,3.68418,6,13,20,1,0.46154,0.18421,1,0,0,0,1,2,0,0,0,2
6654,spainislands.tk,dga,3.1899,4,10,15,1,0.4,0.21266,2,0,0,0,2,6,1,0,0,7
9171,vqcsnafox.cc,dga,3.18872,2,9,12,1,0.22222,0.26573,0,0,0,0,0,0,0,0,0,0
753,s.ad.smaato.net,legit,3.00624,5,7,15,0,0.71429,0.20042,6,0,0,0,6,2,0,0,0,2
642,com.edgekey.net,legit,3.24022,5,8,15,0,0.625,0.21601,3,4,2,0,9,4,1,0,0,5
5820,0y4202smw28i.top,dga,3.57782,2,6,16,1,0.33333,0.22361,0,0,0,0,0,0,0,0,0,0
6536,fx73it1pess6asequt.cn,dga,3.97542,5,11,21,1,0.45455,0.18931,2,0,0,0,2,4,1,0,0,5
5651,xeic.pk,dga,2.80735,2,4,7,1,0.5,0.40105,1,0,0,0,1,1,0,0,0,1
8453,epguemhpy.at,dga,3.25163,4,7,12,1,0.57143,0.27097,0,0,0,0,0,1,0,0,0,1
5151,olcommismagnum.com,dga,3.14967,6,11,18,1,0.54545,0.17498,3,1,0,0,4,5,1,0,0,6
2168,forter.com,legit,2.92193,3,6,10,0,0.5,0.29219,2,0,0,0,2,3,1,0,0,4
3993,oms.opinsights.azure.com,legit,3.82393,8,13,24,0,0.61538,0.15933,5,0,0,2,7,5,0,0,0,5
3742,playercdn.jivox.com,legit,3.93214,5,12,19,0,0.41667,0.20695,4,2,1,0,7,3,0,0,0,3
2210,28-courier.push.apple.com,legit,3.86347,8,11,25,0,0.72727,0.15454,9,4,3,2,18,4,0,0,0,4
2521,wv.inner-active.mobi,legit,3.68418,7,10,20,0,0.7,0.18421,3,0,0,0,3,6,0,0,0,6
9479,oilholdjumpplaceconnectfollow.com,dga,3.73775,11,21,33,1,0.52381,0.11327,6,2,0,0,8,7,1,0,0,8
3273,cdn.appdynamics.com,legit,3.36609,4,13,19,0,0.30769,0.17716,8,5,2,0,15,4,1,0,0,5
6919,yugt.kz,dga,2.80735,1,5,7,1,0.2,0.40105,0,0,0,0,0,0,0,0,0,0
7366,sfmoddrvubnyvbqww.pw,dga,3.78418,2,17,20,1,0.11765,0.18921,0,0,0,0,0,1,0,0,0,1
1717,sync.colossusssp.com,legit,2.97095,4,14,20,0,0.28571,0.14855,4,1,0,0,5,2,1,0,0,3
7622,aqqoqcrmjgxghbtw.eu,dga,3.89241,4,14,19,1,0.28571,0.20486,1,0,0,0,1,0,0,0,0,0
1671,cs.iqzone.com,legit,3.2389,4,7,13,0,0.57143,0.24915,2,0,0,0,2,2,1,0,0,3
842,chromereporting-pa.googleapis.com,legit,3.81321,12,18,33,0,0.66667,0.11555,10,6,4,4,24,9,2,0,0,11
7835,gcyggpjuyxavmas.ru,dga,3.57243,4,13,18,1,0.30769,0.19847,1,0,0,0,1,2,0,0,0,2
2275,experiments.apple.com,legit,3.59447,7,12,21,0,0.58333,0.17117,9,5,3,2,19,4,2,0,0,6
6282,awa0as68mcyo.net,dga,3.70282,5,7,16,1,0.71429,0.23143,0,0,0,0,0,1,0,0,0,1
6034,e0uhy8opyx7v16gl38ede6c.ddns.net,dga,4.28891,6,16,32,1,0.375,0.13403,3,1,0,0,4,6,3,2,2,13
9791,fdlkaomffkclmbba.co.uk,dga,3.39081,5,15,22,1,0.33333,0.15413,2,1,0,0,3,2,1,0,0,3
8913,agwgtodsholapet.org,dga,3.53689,6,12,19,1,0.5,0.18615,2,0,0,0,2,2,0,5,5,12
3613,configsvc.cs.roku.com,legit,3.46328,5,13,21,0,0.38462,0.16492,5,1,0,0,6,2,1,0,0,3
5728,xqhpwditffz.dynserv.com,dga,4.26269,3,18,23,1,0.16667,0.18533,3,1,1,0,5,5,5,5,4,19
6408,ciqauuaieywkkams.org,dga,3.78418,9,10,20,1,0.9,0.18921,1,0,0,0,1,1,0,0,0,1
7931,hhqaiifox.com,dga,3.2389,5,7,13,1,0.71429,0.24915,0,0,0,0,0,0,0,0,0,0
5594,captaininclude.net,dga,3.35021,7,10,18,1,0.7,0.18612,3,0,0,0,3,5,0,0,0,5
8242,acbedsed.nf,dga,3.0958,3,7,11,1,0.42857,0.28144,3,0,0,0,3,4,0,0,0,4
3390,profile.gc.apple.com,legit,3.44644,6,11,20,0,0.54545,0.17232,9,5,3,2,19,1,1,0,0,2
9833,kbqpqtxkfxfm.net,dga,3.375,1,14,16,1,0.07143,0.21094,0,0,0,0,0,0,0,0,0,0
9826,lockbottlefitcloudgrowignore.com,dga,3.81955,11,20,32,1,0.55,0.11936,5,3,2,1,11,4,0,0,0,4
7610,pmkyhb.com,dga,3.12193,1,8,10,1,0.125,0.31219,0,0,0,0,0,0,0,0,0,0
5296,ymofe7pdzmn5xvmyra.net,dga,3.97057,4,15,22,1,0.26667,0.18048,2,0,0,0,2,1,0,0,0,1
1946,trial-eum-clienttons-s.akamaihd.net,legit,3.90015,12,18,35,0,0.66667,0.11143,8,4,4,3,19,6,1,0,0,7
7461,ieepwntzw1vquwjlq4.net,dga,3.75444,5,14,22,1,0.35714,0.17066,1,0,0,0,1,0,0,0,0,0
7924,fcqsydvulvyvdfihw.cc,dga,3.54644,2,17,20,1,0.11765,0.17732,0,0,0,0,0,0,0,0,0,0
4259,onedscolprduks01.uksouth.cloudapp.azure.com,legit,4.02536,14,23,43,0,0.6087,0.09361,13,4,3,4,24,5,1,0,0,6
9801,odxouxavwe.ddns.net,dga,3.47135,6,11,19,1,0.54545,0.1827,4,1,0,0,5,4,4,3,2,13
9147,docuenvopuw.ddns.net,dga,3.44644,6,12,20,1,0.5,0.17232,3,1,0,0,4,5,3,3,2,13
4094,b1t-nydc1.zemanta.com,legit,3.72565,4,12,21,0,0.33333,0.17741,3,0,0,0,3,4,0,0,0,4
749,33across.com,legit,2.9183,3,6,12,0,0.5,0.24319,2,2,1,0,5,1,0,0,0,1
7135,msiuccuiwcymao.net,dga,3.57243,7,10,18,1,0.7,0.19847,1,0,0,0,1,2,0,5,4,11
9945,pxmfpvtmxmxkqboojhhc.com,dga,3.60539,3,20,24,1,0.15,0.15022,1,0,0,0,1,0,0,0,0,0
9878,lsplhmewppwwjojm.eu,dga,3.32636,4,14,19,1,0.28571,0.17507,2,0,0,0,2,0,0,0,0,0
7691,canhokjo.ru,dga,3.27761,4,6,11,1,0.66667,0.29796,0,0,0,0,0,2,0,0,0,2
2458,videoamp.com,legit,3.25163,5,6,12,0,0.83333,0.27097,1,0,0,0,1,2,0,0,0,2
7591,xuxyfun.info,dga,2.9183,4,7,12,1,0.57143,0.24319,0,0,0,0,0,0,0,0,0,0
1484,suggestqueries-clients6.youtube.com,legit,3.91887,13,18,35,0,0.72222,0.11197,8,1,0,0,9,8,3,0,0,11
4779,drift.com,legit,3.16993,2,6,9,0,0.33333,0.35221,0,0,0,0,0,1,0,0,0,1
5471,gspgnrgeje.com,dga,3.32486,3,10,14,1,0.3,0.23749,1,0,0,0,1,1,0,0,0,1
1089,cdn.js7k.com,legit,3.25163,1,8,12,0,0.125,0.27097,2,2,1,0,5,1,0,0,0,1
2474,edgeservices.bing.com,legit,3.53517,7,12,21,0,0.58333,0.16834,9,4,2,1,16,8,3,1,0,12
6806,khtlff.mooo.com,dga,2.97356,4,9,15,1,0.44444,0.19824,2,0,0,0,2,0,1,2,1,4
596,token.safebrowsing.apple,legit,3.88684,8,14,24,0,0.57143,0.16195,3,1,0,0,4,3,1,0,0,4
2650,array807.prod.do.dsp.mp.microsoft.com,legit,3.71259,8,20,37,0,0.4,0.10034,12,12,10,9,43,5,2,0,0,7
1895,spocs.getpocket.com,legit,3.2211,5,12,19,0,0.41667,0.16953,2,0,0,0,2,2,0,0,0,2
359,maps.googleapis.com,legit,3.36609,7,10,19,0,0.7,0.17716,7,6,4,4,21,4,0,0,0,4
3438,5.ras.yahoo.com,legit,3.13957,5,6,15,0,0.83333,0.2093,3,0,0,1,4,2,0,0,0,2
6238,bstpsrbwhaxdrvasdfmud.ac,dga,3.82393,4,19,24,1,0.21053,0.15933,1,0,0,0,1,2,0,0,0,2
4210,nr-data.net.cdn.cloudflare.net,legit,3.53957,8,17,30,0,0.47059,0.11799,8,5,4,2,19,8,0,0,0,8
9335,weatherdumplearnboxrequire.com,dga,3.98657,12,17,30,1,0.70588,0.13289,6,1,0,0,7,6,1,1,1,9
8577,gvlrcsjnigjoevmt.net,dga,3.72193,4,15,20,1,0.26667,0.1861,0,0,0,0,0,1,0,0,0,1
1188,rtb.adentifi.com,legit,3.625,5,9,16,0,0.55556,0.22656,5,1,0,0,6,3,1,0,0,4
692,jquery.com,legit,3.32193,3,6,10,0,0.5,0.33219,1,0,0,0,1,1,0,0,0,1
3980,js.hsleadflows.net,legit,3.57243,4,12,18,0,0.33333,0.19847,5,0,0,0,5,2,0,0,0,2
7639,musicroll.net,dga,3.54659,4,8,13,1,0.5,0.27281,4,2,1,0,7,2,0,0,0,2
8108,bozneoxu.ru,dga,3.0958,5,5,11,1,1.0,0.28144,0,0,0,0,0,1,0,0,0,1
8403,ysxrercemarqmbohp.com,dga,3.65376,5,15,21,1,0.33333,0.17399,4,0,0,0,4,6,0,0,0,6
8720,corcdgfqbex.cc,dga,3.23593,2,11,14,1,0.18182,0.23114,2,0,0,0,2,3,3,2,1,9
3223,pull-f5-sg01.ttlivecdn.com.c.worldfcdn.com,legit,4.18448,6,26,42,0,0.23077,0.09963,6,5,5,2,18,6,2,1,0,9
716,media.licdn.com,legit,3.24022,5,8,15,0,0.625,0.21601,5,1,0,0,6,3,0,0,0,3
7121,journeycountry.net,dga,3.2391,6,11,18,1,0.54545,0.17995,3,0,0,0,3,2,0,0,0,2
1430,fwmrm.net,legit,2.9477,1,7,9,0,0.14286,0.32752,0,0,0,0,0,0,0,0,0,0
438,apple.news,legit,2.92193,3,6,10,0,0.5,0.29219,4,3,2,1,10,1,0,0,0,1
9530,shvcswhuqlffqeimryxwhjnh.net,dga,4.09307,4,23,28,1,0.17391,0.14618,0,0,0,0,0,0,0,0,0,0
6606,ekaoaca0aoi8.net,dga,3.25,9,4,16,1,2.25,0.20312,0,0,0,0,0,2,0,0,0,2
8417,mafjuphu.ru,dga,3.02717,4,6,11,1,0.66667,0.2752,1,0,0,0,1,1,0,0,0,1
2353,stat.flashtalking.com,legit,3.65376,5,14,21,0,0.35714,0.17399,4,0,0,0,4,6,1,0,0,7
1418,contile.services.mozilla.com,legit,3.64559,10,15,28,0,0.66667,0.1302,13,3,1,1,18,10,3,1,0,14
9184,dbaolablefakcllo.de,dga,3.15557,7,11,19,1,0.63636,0.16608,2,0,0,0,2,2,0,0,0,2
175,statics.teams.cdn.office.net,legit,3.44076,8,16,28,0,0.5,0.12288,15,6,5,3,29,10,1,0,0,11
1464,microsoftazuread-sso.com,legit,3.72018,9,13,24,0,0.69231,0.15501,9,7,6,6,28,5,0,0,0,5
1040,pull-flv-l77-va01.tiktokcdn.com,legit,4.09114,5,17,31,0,0.29412,0.13197,4,6,9,9,28,2,0,0,0,2
5355,wheelsettlerealizecompare.com,dga,3.60259,12,16,29,1,0.75,0.12423,7,1,0,0,8,11,2,0,0,13
6512,uefwglyuvqps.biz,dga,3.875,4,11,16,1,0.36364,0.24219,0,0,0,0,0,0,0,0,0,0
2928,sail-personalize.com,legit,3.72193,8,10,20,0,0.8,0.1861,3,0,0,0,3,2,1,0,0,3
5158,lifagnicis.com,dga,3.32486,5,8,14,1,0.625,0.23749,2,0,0,0,2,3,0,0,0,3
9071,uruqmejgncei.com,dga,3.5,6,9,16,1,0.66667,0.21875,1,0,0,0,1,1,1,0,0,2
8658,syoqoyk202gi.net,dga,3.625,4,8,16,1,0.5,0.22656,0,0,0,0,0,0,0,0,0,0
2982,services.box.net,legit,3.45282,5,9,16,0,0.55556,0.2158,6,2,1,1,10,5,2,1,0,8
6356,izc39f42csdybyazfuj56p22psm49cym59oqg53.info,dga,4.4474,6,23,44,1,0.26087,0.10108,0,0,0,0,0,0,0,0,0,0
2250,48-courier.push.apple.com,legit,3.86347,8,11,25,0,0.72727,0.15454,9,4,3,2,18,4,0,0,0,4
2934,api.sail-personalize.com,legit,3.68872,10,11,24,0,0.90909,0.1537,5,1,1,0,7,2,1,0,0,3
7064,coqjinug.ru,dga,3.27761,4,6,11,1,0.66667,0.29796,2,0,0,0,2,2,0,0,0,2
2332,capi.connatix.com,legit,3.21953,6,9,17,0,0.66667,0.18938,7,3,1,0,11,5,3,0,0,8
8414,jkrnxoxdjq.com,dga,3.37878,2,11,14,1,0.18182,0.24134,0,0,0,0,0,0,0,0,0,0
7174,slyxmp7pk8mbw2ab36w.ddns.net,dga,4.23593,2,19,28,1,0.10526,0.15128,2,1,0,0,3,4,3,3,2,12
4223,v77.tiktokcdn.com,legit,3.38158,3,10,17,0,0.3,0.19892,4,6,7,6,23,2,0,0,0,2
7663,kphsjufqbex.org,dga,3.90689,3,11,15,1,0.27273,0.26046,0,0,0,0,0,1,3,2,2,8
1546,dell.com,legit,2.75,2,5,8,0,0.4,0.34375,0,0,0,0,0,2,0,0,0,2
8499,723zcyi27u5upnxhjy.cn,dga,3.82089,3,11,21,1,0.27273,0.18195,0,0,0,0,0,0,0,0,0,0
7260,elohwemse.com,dga,3.02699,5,7,13,1,0.71429,0.23285,2,0,0,0,2,3,0,0,0,3
937,godaddy.com,legit,2.84535,3,7,11,0,0.42857,0.25867,1,0,0,0,1,1,0,0,0,1
9888,fdcbenckdncnbddd.com,dga,3.0037,2,17,20,1,0.11765,0.15018,2,0,0,0,2,4,0,0,0,4
2652,onedscolprdwus04.westus.cloudapp.azure.com,legit,3.98709,13,23,42,0,0.56522,0.09493,17,4,3,4,28,7,2,0,0,9
2931,ih.adscale.de,legit,3.08506,5,6,13,0,0.83333,0.23731,4,0,0,0,4,2,0,0,0,2
514,inbox.google.com,legit,3.25,6,8,16,0,0.75,0.20312,3,5,4,3,15,2,0,0,0,2
9143,vilkngowoqmnqhhvq.su,dga,3.68418,4,15,20,1,0.26667,0.18421,0,0,0,0,0,0,0,0,0,0
3710,eu-central-1.amazonaws.com,legit,3.85429,9,12,26,0,0.75,0.14824,8,2,3,3,16,6,2,0,0,8
152,r4.res.office365.com,legit,3.58418,5,8,20,0,0.625,0.17921,6,4,4,3,17,4,1,0,0,5
8492,3zxsvpb46docct8pqi.com,dga,4.06148,3,14,22,1,0.21429,0.18461,0,0,0,0,0,0,0,0,0,0
7296,qxfnlgzyonbtmwpg.org,dga,3.88418,2,17,20,1,0.11765,0.19421,1,0,0,0,1,1,0,0,0,1
4595,audex.userreport.com,legit,3.54644,8,10,20,0,0.8,0.17732,4,1,0,0,5,5,1,0,0,6
5407,vradfuchimxjxdx.info,dga,3.78418,5,14,20,1,0.35714,0.18921,2,0,0,0,2,1,0,0,0,1
7051,dcbosylldheaunah.eu,dga,3.61635,7,11,19,1,0.63636,0.19033,1,0,0,0,1,1,0,0,0,1
1617,completion.amazon.com,legit,3.40399,8,11,21,0,0.72727,0.16209,8,3,3,3,17,8,3,1,0,12
586,data.msn.com,legit,3.08496,3,7,12,0,0.42857,0.25708,3,0,0,0,3,2,0,0,0,2
8377,thursdayprojects.ch,dga,3.72161,4,14,19,1,0.28571,0.19587,2,1,0,0,3,1,1,0,0,2
6120,rxeoheiutlcs.com,dga,3.625,6,9,16,1,0.66667,0.22656,0,0,0,0,0,0,0,0,0,0
5395,zuavaxhmc.ag,dga,3.18872,4,7,12,1,0.57143,0.26573,0,0,0,0,0,0,0,0,0,0
2418,edog.cdn.office.net,legit,3.2211,6,10,19,0,0.6,0.16953,7,6,5,3,21,4,0,0,0,4
4103,safebrowsing.g.aaplimg.com,legit,3.84411,8,15,26,0,0.53333,0.14785,6,0,0,0,6,2,1,0,0,3
5855,rugceaxo.ru,dga,3.0958,5,5,11,1,1.0,0.28144,2,0,0,0,2,2,0,0,0,2
7261,xykdjw.vn,dga,3.16993,0,8,9,1,0.0,0.35221,0,0,0,0,0,0,0,0,0,0
3192,us-east1-aws.api.sc-gw.com,legit,3.69026,7,12,26,0,0.58333,0.14193,7,3,1,0,11,3,0,0,0,3
3700,us.bytedance.map.fastly.net,legit,3.70805,7,16,27,0,0.4375,0.13734,11,1,0,0,12,7,1,1,0,9
3019,a1894.dscb.akamai.net,legit,3.78494,6,8,21,0,0.75,0.18024,5,3,4,3,15,3,0,0,0,3
1093,walkme.com,legit,3.12193,3,6,10,0,0.5,0.31219,0,0,0,0,0,0,0,0,0,0
7655,dcdfdabfkacdefad.cc,dga,2.71533,4,14,19,1,0.28571,0.14291,2,0,0,0,2,2,0,0,0,2
1683,commnat-main-gc.ess.apple.com,legit,3.67644,8,16,29,0,0.5,0.12677,11,5,3,2,21,7,2,0,0,9
4761,openx2-match.dotomi.com,legit,3.70813,7,12,23,0,0.58333,0.16122,5,0,0,0,5,6,0,0,0,6
3231,frontier-va.tiktokv.com,legit,3.67531,7,13,23,0,0.53846,0.1598,6,5,4,3,18,3,0,0,0,3
7783,vonycaf.com,dga,3.0958,3,7,11,1,0.42857,0.28144,1,0,0,0,1,2,0,0,0,2
9275,aaaskawmskmwqqka.org,dga,3.1037,6,13,20,1,0.46154,0.15518,0,0,0,0,0,1,0,0,0,1
6998,dagvbg2wnqhsf5kxby.com,dga,4.27761,2,17,22,1,0.11765,0.19444,0,0,0,0,0,0,0,0,0,0
5511,vuxkirov.ru,dga,2.91398,4,6,11,1,0.66667,0.26491,1,0,0,0,1,0,0,0,0,0
9359,fdssyzhnz.com,dga,3.39275,1,11,13,1,0.09091,0.26098,1,0,0,0,1,0,0,0,0,0
1053,pixel.mathtag.com,legit,3.61687,5,10,17,0,0.5,0.21276,5,0,0,0,5,4,0,0,0,4
7722,u4uk6wisuoqc.org,dga,3.57782,6,7,16,1,0.85714,0.22361,0,0,0,0,0,2,0,0,0,2
4198,bnmla.com,legit,2.9477,2,6,9,0,0.33333,0.32752,0,0,0,0,0,1,0,0,0,1
2614,v19.tiktokcdn-us.com,legit,3.82193,4,11,20,0,0.36364,0.1911,5,6,7,6,24,2,0,0,0,2
3277,iad-06.braze.com,legit,3.75,5,6,16,0,0.83333,0.23438,2,0,0,0,2,1,0,0,0,1
53,outlook.office.com,legit,3.19161,8,8,18,0,1.0,0.17731,6,4,4,3,17,2,0,0,0,2
7962,dtwwwzrhjovynbrx.com,dga,3.88418,2,17,20,1,0.11765,0.19421,0,0,0,0,0,0,0,0,0,0
5847,cccekabefmokbfcb.com,dga,3.0037,5,14,20,1,0.35714,0.15018,1,0,0,0,1,2,0,0,0,2
6817,ogiamsyqksqickee.org,dga,3.62193,7,12,20,1,0.58333,0.1811,2,0,0,0,2,2,0,0,0,2
8026,taaifdpldetsksa.com,dga,3.68188,6,12,19,1,0.5,0.19378,2,0,0,0,2,3,0,0,0,3
8607,quudtqwimksnmmjg.eu,dga,3.64215,5,13,19,1,0.38462,0.19169,0,0,0,0,0,0,0,0,0,0
8823,folzps.sg,dga,2.9477,1,7,9,1,0.14286,0.32752,0,0,0,0,0,0,0,0,0,0
8765,eordzy5j2ltxxvczpv.ru,dga,4.01137,3,15,21,1,0.2,0.19102,0,0,0,0,0,1,0,0,0,1
4852,ap-gew1.spotify.com,legit,3.93214,5,10,19,0,0.5,0.20695,3,0,0,0,3,2,0,0,0,2
3935,ads.playground.xyz,legit,3.72548,4,12,18,0,0.33333,0.20697,6,0,0,0,6,2,0,0,0,2
374,aa-rt.sharepoint.com,legit,3.68418,7,10,20,0,0.7,0.18421,3,0,0,0,3,3,0,0,0,3
6668,hunetdohw.com,dga,3.39275,4,8,13,1,0.5,0.26098,0,0,0,0,0,2,0,0,0,2
6993,gn2goz1mxl3xmbq75y.cn,dga,4.01137,1,14,21,1,0.07143,0.19102,0,0,0,0,0,0,0,0,0,0
8616,lkiuetirhaoruw.info,dga,3.68188,9,9,19,1,1.0,0.19378,1,0,0,0,1,3,0,0,0,3
7401,emciiwyioimymcgu.org,dga,3.28418,8,11,20,1,0.72727,0.16421,0,0,0,0,0,1,0,0,0,1
9902,jeologea.ru,dga,3.0958,6,4,11,1,1.5,0.28144,3,0,0,0,3,2,0,0,0,2
1434,cognitivlabs.com,legit,3.625,5,10,16,0,0.5,0.22656,2,0,0,0,2,5,0,0,0,5
3529,push-rtmp-l16-tt01.tiktokcdn-us.com.atomile.com,legit,4.1447,10,25,47,0,0.4,0.08819,12,9,10,10,41,7,2,1,0,10
4985,live-video.net,legit,3.18201,6,6,14,0,1.0,0.22729,1,0,0,0,1,2,0,0,0,2
8169,threehurt.net,dga,2.66123,4,8,13,1,0.5,0.20471,1,0,0,0,1,1,0,0,0,1
1851,sharethis.com,legit,3.39275,4,8,13,0,0.5,0.26098,1,0,0,0,1,4,0,0,0,4
3055,array809.prod.do.dsp.mp.microsoft.com,legit,3.71259,8,20,37,0,0.4,0.10034,12,12,10,9,43,5,2,0,0,7
4149,vzw.com,legit,2.80735,1,5,7,0,0.2,0.40105,0,0,0,0,0,0,0,0,0,0
5061,bycuobafnqrlsl.com,dga,3.72548,4,13,18,1,0.30769,0.20697,0,0,0,0,0,0,0,0,0,0
6514,wuhislu.com,dga,3.27761,4,6,11,1,0.66667,0.29796,0,0,0,0,0,1,0,0,0,1
8229,networkcookattractsoilavoid.com,dga,3.6955,12,18,31,1,0.66667,0.11921,4,0,0,0,4,8,1,0,0,9
4172,api.cortana.ai,legit,2.95021,7,5,14,0,1.4,0.21073,5,2,1,0,8,4,1,0,0,5
9325,zjargzjhvc.com,dga,3.37878,2,11,14,1,0.18182,0.24134,0,0,0,0,0,1,0,0,0,1
7286,s60i8yci0igq.top,dga,3.57782,4,7,16,1,0.57143,0.22361,0,0,0,0,0,0,0,0,0,0
8154,refugeesfutures.jp,dga,3.12799,7,10,18,1,0.7,0.17378,3,0,0,0,3,3,2,0,0,5
580,visualstudio.com,legit,3.5,7,8,16,0,0.875,0.21875,1,0,0,0,1,3,0,0,0,3
2354,dual-a-0036.a-msedge.net,legit,3.7406,7,8,24,0,0.875,0.15586,4,2,1,0,7,3,0,0,0,3
94,www.youtube.com,legit,3.1899,5,8,15,0,0.625,0.21266,1,0,0,0,1,1,0,0,0,1
1792,incidents.diagnostics.office.com,legit,3.54284,11,18,32,0,0.61111,0.11071,10,5,4,3,22,8,1,0,0,9
2745,ensighten.com,legit,3.39275,4,8,13,0,0.5,0.26098,2,0,0,0,2,4,0,0,0,4
4564,jabra.com,legit,2.9477,3,5,9,0,0.6,0.32752,1,0,0,0,1,1,0,0,0,1
6615,kvvgbaxwsnbdajbtsjfrxzpso.biz,dga,4.07333,4,24,29,1,0.16667,0.14046,0,0,0,0,0,0,0,0,0,0
4969,mboxedge34.tt.omtrdc.net,legit,3.60539,5,14,24,0,0.35714,0.15022,3,2,1,0,6,3,0,0,0,3
4573,push-rtmp-f5-tt01.fcdn.us.tiktokv.com.c.worldfcdn2.com,legit,4.2384,7,33,54,0,0.21212,0.07849,8,10,7,4,29,5,2,1,0,8
7186,sorted-intimate.yt,dga,3.50326,6,10,18,1,0.6,0.19463,7,0,0,0,7,7,1,0,0,8
7102,xoqhujal.ru,dga,3.27761,4,6,11,1,0.66667,0.29796,0,0,0,0,0,0,0,0,0,0
7311,dgpiefnrxjqhxmkeyku.com,dga,4.17574,5,17,23,1,0.29412,0.18155,1,0,0,0,1,0,0,0,0,0
7104,fkayyfxlcfmyuka.ru,dga,3.30827,4,13,18,1,0.30769,0.18379,0,0,0,0,0,0,0,0,0,0
4248,wlhrm-a-2.prod.infra.webex.com,legit,4.08173,7,16,30,0,0.4375,0.13606,5,4,3,2,14,3,2,0,0,5
9572,wifiowroolevmi.ddns.net,dga,3.67531,8,13,23,1,0.61538,0.1598,6,1,0,0,7,6,4,3,2,15
9728,xkpyrifox.cc,dga,3.25163,2,9,12,1,0.22222,0.27097,0,0,0,0,0,1,0,0,0,1
8139,dfclawxsayiygwrc.eu,dga,3.82687,5,13,19,1,0.38462,0.20141,0,0,0,0,0,1,0,0,0,1
3153,uat-net.technoratimedia.com,legit,3.66193,11,13,27,0,0.84615,0.13563,6,0,0,0,6,9,1,0,0,10
3525,aliyuncs.com,legit,3.4183,4,7,12,0,0.57143,0.28486,1,0,0,0,1,0,0,0,0,0
5422,dbvsiwgucjsfimlv.eu,dga,3.82687,5,13,19,1,0.38462,0.20141,0,0,0,0,0,1,0,0,0,1
7618,mnvtqouveifkrghzk.com,dga,4.01137,5,15,21,1,0.33333,0.19102,1,0,0,0,1,1,0,0,0,1
5186,relaxationprint.re,dga,3.35021,7,10,18,1,0.7,0.18612,7,0,0,0,7,8,4,2,1,15
5949,fmxuzfxhc.lc,dga,3.08496,1,10,12,1,0.1,0.25708,0,0,0,0,0,0,0,0,0,0
5102,norytaf.info,dga,3.08496,4,7,12,1,0.57143,0.25708,1,0,0,0,1,2,0,0,0,2
3773,smartclip.net,legit,3.54659,3,9,13,0,0.33333,0.27281,2,0,0,0,2,2,0,0,0,2
4351,config-teams.s-0005.s-msedge.net,legit,3.80423,7,15,32,0,0.46667,0.11888,9,3,1,0,13,8,1,0,0,9
2222,40-courier.push.apple.com,legit,3.86347,8,11,25,0,0.72727,0.15454,9,4,3,2,18,4,0,0,0,4
9005,odtqyglf.com,dga,3.4183,2,9,12,1,0.22222,0.28486,0,0,0,0,0,0,0,0,0,0
9990,yo28iga8qcm0.net,dga,3.875,4,7,16,1,0.57143,0.24219,0,0,0,0,0,0,0,0,0,0
2555,2.android.pool.ntp.org,legit,3.36852,6,11,22,0,0.54545,0.15311,5,0,0,0,5,2,1,0,0,3
284,r2m01.amazontrust.com,legit,3.6897,5,11,21,0,0.45455,0.1757,7,1,3,3,14,4,0,0,0,4
9213,whichreach.net,dga,3.18201,4,9,14,1,0.44444,0.22729,3,0,0,0,3,4,0,0,0,4
1468,metrics-a.wbx2.com,legit,3.83659,4,10,18,0,0.4,0.21314,1,0,0,0,1,3,0,0,0,3
1696,c2r.ts.cdn.office.net,legit,3.40399,4,12,21,0,0.33333,0.16209,8,6,5,3,22,3,0,0,0,3
2485,iot.us-west-2.amazonaws.com,legit,3.75416,9,12,27,0,0.75,0.13904,7,1,3,3,14,5,1,0,0,6
1275,sync.teads.tv,legit,3.2389,2,9,13,0,0.22222,0.24915,5,0,0,0,5,2,0,0,0,2
2880,z01.azurefd.net,legit,3.50689,4,7,15,0,0.57143,0.23379,2,0,0,2,4,1,0,0,0,1
8218,syndicationeuropean.mo,dga,3.75444,10,11,22,1,0.90909,0.17066,6,0,0,0,6,9,4,2,1,16
3212,cse.google.com,legit,2.89629,5,7,14,0,0.71429,0.20688,4,5,4,3,16,2,0,0,0,2
7970,lxfekapufow.com,dga,3.64022,5,9,15,1,0.55556,0.24268,1,0,0,0,1,0,0,0,0,0
7922,tgbtrtbdoflnhi.com,dga,3.68354,3,14,18,1,0.21429,0.20464,1,0,0,0,1,0,0,0,0,0
7316,ohbuqouxporifea.ddns.net,dga,3.97018,9,13,24,1,0.69231,0.16542,4,1,0,0,5,7,4,3,2,16
8707,4ykiwqkqgqo2.top,dga,3.45282,3,10,16,1,0.3,0.2158,0,0,0,0,0,0,0,0,0,0
9658,lozmoqju.ru,dga,3.0958,4,6,11,1,0.66667,0.28144,1,0,0,0,1,0,0,0,0,0
8817,ditawnihedl.com,dga,3.64022,5,9,15,1,0.55556,0.24268,2,0,0,0,2,4,1,0,0,5
3912,a.espncdn.com,legit,3.2389,3,8,13,0,0.375,0.24915,3,1,0,0,4,2,0,0,0,2
8197,fdxwukmlemcdbegrb.cc,dga,3.68418,3,16,20,1,0.1875,0.18421,2,0,0,0,2,3,0,0,0,3
1536,footprint.net,legit,3.02699,4,8,13,0,0.5,0.23285,4,0,0,0,4,2,1,0,0,3
3092,1f2e7.v.fwmrm.net,legit,3.45482,2,9,17,0,0.22222,0.20322,0,0,0,0,0,0,0,0,0,0
9166,olurgatloh.com,dga,3.32486,5,8,14,1,0.625,0.23749,2,0,0,0,2,1,0,0,0,1
3442,networking.aws.dev,legit,3.72548,5,11,18,0,0.45455,0.20697,2,0,0,0,2,4,1,0,0,5
5164,qjvgzyroecymwresreu.com,dga,3.76227,6,16,23,1,0.375,0.16358,3,0,0,0,3,3,1,0,0,4
1191,f-log-extension.grammarly.io,legit,3.92325,9,15,28,0,0.6,0.14012,7,0,0,0,7,9,1,0,0,10
1013,pull-c5-va01.tiktokcdn.com,legit,4.05602,5,14,26,0,0.35714,0.156,4,6,9,9,28,2,0,0,0,2
9186,sundaytuesday.net,dga,3.14629,6,10,17,1,0.6,0.18508,1,0,0,0,1,3,0,0,0,3
4009,firebaseperusertopics-pa.googleapis.com,legit,3.85273,16,20,39,0,0.8,0.09879,10,7,4,4,25,8,1,0,0,9
6251,jhqzwjtb.cc,dga,3.0958,0,10,11,1,0.0,0.28144,0,0,0,0,0,0,0,0,0,0
1063,time.windows.com,legit,3.375,5,9,16,0,0.55556,0.21094,3,0,0,0,3,3,0,0,0,3
3609,a.prd.aadg.akadns.net,legit,3.13686,6,11,21,0,0.54545,0.14937,5,4,4,3,16,2,1,0,0,3
7582,phraseloanreportsetgrabadd.com,dga,3.7899,10,19,30,1,0.52632,0.12633,5,0,0,0,5,9,0,0,0,9
7545,fcdmnkfbmbofbbln.eu,dga,3.36609,3,15,19,1,0.2,0.17716,2,0,0,0,2,0,0,0,0,0
3519,consensu.org,legit,3.08496,4,7,12,0,0.57143,0.25708,4,1,0,0,5,6,2,0,0,8
9734,bkgwrnwssilw.biz,dga,3.32782,2,13,16,1,0.15385,0.20799,0,0,0,0,0,1,0,0,0,1
1685,com.c.footprint.net,legit,3.28663,5,11,19,0,0.45455,0.17298,6,2,1,0,9,4,2,0,0,6
6620,k7t7hlqkqk2q6kuhw3.ru,dga,3.49923,2,13,21,1,0.15385,0.16663,0,0,0,0,0,0,0,0,0,0
9113,uemiuismif.tv,dga,3.02699,6,6,13,1,1.0,0.23285,1,0,0,0,1,3,0,0,0,3
9054,rcpzhfijvmvwohgyceromvc.ru,dga,3.92103,5,20,26,1,0.25,0.15081,3,0,0,0,3,3,0,0,0,3
1856,s.tribalfusion.com,legit,3.72548,6,10,18,0,0.6,0.20697,4,0,0,0,4,3,1,0,0,4
7905,ehwtgigj.gr,dga,3.02717,2,8,11,1,0.25,0.2752,0,0,0,0,0,0,0,0,0,0
4110,connect-metrics-collector.s-onetag.com,legit,3.59979,11,22,38,0,0.5,0.09473,5,1,0,0,6,10,2,0,0,12
8888,ugacryoryk.com,dga,3.23593,4,9,14,1,0.44444,0.23114,1,0,0,0,1,2,0,0,0,2
5968,qaliesvomo.ddns.net,dga,3.61635,6,11,19,1,0.54545,0.19033,4,1,0,0,5,6,4,3,2,15
8295,gq02824m8a0u.top,dga,3.625,3,5,16,1,0.6,0.22656,0,0,0,0,0,0,0,0,0,0
1158,adjust.com,legit,3.32193,3,6,10,0,0.5,0.33219,3,0,0,0,3,1,0,0,0,1
8676,n60lwpthtpzjua37l18j46hyiuj56i35dwh24p52.ru,dga,4.43721,6,20,43,1,0.3,0.10319,0,0,0,0,0,0,0,0,0,0
5513,verenobiscumtext.com,dga,3.68418,7,12,20,1,0.58333,0.18421,4,0,0,0,4,6,2,0,0,8
4875,azurewebsites.windows.net,legit,3.62347,9,14,25,0,0.64286,0.14494,5,0,0,1,6,7,0,0,0,7
700,analytics.tiktok.com,legit,3.48418,6,12,20,0,0.5,0.17421,4,5,4,3,16,3,0,0,0,3
5689,hvl48g53dun10cwl58c29b38atmxevbyovgqmw.ru,dga,4.68658,5,23,41,1,0.21739,0.11431,1,0,0,0,1,1,0,0,0,1
3366,usadmm-ds.dotomi.com,legit,3.24644,6,11,20,0,0.54545,0.16232,6,0,0,0,6,3,0,0,0,3
1488,adfarm1.adition.com,legit,3.47135,7,9,19,0,0.77778,0.1827,4,0,0,0,4,4,2,1,0,7
7234,twcxcukuuldvahf.co.uk,dga,3.59447,6,13,21,1,0.46154,0.17117,2,1,0,0,3,1,1,0,0,2
6116,ceaqeodo.ru,dga,3.0958,6,4,11,1,1.5,0.28144,2,0,0,0,2,2,0,0,0,2
9993,hvhrxbeezx.com,dga,3.37878,3,10,14,1,0.3,0.24134,0,0,0,0,0,1,0,0,0,1
6458,unshghpxxndvabllj.tw,dga,3.92193,2,17,20,1,0.11765,0.1961,0,0,0,0,0,2,0,0,0,2
652,js-sec.indexww.com,legit,3.61437,4,11,18,0,0.36364,0.2008,2,0,0,0,2,5,0,0,0,5
5759,gwop.ag,dga,2.52164,2,4,7,1,0.5,0.36023,0,0,0,0,0,0,0,0,0,0
2872,ioc-gw-prod-us-1b.sentinelone.net,legit,3.93061,10,16,33,0,0.625,0.11911,10,3,1,0,14,7,4,0,0,11
2419,uci.edog.cdn.office.net,legit,3.32748,8,11,23,0,0.72727,0.14467,7,6,5,3,21,4,0,0,0,4
3248,carddav.address.yahoo.com,legit,3.38347,8,14,25,0,0.57143,0.13534,6,0,0,1,7,5,2,0,0,7
2224,47-courier.push.apple.com,legit,3.86347,8,11,25,0,0.72727,0.15454,9,4,3,2,18,4,0,0,0,4
4092,sdk.pushmessage.samsung.com,legit,3.53194,7,17,27,0,0.41176,0.13081,5,1,0,0,6,4,1,0,0,5
2686,browser.events.data.trafficmanager.net,legit,3.77492,12,22,38,0,0.54545,0.09934,14,5,1,3,23,12,3,0,0,15
1795,init-p01md-lb.push-apple.com.akadns.net,legit,4.15041,9,21,39,0,0.42857,0.10642,12,9,9,9,39,8,3,1,0,12
7631,gmyikyooiuqmiiic.org,dga,3.2037,9,10,20,1,0.9,0.16018,3,0,0,0,3,2,0,0,0,2
8826,virtually-florist.org,dga,3.65376,6,13,21,1,0.46154,0.17399,2,0,0,0,2,4,2,0,0,6
6130,agq0qcqse0y8.org,dga,3.45282,3,9,16,1,0.33333,0.2158,1,0,0,0,1,1,0,0,0,1
3095,cryptauthenrollment.googleapis.com,legit,3.96203,11,21,34,0,0.52381,0.11653,10,7,4,4,25,5,1,0,0,6
2576,trellix.com,legit,3.27761,3,7,11,0,0.42857,0.29796,2,0,0,0,2,2,0,0,0,2
6136,actionjacketbecomefileweigh.com,dga,3.82131,13,17,31,1,0.76471,0.12327,4,1,0,0,5,9,3,1,1,14
4913,crsspxl.com,legit,3.0958,1,9,11,0,0.11111,0.28144,1,0,0,0,1,0,0,0,0,0
1067,pull-f5-tt02.tiktokcdn.com,legit,3.93121,4,15,26,0,0.26667,0.1512,4,6,9,7,26,2,0,0,0,2
6637,aukgzaiq.net,dga,3.4183,5,6,12,1,0.83333,0.28486,0,0,0,0,0,0,0,0,0,0
4031,om.forgeofempires.com,legit,3.2728,8,11,21,0,0.72727,0.15585,5,1,0,0,6,6,1,0,0,7
8875,sxlmlxiovlxcaggr.eu,dga,3.64215,5,13,19,1,0.38462,0.19169,0,0,0,0,0,1,0,0,0,1
8814,zuyvt.com.mt,dga,3.08496,2,8,12,1,0.25,0.25708,2,2,1,0,5,2,2,1,0,5
4523,4-c-0003.c-msedge.net,legit,3.52257,3,8,21,0,0.375,0.16774,4,2,1,0,7,3,0,0,0,3
5295,ecvqf.ly,dga,3.0,1,6,8,1,0.16667,0.375,0,0,0,0,0,1,0,0,0,1
6649,dduwjmnvsqhgcer.bz,dga,4.05881,2,15,18,1,0.13333,0.22549,2,0,0,0,2,3,0,0,0,3
9678,ehem47bm3ks4sxm5p5.cn,dga,3.78494,2,12,21,1,0.16667,0.18024,0,0,0,0,0,1,0,0,0,1
9211,sy6bgc2d111b8xj1by.ru,dga,3.6897,1,12,21,1,0.08333,0.1757,0,0,0,0,0,0,0,0,0,0
643,lh6.googleusercontent.com,legit,3.65366,8,14,25,0,0.57143,0.14615,10,8,4,3,25,7,3,0,0,10
5955,bvkollqlqtcx.me.uk,dga,3.57243,3,13,18,1,0.23077,0.19847,1,0,0,0,1,0,0,0,0,0
1377,lcs-cops.adobe.io,legit,3.45482,6,8,17,0,0.75,0.20322,4,0,0,0,4,2,0,0,0,2
1629,edge.digicert.com,legit,3.21953,6,9,17,0,0.66667,0.18938,7,3,1,0,11,6,1,0,0,7
5111,travellingnecessity.pk,dga,3.78875,6,15,22,1,0.4,0.17222,5,0,0,0,5,10,3,0,0,13
6462,ciwqiuyyeayoaigs.org,dga,3.54644,9,10,20,1,0.9,0.17732,1,0,0,0,1,1,0,0,0,1
5811,rcgpojjd.com,dga,3.08496,2,9,12,1,0.22222,0.25708,0,0,0,0,0,0,0,0,0,0
7252,sq864qou4iga.org,dga,3.5,5,6,16,1,0.83333,0.21875,1,0,0,0,1,0,0,0,0,0
7462,puzoxaqykim.eu,dga,3.6645,6,7,14,1,0.85714,0.26175,0,0,0,0,0,0,0,0,0,0
1618,dscd.akamai.net,legit,3.32323,5,8,15,0,0.625,0.22155,6,3,4,3,16,2,0,0,0,2
6195,8qgi8yge0a4a.net,dga,3.5,5,6,16,1,0.83333,0.21875,1,0,0,0,1,1,0,0,0,1
1477,d.turn.com,legit,3.12193,2,6,10,0,0.33333,0.31219,2,0,0,0,2,0,1,0,0,1
6779,lsrofcn.com,dga,3.0958,2,8,11,1,0.25,0.28144,2,0,0,0,2,0,0,0,0,0
1530,firefox.com,legit,3.0958,4,6,11,0,0.66667,0.28144,1,0,0,0,1,1,0,0,0,1
29,digicert.com,legit,3.25163,4,7,12,0,0.57143,0.27097,3,1,0,0,4,3,0,0,0,3
760,android.apis.google.com,legit,3.62118,9,11,23,0,0.81818,0.15744,8,7,4,3,22,4,1,0,0,5
1432,weather-data.apple.com.akadns.net,legit,3.76365,11,17,33,0,0.64706,0.11405,14,10,10,10,44,9,4,2,1,16
2548,c-ring.msedge.net,legit,3.45482,4,10,17,0,0.4,0.20322,5,2,1,0,8,5,2,0,0,7
3614,ims-na1.adobelogin.com,legit,3.78875,8,10,22,0,0.8,0.17222,4,0,0,0,4,3,0,0,0,3
468,uci.cdn.office.net,legit,3.19716,6,9,18,0,0.66667,0.17762,6,6,5,3,20,3,0,0,0,3
1828,me.com.akadns.net,legit,3.33718,5,9,17,0,0.55556,0.1963,6,6,7,8,27,4,3,1,0,8
250,analytics.google.com,legit,3.58418,7,11,20,0,0.63636,0.17921,5,5,4,3,17,4,0,0,0,4
7890,alonelabor.net,dga,3.09307,6,7,14,1,0.85714,0.22093,2,0,0,0,2,5,1,0,0,6
5308,kktrtevjrkif.com,dga,3.45282,3,12,16,1,0.25,0.2158,1,0,0,0,1,1,0,0,0,1
605,bootstrapcdn.com,legit,3.45282,4,11,16,0,0.36364,0.2158,6,1,0,0,7,3,1,0,0,4
2159,da.us.criteo.net,legit,3.45282,6,7,16,0,0.85714,0.2158,5,0,0,0,5,3,0,0,0,3
9742,virtuteslaiconcionatores.com,dga,3.65505,12,15,28,1,0.8,0.13054,7,1,0,0,8,9,3,0,0,12
659,aad.cs.dds.microsoft.com,legit,3.29248,6,14,24,0,0.42857,0.13719,12,8,7,6,33,4,1,1,0,6
9293,meetinganticipatecakeimply.com,dga,3.60624,12,17,30,1,0.70588,0.12021,7,0,0,0,7,9,2,0,0,11
3305,cookies.andbeyond.media,legit,3.55553,10,11,23,0,0.90909,0.15459,6,0,0,0,6,6,1,0,0,7
328,ocsp.entrust.net,legit,3.20282,4,10,16,0,0.4,0.20018,5,1,0,0,6,2,1,0,0,3
3954,bytewlb.akadns.net,legit,3.50326,4,12,18,0,0.33333,0.19463,4,3,4,3,14,3,1,0,0,4
7406,bxdatis.mooo.com,dga,3.25,6,8,16,1,0.75,0.20312,5,0,0,0,5,3,2,2,1,8
8419,vofodet.info,dga,3.02206,5,6,12,1,0.83333,0.25184,1,0,0,0,1,2,0,0,0,2
4101,hlb.apr-52dd2-0.edgecastdns.net,legit,4.00227,5,17,31,0,0.29412,0.12911,7,5,1,0,13,9,1,0,0,10
2510,array511.prod.do.dsp.mp.microsoft.com,legit,3.65853,8,20,37,0,0.4,0.09888,12,12,10,9,43,5,2,0,0,7
8045,ywjwvpylqndiqmsm.eu,dga,3.82687,3,15,19,1,0.2,0.20141,0,0,0,0,0,1,0,0,0,1
6439,zglctkrtryx.com,dga,3.50689,1,13,15,1,0.07692,0.23379,0,0,0,0,0,0,0,0,0,0
4958,humb.apple.com,legit,3.37878,4,8,14,0,0.5,0.24134,5,4,3,2,14,1,0,0,0,1
6730,amnjlnnjamhqyhtmlnpqxsqz.com,dga,3.78039,3,24,28,1,0.125,0.13501,1,0,0,0,1,1,0,0,0,1
115,ytimg.com,legit,2.9477,2,6,9,0,0.33333,0.32752,1,0,0,0,1,1,0,0,0,1
3555,fast-prod-atm-nam.trafficmanager.net,legit,3.74536,10,21,36,0,0.47619,0.10404,11,6,2,3,22,10,2,0,0,12
9683,cbjhziizw.dynserv.com,dga,4.01137,4,15,21,1,0.26667,0.19102,3,1,1,0,5,4,5,5,4,18
9716,awaeueiq.biz,dga,3.08496,7,4,12,1,1.75,0.25708,0,0,0,0,0,0,0,0,0,0
3774,certificates.godaddy.com,legit,3.68872,8,14,24,0,0.57143,0.1537,9,2,0,0,11,9,1,0,0,10
8244,ehovivqode.ddns.net,dga,3.32636,6,11,19,1,0.54545,0.17507,3,1,0,0,4,5,4,3,2,14
1887,login.dotomi.com,legit,3.125,6,8,16,0,0.75,0.19531,4,0,0,0,4,4,0,0,0,4
3322,pagead2.googleadservices.com,legit,3.72647,11,14,28,0,0.78571,0.13309,11,8,5,5,29,8,2,1,0,11
9315,brooklynnkimberly.net,dga,3.49923,5,15,21,1,0.33333,0.16663,3,0,0,0,3,2,0,0,0,2
5889,fydwguofcbrsyd.tw,dga,3.61687,2,14,17,1,0.14286,0.21276,1,0,0,0,1,0,0,0,0,0
3414,proc.ad.cpe.dotomi.com,legit,3.2433,7,11,22,0,0.63636,0.14742,9,1,0,0,10,3,2,0,0,5
8005,gifx.nl,dga,2.80735,1,5,7,1,0.2,0.40105,0,0,0,0,0,0,0,0,0,0
4394,raw.githubusercontent.com,legit,3.89366,8,15,25,0,0.53333,0.15575,9,3,0,0,12,8,3,0,0,11
6742,kqdzdqlydzl68lvd60hxh34dsize21hqa57l38.org,dga,4.44293,4,25,42,1,0.16,0.10578,1,0,0,0,1,1,0,0,0,1
6564,horpurgaestcausam.com,dga,3.59447,8,12,21,1,0.66667,0.17117,4,0,0,0,4,5,1,0,0,6
7085,southfruitgroundcablebrain.com,dga,4.0314,11,18,30,1,0.61111,0.13438,5,0,0,0,5,6,0,0,0,6
4670,nintendo.net,legit,2.58496,4,7,12,0,0.57143,0.21541,4,0,0,0,4,5,0,1,0,6
1951,s7.addthis.com,legit,3.37878,3,8,14,0,0.375,0.24134,2,0,0,0,2,2,0,0,0,2
2955,e3528.dscg.akamaiedge.net,legit,3.78347,8,10,25,0,0.8,0.15134,7,5,5,3,20,5,0,0,0,5
9205,safinwicas.com,dga,3.23593,5,8,14,1,0.625,0.23114,2,0,0,0,2,4,0,0,0,4
9556,ij1jux1hgf3jm4w4edq.ddns.net,dga,4.11058,4,17,28,1,0.23529,0.14681,3,1,0,0,4,5,3,3,2,13
9669,knuvhccuvnet.pw,dga,3.37356,3,11,15,1,0.27273,0.2249,0,0,0,0,0,2,0,0,0,2
7018,vqndmjfcpwqocaf.info,dga,3.68418,4,15,20,1,0.26667,0.18421,0,0,0,0,0,2,0,0,0,2
4659,fp-afd-nocache.azureedge.net,legit,3.79434,10,14,28,0,0.71429,0.13551,5,2,1,2,10,5,0,0,0,5
4765,push-rtmp-l1-va01.tiktokcdn.com,legit,4.19582,5,18,31,0,0.27778,0.13535,5,6,7,8,26,2,0,0,0,2
4228,ws.zoominfo.com,legit,3.10689,5,8,15,0,0.625,0.20713,4,0,0,0,4,3,0,0,0,3
4571,push-rtmp-l10-va01.tiktokcdn.com,legit,4.20282,5,18,32,0,0.27778,0.13134,5,6,7,8,26,2,0,0,0,2
7930,wehaldof.com,dga,3.4183,4,7,12,1,0.57143,0.28486,1,0,0,0,1,0,0,0,0,0
2566,q.adrta.com,legit,3.0958,3,6,11,0,0.5,0.28144,3,0,0,0,3,1,0,0,0,1
3892,pull-flv-l1-gcp01.tiktokcdn.com,legit,4.00227,4,19,31,0,0.21053,0.12911,4,6,9,9,28,2,0,0,0,2
2649,geo2.adobe.com,legit,3.18201,6,5,14,0,1.2,0.22729,3,0,0,0,3,2,0,0,0,2
2111,1394501235.rsc.cdn77.org,legit,3.88684,1,8,24,0,0.125,0.16195,3,1,0,0,4,1,0,0,0,1
2809,dynamic.tiles.virtualearth.net,legit,3.80624,10,17,30,0,0.58824,0.12687,9,2,0,0,11,8,1,0,0,9
1150,service.idsync.analytics.yahoo.com,legit,3.79998,11,19,34,0,0.57895,0.11176,10,2,1,2,15,6,2,1,0,9
6707,ruqpdqruvorq.ru,dga,2.73957,4,10,15,1,0.4,0.18264,0,0,0,0,0,1,0,0,0,1
3101,3.pool.ntp.org,legit,2.98523,3,7,14,0,0.42857,0.21323,2,0,0,0,2,0,0,0,0,0
5442,bbpkcbecbnfj.com,dga,3.20282,2,13,16,1,0.15385,0.20018,0,0,0,0,0,2,0,0,0,2
2868,publicassets.cdn-apple.com,legit,3.84411,7,16,26,0,0.4375,0.14785,11,4,2,1,18,7,1,0,0,8
8915,lfrgslbgvveljswoxvo.com,dga,3.72945,4,18,23,1,0.22222,0.16215,0,0,0,0,0,2,0,0,0,2
6450,iuaymgokoiuawemq.org,dga,3.58418,10,9,20,1,1.11111,0.17921,0,0,0,0,0,1,0,0,0,1
7506,qegul.eu,dga,2.5,4,3,8,1,1.33333,0.3125,0,0,0,0,0,0,0,0,0,0
2770,p.jwpcdn.com,legit,3.08496,1,9,12,0,0.11111,0.25708,3,1,0,0,4,1,0,0,0,1
3089,cma.itunes.apple.com,legit,3.58418,7,10,20,0,0.7,0.17921,8,4,3,2,17,5,0,0,0,5
3154,www.amazon.de,legit,3.02699,4,7,13,0,0.57143,0.23285,4,1,3,3,11,3,0,0,0,3
3698,office365.com.edgekey.net,legit,3.74928,8,11,25,0,0.72727,0.14997,7,9,6,3,25,6,2,1,0,9
9639,cisoixxfdjjkroltr.me,dga,3.82193,5,14,20,1,0.35714,0.1911,1,0,0,0,1,1,0,0,0,1
9732,ndnldfdabkbalela.eu,dga,3.18137,6,12,19,1,0.5,0.16744,2,0,0,0,2,5,0,0,0,5
899,visitor.omnitagjs.com,legit,3.55852,7,12,21,0,0.58333,0.16945,1,0,0,0,1,7,1,0,0,8
1285,apps.qualys.com,legit,3.37356,4,9,15,0,0.44444,0.2249,3,1,0,0,4,0,0,0,0,0
311,s0.2mdn.net,legit,3.0958,1,6,11,0,0.16667,0.28144,1,0,0,0,1,1,0,0,0,1
6973,kwljcasktpg.com,dga,3.64022,2,12,15,1,0.16667,0.24268,0,0,0,0,0,2,0,0,0,2
7675,hepaudkibemeka.ddns.net,dga,3.62118,8,13,23,1,0.61538,0.15744,2,1,0,0,3,6,4,3,2,15
5932,bmmpontmdkcx.net,dga,3.45282,2,13,16,1,0.15385,0.2158,2,0,0,0,2,1,0,0,0,1
5447,nucqcaatmh.com,dga,3.18201,4,9,14,1,0.44444,0.22729,1,0,0,0,1,2,0,0,0,2
2976,api.taboola.com,legit,3.13957,7,6,15,0,1.16667,0.2093,5,1,1,0,7,2,0,0,0,2
3640,qagpublic.qg2.apps.qualys.com,legit,3.74541,7,17,29,0,0.41176,0.12915,6,2,1,0,9,1,0,0,0,1
8887,1270hybk5iv8.com,dga,4.0,2,7,16,1,0.28571,0.25,0,0,0,0,0,0,0,0,0,0
2499,onenote.com,legit,2.66353,5,5,11,0,1.0,0.24214,3,0,0,0,3,4,1,0,0,5
8118,sqg24y4i4msq.top,dga,3.45282,2,9,16,1,0.22222,0.2158,0,0,0,0,0,0,0,0,0,0
8590,emuxoymhqnganppxid.com,dga,3.87966,6,15,22,1,0.4,0.17635,1,0,0,0,1,2,0,0,0,2
2152,array810.prod.do.dsp.mp.microsoft.com,legit,3.71259,8,20,37,0,0.4,0.10034,12,12,10,9,43,5,2,0,0,7
3094,sc.iasds01.com,legit,3.18201,3,7,14,0,0.42857,0.22729,1,0,0,0,1,1,0,0,0,1
1117,login5.spotify.com,legit,3.68354,5,10,18,0,0.5,0.20464,3,0,0,0,3,2,0,0,0,2
4777,gateway-asset.ce.apple-dns.net,legit,3.57775,9,16,30,0,0.5625,0.11926,12,5,3,2,22,9,3,0,0,12
8172,1nqsebkcyfauqwdcny.net,dga,3.87966,4,16,22,1,0.25,0.17635,1,0,0,0,1,1,0,0,0,1
4459,e5977.dsce9.akamaiedge.net,legit,3.65739,9,9,26,0,1.0,0.14067,8,5,5,3,21,6,0,0,0,6
3392,dart.l.doubleclick.net,legit,3.66353,6,13,22,0,0.46154,0.16652,5,0,0,0,5,5,0,0,0,5
9092,esirukmov.ddns.net,dga,3.61437,5,11,18,1,0.45455,0.2008,3,1,0,0,4,6,3,2,1,12
8269,biteseparateprintdigresolve.com,dga,3.86148,12,18,31,1,0.66667,0.12456,9,0,0,0,9,11,3,0,0,14
3730,wfram-a-1.prod.infra.webex.com,legit,3.92323,8,15,30,0,0.53333,0.13077,6,4,3,2,15,4,2,0,0,6
820,um.simpli.fi,legit,2.85539,4,6,12,0,0.66667,0.23795,2,0,0,0,2,1,0,0,0,1
7978,subcyqpgrsnk.in,dga,3.64022,2,12,15,1,0.16667,0.24268,0,0,0,0,0,1,0,0,0,1
3585,evergage.com,legit,3.02206,5,6,12,0,0.83333,0.25184,2,1,0,0,3,3,1,0,0,4
4733,ravm.tv,legit,2.52164,1,5,7,0,0.2,0.36023,1,0,0,0,1,1,0,0,0,1
5720,fotaqyh.su,dga,3.32193,3,6,10,1,0.5,0.33219,1,0,0,0,1,1,0,0,0,1
1134,inappcheck-lb.itunes-apple.com.akadns.net,legit,3.97329,12,23,41,0,0.52174,0.09691,12,9,9,9,39,10,3,1,0,14
391,scontent.xx.fbcdn.net,legit,3.2728,3,15,21,0,0.2,0.15585,7,3,0,0,10,5,2,0,0,7
4926,godaddy.com.akadns.net,legit,3.48171,6,13,22,0,0.46154,0.15826,5,6,7,7,25,5,3,1,0,9
466,unitedstates.cp.wd.microsoft.com,legit,3.80423,9,19,32,0,0.47368,0.11888,17,8,7,6,38,10,1,0,0,11
2086,a2047.w184.akamai.net,legit,3.6897,6,5,21,0,1.2,0.1757,3,3,4,3,13,2,0,0,0,2
3974,gspe11-ssl.ls.apple.com.edgekey.net,legit,3.73988,8,19,35,0,0.42105,0.10685,11,9,6,4,30,5,2,1,0,8
114,c.lencr.org,legit,2.91398,2,7,11,0,0.28571,0.26491,3,0,0,0,3,2,0,0,0,2
9784,obkuifvsilplkiabcgt.com,dga,3.88205,7,15,23,1,0.46667,0.16878,1,0,0,0,1,1,0,0,0,1
637,me.apple-dns.net,legit,3.32782,4,9,16,0,0.44444,0.20799,7,5,3,2,17,3,1,0,0,4
7480,bdgurpeajwjasjij.eu,dga,3.51109,7,11,19,1,0.63636,0.18479,1,0,0,0,1,2,0,0,0,2
9922,cuugisfe.ddns.net,dga,3.38158,5,10,17,1,0.5,0.19892,3,1,0,0,4,5,4,3,2,14
5086,64mwmoa428uk.top,dga,3.625,4,6,16,1,0.66667,0.22656,0,0,0,0,0,0,0,0,0,0
3635,intl.xiaomi.com,legit,3.1899,6,7,15,0,0.85714,0.21266,3,0,0,0,3,3,0,0,0,3
5686,hltqjjfm.im,dga,3.0958,1,9,11,1,0.11111,0.28144,0,0,0,0,0,0,0,0,0,0
9581,sfjcomvgqavu.tv,dga,3.5899,3,11,15,1,0.27273,0.23933,1,1,0,0,2,2,1,0,0,3
2122,inner-active.mobi,legit,3.57247,7,8,17,0,0.875,0.21015,3,0,0,0,3,6,0,0,0,6
4250,log.pinterest.com,legit,3.61687,5,10,17,0,0.5,0.21276,9,0,0,0,9,6,4,1,0,11
2204,abs-0.twimg.com,legit,3.64022,3,8,15,0,0.375,0.24268,1,0,0,0,1,0,0,0,0,0
9455,rulbbvoggkps.biz,dga,3.57782,3,12,16,1,0.25,0.22361,0,0,0,0,0,0,0,0,0,0
2323,vimeocdn.com,legit,3.08496,4,7,12,0,0.57143,0.25708,2,1,0,0,3,1,0,0,0,1
5181,8i4y4uoa06se.org,dga,3.75,6,4,16,1,1.5,0.23438,1,0,0,0,1,1,0,0,0,1
9580,lmrgygn.org,dga,2.84535,1,9,11,1,0.11111,0.25867,0,0,0,0,0,0,0,0,0,0
1511,rtbhouse.com,legit,3.4183,4,7,12,0,0.57143,0.28486,3,0,0,0,3,1,0,0,0,1
4153,cortana.ai,legit,2.84644,5,4,10,0,1.25,0.28464,2,0,0,0,2,4,0,0,0,4
7624,oyvelxohhcplmvti.eu,dga,3.72161,6,12,19,1,0.5,0.19587,2,0,0,0,2,3,0,0,0,3
4803,smartsheet.com,legit,3.23593,4,9,14,0,0.44444,0.23114,1,0,0,0,1,3,0,0,0,3
7429,jepomix.info,dga,3.25163,5,6,12,1,0.83333,0.27097,1,0,0,0,1,2,0,0,0,2
4632,dynamics.com,legit,3.25163,3,8,12,0,0.375,0.27097,3,1,0,0,4,3,1,0,0,4
1401,js.adsrvr.org,legit,3.02699,2,9,13,0,0.22222,0.23285,4,0,0,0,4,0,0,0,0,0
7587,ecrevfjyfhdfyefokl.com,dga,3.60694,5,16,22,1,0.3125,0.16395,2,0,0,0,2,2,0,0,0,2
1106,dealer.spotify.com,legit,3.83659,6,10,18,0,0.6,0.21314,4,0,0,0,4,5,0,0,0,5
7954,puwnqsaelwe.cc,dga,3.37878,4,9,14,1,0.44444,0.24134,0,0,0,0,0,1,0,0,0,1
1206,fls-na.amazon.com,legit,3.33718,5,9,17,0,0.55556,0.1963,4,1,3,3,11,3,0,0,0,3
4057,youtube.googleapis.com,legit,3.73216,10,10,22,0,1.0,0.16964,7,6,4,4,21,4,0,0,0,4
680,smaato.net,legit,2.92193,4,5,10,0,0.8,0.29219,2,0,0,0,2,2,0,0,0,2
1287,evidon.com,legit,3.12193,4,5,10,0,0.8,0.31219,1,0,0,0,1,1,0,0,0,1
3484,t-0009.fdv2-t-msedge.net,legit,3.62581,3,11,24,0,0.27273,0.15108,3,2,1,0,6,3,0,0,0,3
8555,skgqucquggoocymo.org,dga,3.22193,6,13,20,1,0.46154,0.1611,1,1,0,0,2,0,0,0,0,0
388,api.amazon.com,legit,3.03915,6,6,14,0,1.0,0.21708,6,2,4,3,15,3,0,0,0,3
6242,32gnyngfylol76wn3ho.ddns.net,dga,3.89272,3,18,28,1,0.16667,0.13903,3,1,0,0,4,4,4,3,2,13
8203,contratimneglsualia.com,dga,3.70813,9,13,23,1,0.69231,0.16122,7,1,0,0,8,7,3,0,1,11
1028,pull-hls-f77-va01.tiktokcdn.com,legit,4.26033,5,17,31,0,0.29412,0.13743,4,6,9,9,28,2,0,0,0,2
4377,lg.prod.aadmsa.trafficmanager.net,legit,3.76365,10,19,33,0,0.52632,0.11405,11,7,4,5,27,6,2,0,0,8
4226,io.narrative.io,legit,3.05656,8,5,15,0,1.6,0.20377,3,0,0,0,3,5,1,0,0,6
5007,brothernerveplacebringconsult.com,dga,3.94546,10,22,33,1,0.45455,0.11956,7,1,0,0,8,12,5,1,0,18
1127,a1931.dscgi3.akamai.net,legit,3.70813,7,8,23,0,0.875,0.16122,5,3,4,3,15,3,0,0,0,3
7143,iyyemjrudoui.com,dga,3.375,7,8,16,1,0.875,0.21094,1,0,0,0,1,1,0,0,0,1
986,pull-f5-gcp01.ttlivecdn.com,legit,4.10638,4,16,27,0,0.25,0.15209,4,1,2,1,8,3,0,0,0,3
3819,sxp.smartclip.net,legit,3.61687,3,12,17,0,0.25,0.21276,3,0,0,0,3,2,0,0,0,2
2889,eeroup.com,legit,2.92193,5,4,10,0,1.25,0.29219,3,0,0,0,3,1,0,0,0,1
7060,saovgaadu.ddns.net,dga,3.30827,6,10,18,1,0.6,0.18379,3,1,0,0,4,4,3,3,2,12
231,xp.apple.com,legit,3.02206,3,7,12,0,0.42857,0.25184,6,4,3,2,15,1,0,0,0,1
6219,gicsanse.ru,dga,3.27761,4,6,11,1,0.66667,0.29796,2,0,0,0,2,4,2,0,0,6
5961,fnop.co.nz,dga,2.72193,2,6,10,1,0.33333,0.27219,3,1,0,0,4,1,1,0,0,2
5969,stressclasschipgloveadapt.com,dga,3.7849,8,20,29,1,0.4,0.13051,7,0,0,0,7,7,4,0,0,11
505,spclient.wg.spotify.com,legit,3.79509,5,15,23,0,0.33333,0.165,4,1,0,0,5,2,1,0,0,3
4032,audio-fa.scdn.co,legit,3.375,6,7,16,0,0.85714,0.21094,2,1,0,0,3,1,0,0,0,1
8935,ucibtiuf.ddns.net,dga,3.38158,5,10,17,1,0.5,0.19892,3,1,0,0,4,5,3,2,1,11
7529,lapqgbqfdefnkglk.eu,dga,3.61635,4,14,19,1,0.28571,0.19033,1,0,0,0,1,2,0,0,0,2
9800,xutyzix.info,dga,3.25163,4,7,12,1,0.57143,0.27097,0,0,0,0,0,0,0,0,0,0
4237,dscr.akamai.net,legit,3.45656,5,8,15,0,0.625,0.23044,5,3,4,3,15,2,0,0,0,2
9962,naholdota.com,dga,3.18083,5,7,13,1,0.71429,0.24468,1,0,0,0,1,1,0,0,0,1
1813,cstat.cdn-apple.com,legit,3.57662,4,12,19,0,0.33333,0.18824,10,4,2,1,17,5,0,0,0,5
7267,kefadyn.info,dga,3.25163,4,7,12,1,0.57143,0.27097,1,0,0,0,1,0,1,0,0,1
5246,whpgogekkthau.co.uk,dga,3.47135,6,11,19,1,0.54545,0.1827,3,1,0,0,4,2,1,0,0,3
2450,chipmunk.grammarly.com,legit,3.73216,5,15,22,0,0.33333,0.16964,3,0,0,0,3,4,0,0,0,4
4907,clarity.azurefd.net,legit,3.72161,6,11,19,0,0.54545,0.19587,2,0,0,2,4,5,0,0,0,5
996,pull-f5-vr-va01.tiktokcdn.com,legit,4.21126,5,16,29,0,0.3125,0.14522,4,6,9,9,28,2,0,0,0,2
2056,s-msedge.net,legit,3.02206,3,7,12,0,0.42857,0.25184,3,2,1,0,6,3,0,0,0,3
5057,4mwikqkesykm.net,dga,3.45282,3,11,16,1,0.27273,0.2158,1,0,0,0,1,1,0,0,0,1
9188,cac1lr7a7431sgffn3.net,dga,3.82307,3,11,22,1,0.27273,0.17378,0,0,0,0,0,2,0,0,0,2
6673,3hctqdurwvatqxqfsfw.ddns.net,dga,3.94076,3,22,28,1,0.13636,0.14074,3,1,0,0,4,5,3,3,2,13
4414,alt8-mtalk.google.com,legit,3.46328,6,11,21,0,0.54545,0.16492,3,5,4,3,15,2,0,0,0,2
6870,wjcigqrori.com,dga,3.23593,4,9,14,1,0.44444,0.23114,1,0,0,0,1,2,0,0,0,2
1518,media6degrees.com,legit,3.38158,7,8,17,0,0.875,0.19892,3,0,0,0,3,4,0,0,0,4
7159,gsrwnwnxjidrjnio.jp,dga,3.43162,3,15,19,1,0.2,0.18061,0,0,0,0,0,1,0,0,0,1
4468,cs-rtb.minutemedia-prebid.com,legit,3.88334,9,16,29,0,0.5625,0.13391,7,1,0,0,8,6,0,0,0,6
4416,downloads.hpdaas.com,legit,3.40869,6,12,20,0,0.5,0.17043,4,0,0,0,4,1,0,0,0,1
2743,2.pool.ntp.org,legit,2.98523,3,7,14,0,0.42857,0.21323,2,0,0,0,2,0,0,0,0,0
9881,dansdivitiasimai.com,dga,3.2037,9,10,20,1,0.9,0.16018,2,0,0,0,2,7,1,0,0,8
5868,peywyvbyghfqnutxyhfo.cc,dga,3.91487,3,19,23,1,0.15789,0.17021,0,0,0,0,0,0,0,0,0,0
3278,wpc.v0cdn.net,legit,3.2389,1,9,13,0,0.11111,0.24915,2,1,0,0,3,1,0,0,0,1
4591,eloqua.com,legit,3.12193,5,4,10,0,1.25,0.31219,1,0,0,0,1,1,0,0,0,1
6572,umwbdcbulhzfvu.com,dga,3.57243,4,13,18,1,0.30769,0.19847,0,0,0,0,0,0,0,0,0,0
85,gateway.icloud.com,legit,3.72548,7,9,18,0,0.77778,0.20697,5,3,2,1,11,3,1,0,0,4
7893,utibwde6s0s0ev16yno23js.ddns.net,dga,4.05423,6,17,32,1,0.35294,0.12669,4,1,0,0,5,6,3,3,2,14
6020,qaqoplffwkrrwbdjh.me,dga,3.92193,3,16,20,1,0.1875,0.1961,1,0,0,0,1,0,0,0,0,0
8266,jsoyeijbgcgpmu.co.uk,dga,3.72193,6,12,20,1,0.5,0.1861,2,1,0,0,3,1,1,0,0,2
6790,fdkxjbncpscllksbjn.com,dga,3.69785,1,20,22,1,0.05,0.16808,0,0,0,0,0,0,0,0,0,0
714,rfihub.com,legit,3.32193,3,6,10,0,0.5,0.33219,0,0,0,0,0,0,0,0,0,0
7485,middledollar.net,dga,3.28064,5,10,16,1,0.5,0.20504,3,0,0,0,3,6,0,0,0,6
9775,efhuaxsocoawx.ddns.net,dga,3.73216,7,13,22,1,0.53846,0.16964,3,1,0,0,4,5,3,2,1,11
7801,qbwpqnixoten.ru,dga,3.64022,4,10,15,1,0.4,0.24268,2,0,0,0,2,3,0,0,0,3
2666,networksdk.ssacdn.com,legit,3.59447,4,15,21,0,0.26667,0.17117,2,1,0,0,3,5,0,0,0,5
4062,hscollectedforms.net,legit,3.58418,5,14,20,0,0.35714,0.17921,4,0,0,0,4,6,0,0,0,6
4921,tm.prd.ags.akadns.net,legit,3.40399,4,13,21,0,0.30769,0.16209,6,4,4,3,17,2,1,0,0,3
4163,mcusercontent.com,legit,3.21953,5,11,17,0,0.45455,0.18938,8,3,0,0,11,6,3,0,0,9
4824,odin.adobe.com,legit,3.18201,6,6,14,0,1.0,0.22729,3,0,0,0,3,2,0,0,0,2
4268,onedscolprduks00.uksouth.cloudapp.azure.com,legit,3.97885,14,23,43,0,0.6087,0.09253,13,4,3,4,24,5,1,0,0,6
3721,rayjump.com,legit,3.27761,3,7,11,0,0.42857,0.29796,1,0,0,0,1,1,0,0,0,1
4202,network-a.bazaarvoice.com,legit,3.81366,10,12,25,0,0.83333,0.15255,2,1,0,0,3,6,0,0,0,6
7091,rrfqdmdshbmvfp.com,dga,3.57243,1,16,18,1,0.0625,0.19847,1,0,0,0,1,0,0,0,0,0
37,partner.netflix.net,legit,3.28663,5,12,19,0,0.41667,0.17298,2,0,0,0,2,4,0,0,0,4
3444,tnc16-platform-alisg.tiktokv.com,legit,4.10141,7,19,32,0,0.36842,0.12817,5,5,4,3,17,5,0,0,0,5
8032,qekuveg.info,dga,3.4183,5,6,12,1,0.83333,0.28486,0,0,0,0,0,1,0,0,0,1
1202,spectrum.s3.amazonaws.com,legit,3.72307,7,14,25,0,0.5,0.14892,4,1,3,3,11,4,0,0,0,4
2767,gopher-buddy-prod.appspot.com,legit,3.81093,7,18,29,0,0.38889,0.13141,7,5,3,1,16,2,2,0,0,4
9601,static-indication.mx,dga,3.38418,7,11,20,1,0.63636,0.16921,7,0,0,0,7,9,3,2,1,15
9243,cecoirefdo.ddns.net,dga,3.32636,6,11,19,1,0.54545,0.17507,5,1,0,0,6,8,4,3,2,17
7185,y868gshgnlrh3mqwjt.net,dga,4.00489,1,16,22,1,0.0625,0.18204,0,0,0,0,0,0,0,0,0,0
3480,s.skimresources.com,legit,3.1953,6,11,19,0,0.54545,0.16817,5,0,0,0,5,3,1,0,0,4
7400,zszmic.gd,dga,2.9477,1,7,9,1,0.14286,0.32752,2,1,0,0,3,2,0,0,0,2
1283,dsum.casalemedia.com,legit,3.34644,8,10,20,0,0.8,0.16732,4,0,0,0,4,6,0,0,0,6
7220,iuwyuescqakukawk.org,dga,3.64644,8,11,20,1,0.72727,0.18232,1,0,0,0,1,1,0,0,0,1
7464,bssmellhdxoq.biz,dga,3.625,3,12,16,1,0.25,0.22656,0,0,0,0,0,1,0,0,0,1
4487,yusercontent.com,legit,3.375,5,10,16,0,0.5,0.21094,8,3,0,0,11,6,3,0,0,9
9517,heikacdrlfsmldxbosh.com,dga,3.91487,5,17,23,1,0.29412,0.17021,1,0,0,0,1,1,0,0,0,1
6464,ofreerak.ddns.net,dga,3.33718,5,10,17,1,0.5,0.1963,6,1,0,0,7,7,3,2,2,14
5711,rylohyv.info,dga,3.25163,3,8,12,1,0.375,0.27097,1,0,0,0,1,0,0,0,0,0
2546,pixel.wp.com,legit,3.25163,3,7,12,0,0.42857,0.27097,1,0,0,0,1,1,0,0,0,1
9785,haftxflbpdcvharpkt.com,dga,3.91398,3,18,22,1,0.16667,0.17791,0,0,0,0,0,1,0,0,0,1
7001,uwfanudela.ddns.net,dga,3.32636,6,11,19,1,0.54545,0.17507,2,1,0,0,3,8,4,3,2,17
919,comm-cohort.ess.apple.com,legit,3.51327,7,14,25,0,0.5,0.14053,8,5,3,2,18,5,2,0,0,7
8239,qypghhkksjui.com,dga,3.75,3,12,16,1,0.25,0.23438,0,0,0,0,0,0,0,0,0,0
36,netflix.net,legit,2.91398,3,7,11,0,0.42857,0.26491,1,0,0,0,1,2,0,0,0,2
8134,vncapuaxpz.biz,dga,3.37878,4,9,14,1,0.44444,0.24134,1,0,0,0,1,1,0,0,0,1
6054,thesmagnificamchristi.com,dga,3.62347,8,16,25,1,0.5,0.14494,6,1,0,0,7,10,2,0,2,14
4650,hpanalytics.net,legit,3.50689,4,10,15,0,0.4,0.23379,2,0,0,0,2,3,0,0,0,3
3913,tag-logger.demandbase.com,legit,3.75327,8,14,25,0,0.57143,0.15013,7,0,0,0,7,11,1,0,0,12
9542,w2kx1l3v7t7nwneba6mdsf7.ddns.net,dga,4.14032,3,20,32,1,0.15,0.12938,3,1,0,0,4,5,3,3,2,13
9536,bataddgloveangledisappointed.com,dga,3.82782,12,19,32,1,0.63158,0.11962,12,2,0,0,14,11,1,1,0,13
3375,px.quantserve.com,legit,3.85217,5,10,17,0,0.5,0.2266,3,1,1,0,5,4,2,1,0,7
9797,twelveuntil.net,dga,3.00624,5,9,15,1,0.55556,0.20042,2,0,0,0,2,3,0,0,0,3
1307,c.evidon.com,legit,3.08496,4,6,12,0,0.66667,0.25708,1,0,0,0,1,1,0,0,0,1
1030,eyeota.net,legit,2.64644,5,4,10,0,1.25,0.26464,1,0,0,0,1,1,0,0,0,1
8381,grwnxqzqc.com.pr,dga,3.5,1,13,16,1,0.07692,0.21875,2,2,1,0,5,2,2,1,0,5
9620,registerlockpracticepossess.com,dga,3.56325,10,20,31,1,0.5,0.11494,12,1,0,0,13,12,3,0,0,15
7739,uywbzdluk.tv,dga,3.4183,2,9,12,1,0.22222,0.28486,0,0,0,0,0,0,0,0,0,0
8233,vydftxyqzwaihhil.com,dga,4.02193,4,15,20,1,0.26667,0.2011,0,0,0,0,0,0,0,0,0,0
5904,lufegware.com,dga,3.54659,5,7,13,1,0.71429,0.27281,1,0,0,0,1,2,0,0,0,2
7706,hmeolbtlojdjgxmw.eu,dga,3.72161,5,13,19,1,0.38462,0.19587,1,0,0,0,1,0,0,0,0,0
3140,prod.dradis.netflix.com,legit,3.84922,6,14,23,0,0.42857,0.16736,8,3,2,1,14,5,1,0,0,6
7432,ruiygrbclyip.com,dga,3.5,4,11,16,1,0.36364,0.21875,0,0,0,0,0,0,0,0,0,0
9755,yunooehnfdwxjf.co.uk,dga,3.68418,6,12,20,1,0.5,0.18421,3,1,0,0,4,1,1,0,0,2
7352,zxmgoduq.com.pt,dga,3.50689,3,10,15,1,0.3,0.23379,2,2,1,0,5,2,2,1,0,5
2157,nist.gov,legit,3.0,2,5,8,0,0.4,0.375,1,0,0,0,1,3,1,0,0,4
7158,hpxfjytirajrdpiu.eu,dga,3.72161,6,12,19,1,0.5,0.19587,3,0,0,0,3,2,0,0,0,2
7985,ullefugna.com,dga,3.39275,5,7,13,1,0.71429,0.26098,1,0,0,0,1,1,0,0,0,1
8769,ryneryv.info,dga,3.08496,3,8,12,1,0.375,0.25708,1,0,0,0,1,2,0,0,0,2
1145,fmfmobile.fe.apple-dns.net,legit,3.71929,7,15,26,0,0.46667,0.14305,7,5,3,2,17,3,1,0,0,4
9478,tupdeote.ru,dga,2.91398,5,5,11,1,1.0,0.26491,1,0,0,0,1,2,0,0,0,2
5157,lbhqdifox.org,dga,3.54659,3,9,13,1,0.33333,0.27281,0,0,0,0,0,0,0,0,0,0
6344,k8o4yhodsta4k8k.ddns.net,dga,3.60539,4,14,24,1,0.28571,0.15022,5,1,0,0,6,6,3,2,2,13
3082,mon.isnssdk.com,legit,3.05656,3,10,15,0,0.3,0.20377,1,0,0,0,1,3,0,0,0,3
7069,huwemdor.com,dga,3.25163,4,7,12,1,0.57143,0.27097,0,0,0,0,0,2,0,0,0,2
9549,iureestcrefactum.com,dga,3.44644,8,11,20,1,0.72727,0.17232,4,0,0,0,4,4,1,0,0,5
4044,amplify-imp.outbrain.com,legit,3.85539,8,13,24,0,0.61538,0.16064,7,0,0,0,7,3,0,0,0,3
8732,uowslaiq.net,dga,3.58496,5,6,12,1,0.83333,0.29875,0,0,0,0,0,1,0,0,0,1
6949,hewitlahw.com,dga,3.39275,4,8,13,1,0.5,0.26098,0,0,0,0,0,2,0,0,0,2
7856,xubyqen.info,dga,3.4183,4,7,12,1,0.57143,0.28486,1,0,0,0,1,1,0,0,0,1
5837,pwmpbqaajxosrvrqd.cc,dga,3.82193,3,16,20,1,0.1875,0.1911,0,0,0,0,0,0,0,0,0,0
7194,dgceiacljj.cx,dga,3.18083,3,9,13,1,0.33333,0.24468,1,0,0,0,1,2,0,0,0,2
8703,gkyuoaiq.biz,dga,3.4183,5,6,12,1,0.83333,0.28486,0,0,0,0,0,0,0,0,0,0
4358,friend.gc.apple.com,legit,3.68188,5,11,19,0,0.45455,0.19378,7,4,3,2,16,4,0,0,0,4
8318,dnsdehnb.ir,dga,3.0958,2,8,11,1,0.25,0.28144,1,1,0,0,2,3,1,0,0,4
4257,eventlog.outbrain.com,legit,3.78494,8,11,21,0,0.72727,0.18024,6,1,0,0,7,4,1,0,0,5
8473,seojupla.ru,dga,3.27761,5,5,11,1,1.0,0.29796,2,0,0,0,2,2,0,0,0,2
5638,kimberleemarianne.net,dga,3.2321,9,11,21,1,0.81818,0.15391,3,0,0,0,3,9,0,0,0,9
5347,junoxwodcvjg.biz,dga,3.75,4,11,16,1,0.36364,0.23438,0,0,0,0,0,0,0,0,0,0
7765,degreesafety.net,dga,3.1494,6,9,16,1,0.66667,0.19684,2,0,0,0,2,4,0,0,0,4
9046,xlxwjtlwtdokowdzyr.com,dga,3.66353,3,18,22,1,0.16667,0.16652,0,0,0,0,0,0,0,0,0,0
5117,wuhpzndzn.dyndns.org,dga,3.48418,2,16,20,1,0.125,0.17421,2,1,0,0,3,4,3,4,3,14
7685,bankringadmirelipintendcrew.com,dga,3.87324,10,20,31,1,0.5,0.12494,10,0,0,0,10,9,2,1,0,12
9146,jftgbeqpcoje.biz,dga,3.625,4,11,16,1,0.36364,0.22656,1,0,0,0,1,2,0,0,0,2
1052,mediago.io,legit,2.92193,6,3,10,0,2.0,0.29219,1,0,0,0,1,1,0,0,0,1
5557,centumfaciunt.com,dga,3.33718,6,10,17,1,0.6,0.1963,3,1,0,0,4,3,1,0,0,4
6175,7lobfk7cflmcrf465c.cn,dga,3.59447,1,14,21,1,0.07143,0.17117,2,0,0,0,2,0,0,0,0,0
8973,yversldecbexyixxx.tw,dga,3.58418,4,15,20,1,0.26667,0.17921,1,0,0,0,1,5,3,0,0,8
2696,onedscolprdeus08.eastus.cloudapp.azure.com,legit,3.89185,15,21,42,0,0.71429,0.09266,17,5,3,4,29,9,1,0,0,10
9605,gugweytg.ms,dga,3.02717,2,8,11,1,0.25,0.2752,0,0,0,0,0,0,0,0,0,0
9048,tnbegcn.com,dga,3.0958,2,8,11,1,0.25,0.28144,0,0,0,0,0,1,0,0,0,1
4082,pixel.33across.com,legit,3.61437,5,9,18,0,0.55556,0.2008,3,2,1,0,6,2,0,0,0,2
3592,www.onenote.com,legit,2.87291,5,8,15,0,0.625,0.19153,3,0,0,0,3,4,1,0,0,5
3436,direct.adsrvr.org,legit,3.38158,4,11,17,0,0.36364,0.19892,4,0,0,0,4,2,0,0,0,2
2411,edgecastdns.net,legit,3.05656,4,10,15,0,0.4,0.20377,4,4,1,0,9,8,1,0,0,9
8437,kpgrttuldobhrtaxe.net,dga,3.82089,5,15,21,1,0.33333,0.18195,1,0,0,0,1,1,0,0,0,1
4329,p-static.bing.trafficmanager.net,legit,3.74173,9,19,32,0,0.47368,0.11693,11,3,1,3,18,11,3,0,0,14
2029,vidoomy.com,legit,2.84535,4,6,11,0,0.66667,0.25867,1,0,0,0,1,1,0,0,0,1
2585,svastx.moatads.com,legit,3.19716,5,11,18,0,0.45455,0.17762,6,1,0,0,7,4,0,0,0,4
6070,myyikwyiuucyywug.org,dga,3.2037,6,13,20,1,0.46154,0.16018,0,0,0,0,0,0,0,0,0,0
744,metaservices.microsoft.com,legit,3.47835,9,15,26,0,0.6,0.13378,12,10,8,7,37,9,2,1,0,12
1990,baidu.com,legit,3.16993,4,4,9,0,1.0,0.35221,0,0,0,0,0,0,0,0,0,0
664,fs.microsoft.com,legit,3.07782,4,10,16,0,0.4,0.19236,7,8,7,6,28,2,0,0,0,2
5912,iuuaiwoeucuegsgy.org,dga,3.38418,11,8,20,1,1.375,0.16921,0,0,0,0,0,0,0,0,0,0
7988,jizfrmvmulmntge165.ru,dga,3.97542,4,13,21,1,0.30769,0.18931,2,0,0,0,2,1,0,0,0,1
6614,dqvinifox.cc,dga,3.25163,3,8,12,1,0.375,0.27097,1,0,0,0,1,2,0,0,0,2
7512,unvohebudoi.ddns.net,dga,3.44644,7,11,20,1,0.63636,0.17232,2,1,0,0,3,4,4,3,2,13
1251,4dex.io,legit,2.80735,3,2,7,0,1.5,0.40105,0,0,0,0,0,1,0,0,0,1
7481,qqjwsqnwmemjdhj.biz,dga,3.53689,2,16,19,1,0.125,0.18615,0,0,0,0,0,1,0,0,0,1
8393,bpnjqvispebyd.com,dga,3.85217,3,13,17,1,0.23077,0.2266,0,0,0,0,0,1,0,0,0,1
6880,galupu.info,dga,3.27761,5,5,11,1,1.0,0.29796,0,0,0,0,0,0,0,0,0,0
7249,oankikdtwehhrecqs.com,dga,3.91613,6,14,21,1,0.42857,0.18648,1,0,0,0,1,3,0,0,0,3
5024,svneascvmk.mooo.com,dga,3.15557,6,11,19,1,0.54545,0.16608,3,0,0,0,3,3,1,2,1,7
6568,fyyqqdrihseaeixy.eu,dga,3.53689,7,11,19,1,0.63636,0.18615,2,0,0,0,2,3,0,0,0,3
5806,jxqtupnmsmknn.info,dga,3.61437,3,14,18,1,0.21429,0.2008,0,0,0,0,0,0,0,0,0,0
939,pull-q5-va01.tiktokcdn.com,legit,4.16198,5,14,26,0,0.35714,0.16008,4,6,9,9,28,2,0,0,0,2
9391,werkepurgasecurus.com,dga,3.52257,8,12,21,1,0.66667,0.16774,3,0,0,0,3,4,0,0,0,4
5536,lkcpohufseco.com,dga,3.40564,5,10,16,1,0.5,0.21285,2,0,0,0,2,3,0,0,0,3
2855,urlp.asm.skype.com,legit,3.57243,4,11,18,0,0.36364,0.19847,2,0,0,0,2,1,0,0,0,1
4673,an.yandex.ru,legit,3.08496,4,6,12,0,0.66667,0.25708,0,0,0,0,0,3,1,0,0,4
2679,zopim.com,legit,2.72548,3,5,9,0,0.6,0.30283,1,0,0,0,1,0,0,0,0,0
7291,bvbwqjdkfaj.com,dga,3.64022,2,12,15,1,0.16667,0.24268,0,0,0,0,0,0,0,0,0,0
6017,ehafkfvej.ki,dga,3.08496,4,7,12,1,0.57143,0.25708,0,0,0,0,0,1,0,0,0,1
8992,xjfbxkn.org,dga,3.27761,1,9,11,1,0.11111,0.29796,0,0,0,0,0,0,0,0,0,0
2348,api-js.mixpanel.com,legit,3.72161,6,10,19,0,0.6,0.19587,5,2,0,0,7,4,0,0,0,4
6608,iajwwuyhxwrbpsvsusutx.me,dga,3.90727,6,17,24,1,0.35294,0.1628,1,0,0,0,1,1,0,0,0,1
2563,atlas.samsung.com,legit,3.29277,5,10,17,0,0.5,0.19369,3,0,0,0,3,5,0,0,0,5
4040,aadcdn.msftauthimages.net,legit,3.65366,8,15,25,0,0.53333,0.14615,8,3,1,0,12,5,0,0,0,5
1022,pull-cmaf-f16-sg01.ttlivecdn.com,legit,4.24173,5,18,32,0,0.27778,0.13255,5,1,2,1,9,4,0,0,0,4
2320,admixer.net,legit,3.27761,4,6,11,0,0.66667,0.29796,3,0,0,0,3,2,0,0,0,2
3146,ds.reson8.com,legit,3.2389,3,7,13,0,0.42857,0.24915,5,0,0,0,5,3,1,0,0,4
1037,st.pubmatic.com,legit,3.37356,4,9,15,0,0.44444,0.2249,5,0,0,0,5,5,1,0,0,6
2247,16-courier.push.apple.com,legit,3.86347,8,11,25,0,0.72727,0.15454,9,4,3,2,18,4,0,0,0,4
3736,pull-flv-l11-gcp01.tiktokcdn.com,legit,3.99173,4,19,32,0,0.21053,0.12474,4,6,9,9,28,2,0,0,0,2
2144,public-prod-dspcookiematching.dmxleo.com,legit,4.1562,12,24,40,0,0.5,0.1039,12,2,1,0,15,8,2,0,0,10
3202,logs.ironsrc.mobi,legit,3.33718,5,10,17,0,0.5,0.1963,4,0,0,0,4,2,0,0,0,2
1860,www3.l.google.com,legit,3.01307,4,9,17,0,0.44444,0.17724,2,5,4,3,14,1,0,0,0,1
6218,osdefagwiri.com,dga,3.64022,6,8,15,1,0.75,0.24268,0,0,0,0,0,2,0,0,0,2
8860,tools-drawings.xyz,dga,3.9477,4,12,18,1,0.33333,0.21932,3,0,0,0,3,2,1,0,0,3
9296,pqakfsfox.cc,dga,3.25163,2,9,12,1,0.22222,0.27097,0,0,0,0,0,0,0,0,0,0
2004,sophos.com,legit,2.64644,3,6,10,0,0.5,0.26464,0,0,0,0,0,0,0,0,0,0
7149,dkrurkn.cc,dga,2.72193,1,8,10,1,0.125,0.27219,0,0,0,0,0,0,0,0,0,0
6954,banwozdi.ru,dga,3.45943,4,6,11,1,0.66667,0.31449,0,0,0,0,0,1,0,0,0,1
2341,array510.prod.do.dsp.mp.microsoft.com,legit,3.71259,8,20,37,0,0.4,0.10034,12,12,10,9,43,5,2,0,0,7
4000,piano.io,legit,2.5,5,2,8,0,2.5,0.3125,1,0,0,0,1,1,0,0,0,1
1195,services.bingapis.com,legit,3.65376,7,12,21,0,0.58333,0.17399,9,3,1,1,14,7,3,1,0,11
2785,aax-us-east-retail-direct.amazon.com,legit,3.86383,14,16,36,0,0.875,0.10733,9,2,3,3,17,10,0,0,0,10
5953,ruxfodir.ru,dga,2.84535,4,6,11,1,0.66667,0.25867,0,0,0,0,0,0,0,0,0,0
342,cdn.jsdelivr.net,legit,3.5,3,11,16,0,0.27273,0.21875,3,2,1,0,6,3,0,0,0,3
6556,livingcelebratefanreward.com,dga,3.89629,10,17,28,1,0.58824,0.13915,8,0,0,0,8,10,2,0,0,12
890,sc.omtrdc.net,legit,3.2389,2,9,13,0,0.22222,0.24915,0,0,0,0,0,1,0,0,0,1
8854,mfmcbofoflbdddal.de,dga,3.15557,4,14,19,1,0.28571,0.16608,1,0,0,0,1,1,0,0,0,1
8215,awitsurni.com,dga,3.54659,5,7,13,1,0.71429,0.27281,0,0,0,0,0,3,0,0,0,3
6691,fxjtn50gsduozoqlzjtl68fuauexaxkqj56.ru,dga,4.31346,9,22,38,1,0.40909,0.11351,0,0,0,0,0,0,0,0,0,0
9085,ixmupspkppwvzk.com,dga,3.50326,3,14,18,1,0.21429,0.19463,1,0,0,0,1,0,0,0,0,0
8046,yyuj.li,dga,2.52164,2,4,7,1,0.5,0.36023,0,0,0,0,0,0,0,0,0,0
9412,mbxbrfipyiih.so,dga,3.45656,4,10,15,1,0.4,0.23044,0,0,0,0,0,0,0,0,0,0
82,do.dsp.mp.microsoft.com,legit,3.27335,5,14,23,0,0.35714,0.14232,9,8,7,7,31,3,1,0,0,4
5946,elucidandepeconfidant.com,dga,3.64307,10,14,25,1,0.71429,0.14572,3,1,0,0,4,7,2,0,0,9
9314,uoooemsgcqwmiewy.org,dga,3.52193,8,11,20,1,0.72727,0.1761,2,0,0,0,2,2,1,0,0,3
155,ocsp2.apple.com,legit,3.1899,4,8,15,0,0.5,0.21266,5,4,3,2,14,1,0,0,0,1
6662,sda4g2s4opa4gve.ddns.net,dga,3.57393,5,13,24,1,0.38462,0.14891,3,1,0,0,4,5,4,3,2,14
8463,vssxhkffxcoy.com,dga,3.375,2,13,16,1,0.15385,0.21094,1,0,0,0,1,1,0,0,0,1
8548,gooiarociurup.com,dga,3.14629,9,7,17,1,1.28571,0.18508,2,1,0,0,3,1,0,0,0,1
5378,lyrywir.com,dga,3.0958,2,8,11,1,0.25,0.28144,0,0,0,0,0,0,0,0,0,0
7724,ewafsucgo.com,dga,3.39275,5,7,13,1,0.71429,0.26098,0,0,0,0,0,1,0,0,0,1
8286,q4icmwi8y4uk.org,dga,3.75,4,8,16,1,0.5,0.23438,1,0,0,0,1,1,0,0,0,1
3112,t.contentsquare.net,legit,3.2211,6,11,19,0,0.54545,0.16953,7,3,0,0,10,6,3,0,0,9
5105,itveleamncuiusconcio.com,dga,3.52206,11,12,24,1,0.91667,0.14675,6,1,0,0,7,8,1,0,0,9
5593,swingersobtained.tel,dga,3.68418,7,12,20,1,0.58333,0.18421,5,0,0,0,5,6,3,0,0,9
8804,usbmsyeoya.net,dga,3.37878,5,8,14,1,0.625,0.24134,1,0,0,0,1,0,0,1,0,1
1609,ras.yahoo.com,legit,3.02699,5,6,13,0,0.83333,0.23285,3,0,0,1,4,2,0,0,0,2
5294,elernufdorg.com,dga,3.50689,5,9,15,1,0.55556,0.23379,2,0,0,0,2,4,0,0,0,4
873,typekit.com,legit,3.27761,3,7,11,0,0.42857,0.29796,0,0,0,0,0,1,0,0,0,1
7858,upahqelatem.ddns.net,dga,3.58418,6,12,20,1,0.5,0.17921,4,1,0,0,5,9,4,2,2,17
9693,ywfffevekkudirfoj.su,dga,3.62193,6,13,20,1,0.46154,0.1811,0,0,0,0,0,1,0,0,0,1
2607,www.expedia.com,legit,3.32323,5,8,15,0,0.625,0.22155,1,0,0,0,1,1,0,0,0,1
2968,a.rfihub.com,legit,3.4183,4,6,12,0,0.66667,0.28486,0,0,0,0,0,0,0,0,0,0
8440,avfve51buj56mxb38iqavjupxh14cwdxkrnu.com,dga,4.61531,8,23,40,1,0.34783,0.11538,0,0,0,0,0,1,0,0,0,1
7329,nldzfqge.dyndns.org,dga,3.53689,2,15,19,1,0.13333,0.18615,4,1,0,0,5,5,4,4,3,16
171,ad.doubleclick.net,legit,3.61437,6,10,18,0,0.6,0.2008,7,0,0,0,7,4,0,0,0,4
8142,iamanniversaria.com,dga,3.26083,9,9,19,1,1.0,0.17162,3,1,0,0,4,8,2,0,0,10
3767,youtube-nocookie.com,legit,3.44145,10,8,20,0,1.25,0.17207,3,0,0,0,3,2,0,0,0,2
4530,hostedrmm.com,legit,3.18083,3,9,13,0,0.33333,0.24468,3,0,0,0,3,3,0,0,0,3
2134,widget.intercom.io,legit,3.46132,7,9,18,0,0.77778,0.1923,6,2,0,0,8,7,2,1,0,10
4944,t.eloqua.com,legit,3.25163,5,5,12,0,1.0,0.27097,1,0,0,0,1,1,0,0,0,1
6095,occaqoessiucsmyo.org,dga,3.44644,8,11,20,1,0.72727,0.17232,1,0,0,0,1,3,1,0,0,4
8645,syhlxxjru.net,dga,3.54659,2,10,13,1,0.2,0.27281,0,0,0,0,0,0,0,0,0,0
148,fbcdn.net,legit,2.9477,1,7,9,0,0.14286,0.32752,2,1,0,0,3,1,0,0,0,1
169,browser.events.data.microsoft.com,legit,3.80138,10,19,33,0,0.52632,0.11519,14,10,7,6,37,9,2,0,0,11
3869,serverbid.com,legit,3.39275,4,8,13,0,0.5,0.26098,2,1,1,0,4,3,3,1,0,7
4923,sqs.us-east-1.amazonaws.com,legit,3.63028,8,13,27,0,0.61538,0.13445,8,2,3,3,16,6,0,0,0,6
6645,peacanda.ru,dga,3.02717,5,5,11,1,1.0,0.2752,1,0,0,0,1,5,1,0,0,6
4200,mcs2-cloudstation-us-east-2.prod.hydra.sophos.com,legit,4.02208,13,26,49,0,0.5,0.08208,14,8,5,3,30,8,4,2,1,15
3666,en.wikipedia.org,legit,3.45282,7,7,16,0,1.0,0.2158,2,0,0,0,2,2,0,0,0,2
9899,cmwfs.fr,dga,2.75,0,7,8,1,0.0,0.34375,0,0,0,0,0,0,0,0,0,0
2766,iad-03.braze.com,legit,3.75,5,6,16,0,0.83333,0.23438,2,0,0,0,2,1,0,0,0,1
5577,nomaberusole.ddns.net,dga,3.55852,7,12,21,1,0.58333,0.16945,7,1,0,0,8,9,4,3,2,18
7413,qeibavea.ru,dga,3.0958,6,4,11,1,1.5,0.28144,1,0,0,0,1,2,0,0,0,2
8129,tqmipwmhf.com,dga,3.33468,2,10,13,1,0.2,0.25651,1,0,0,0,1,1,0,0,0,1
1302,www.yahoo.com,legit,2.81507,4,7,13,0,0.57143,0.21654,1,0,0,1,2,0,0,0,0,0
1560,clever.com,legit,2.92193,3,6,10,0,0.5,0.29219,2,0,0,0,2,3,1,0,0,4
9526,cgsqqaiugkeq.info,dga,3.57247,6,10,17,1,0.6,0.21015,0,0,0,0,0,0,0,3,2,5
9272,jacquelinepettigrew.net,dga,3.63815,9,13,23,1,0.69231,0.15818,4,0,0,0,4,7,1,0,0,8
6580,toafbeasireh.ddns.net,dga,3.59447,7,12,21,1,0.58333,0.17117,4,1,0,0,5,9,3,2,2,16
1035,unagi-na.amazon.com,legit,3.26083,8,8,19,0,1.0,0.17162,4,1,3,3,11,3,0,0,0,3
1485,amp-api.apps.apple.com,legit,3.08377,7,11,22,0,0.63636,0.14017,8,5,4,2,19,2,0,0,0,2
4652,digitalassetlinks.googleapis.com,legit,3.71814,12,18,32,0,0.66667,0.11619,10,6,4,4,24,10,2,0,0,12
8646,ofqwvtzsc.tv,dga,3.25163,1,10,12,1,0.1,0.27097,1,0,0,0,1,0,0,0,0,0
2993,iasds01.com,legit,3.27761,3,5,11,0,0.6,0.29796,1,0,0,0,1,1,0,0,0,1
7011,qoqsakuh.ru,dga,3.0958,4,6,11,1,0.66667,0.28144,0,0,0,0,0,0,0,0,0,0
3535,mon15-normal-useast1a.tiktokv.com,legit,4.00607,10,16,33,0,0.625,0.1214,8,6,4,3,21,8,0,0,0,8
8726,nuahbomitod.ddns.net,dga,3.54644,6,12,20,1,0.5,0.17732,4,2,0,0,6,7,3,2,1,13
9682,jrp2t68v4fpn4n741u.biz,dga,4.06148,2,11,22,1,0.18182,0.18461,0,0,0,0,0,0,0,0,0,0
1245,core.bdec.microsoft.com,legit,3.36031,7,13,23,0,0.53846,0.1461,9,8,7,6,30,7,0,0,0,7
6341,zztmz66nh1kyakdpqv.net,dga,3.87966,2,16,22,1,0.125,0.17635,0,0,0,0,0,0,0,0,0,0
7371,hcluflcssyfp.com,dga,3.32782,2,13,16,1,0.15385,0.20799,0,0,0,0,0,0,0,0,0,0
8614,eimsmymkuqkgsysq.org,dga,3.44644,4,15,20,1,0.26667,0.17232,0,0,0,0,0,0,0,0,0,0
2050,array813.prod.do.dsp.mp.microsoft.com,legit,3.71259,8,20,37,0,0.4,0.10034,12,12,10,9,43,5,2,0,0,7
7557,kyppgkodpsereccle.su,dga,3.54644,5,14,20,1,0.35714,0.17732,5,1,0,0,6,5,2,0,0,7
1520,clients.l.google.com,legit,3.30869,6,11,20,0,0.54545,0.16543,6,6,4,3,19,2,1,0,0,3
1388,segments.company-target.com,legit,3.70805,7,17,27,0,0.41176,0.13734,8,3,1,0,12,9,3,1,0,13
785,sonobi.com,legit,2.84644,4,5,10,0,0.8,0.28464,1,0,0,0,1,1,0,0,0,1
6236,vwdwhhonkcfl.biz,dga,3.75,2,13,16,1,0.15385,0.23438,1,0,0,0,1,1,0,0,0,1
5876,qnipduksxumpbveiq.com,dga,3.91613,6,14,21,1,0.42857,0.18648,0,0,0,0,0,2,0,0,0,2
3891,parrable.com,legit,3.25163,4,7,12,0,0.57143,0.27097,2,0,0,0,2,3,0,0,0,3
7419,kfkchwnansnan.org,dga,3.38158,3,13,17,1,0.23077,0.19892,0,0,0,0,0,2,2,4,3,11
6886,christusdeisunttenentur.com,dga,3.53194,9,17,27,1,0.52941,0.13081,5,1,0,0,6,8,4,0,2,14
7265,voychehj.cc,dga,2.84535,2,8,11,1,0.25,0.25867,0,0,0,0,0,0,0,0,0,0
500,tiktokcdn.com,legit,3.08506,3,9,13,0,0.33333,0.23731,3,5,6,5,19,2,0,0,0,2
4251,exp-tas.com,legit,3.45943,3,6,11,0,0.5,0.31449,1,0,0,0,1,2,0,0,0,2
4371,pinterest.net,legit,2.81507,4,8,13,0,0.5,0.21654,8,0,0,0,8,6,4,1,0,11
6298,bymfjmim.com,dga,2.9183,2,9,12,1,0.22222,0.24319,1,0,0,0,1,1,0,0,0,1
3932,track.adform.net,legit,3.5,4,10,16,0,0.4,0.21875,3,0,0,0,3,3,1,0,0,4
9200,kblpsluymmmt.biz,dga,3.45282,2,13,16,1,0.15385,0.2158,0,0,0,0,0,0,0,0,0,0
4425,webcast16-ws-useast1a.tiktokv.com,legit,3.93061,9,17,33,0,0.52941,0.11911,6,6,4,3,19,6,0,0,0,6
3554,amcore-ens.rest.gti.trellix.com,legit,3.7442,9,17,31,0,0.52941,0.12078,10,0,0,0,10,10,2,0,0,12
6504,jddgizx.yi.org,dga,3.23593,3,9,14,1,0.33333,0.23114,0,0,0,0,0,1,0,0,0,1
5300,ussufiwwir.com,dga,3.23593,5,8,14,1,0.625,0.23114,1,0,0,0,1,1,0,0,0,1
9461,cfewybegcihqpner.eu,dga,3.72161,6,12,19,1,0.5,0.19587,1,0,0,0,1,3,0,0,0,3
2732,onedscolprdeus06.eastus.cloudapp.azure.com,legit,3.89185,15,21,42,0,0.71429,0.09266,17,5,3,4,29,9,1,0,0,10
698,crl.verisign.com,legit,3.5,4,10,16,0,0.4,0.21875,2,0,0,0,2,5,3,0,0,8
9598,fulucgifsu.com,dga,3.18201,5,8,14,1,0.625,0.22729,0,0,0,0,0,1,0,0,0,1
68,substrate.office.com,legit,3.62193,7,11,20,0,0.63636,0.1811,8,4,4,3,19,7,2,0,0,9
3848,gbc.criteo.com,legit,3.18201,4,8,14,0,0.5,0.22729,3,0,0,0,3,3,0,0,0,3
9964,rbzovgn.com,dga,3.27761,2,8,11,1,0.25,0.29796,0,0,0,0,0,0,0,0,0,0
1614,hotapi16-platform-useast5.us.tiktokv.com,legit,4.17507,12,20,40,0,0.6,0.10438,12,7,4,3,26,9,0,0,0,9
728,ct.pinterest.com,legit,3.32782,4,10,16,0,0.4,0.20799,8,0,0,0,8,6,4,1,0,11
5553,blpz.ru,dga,2.80735,1,5,7,1,0.2,0.40105,0,0,0,0,0,0,0,0,0,0
9165,cslmthldopylhkwx.eu,dga,3.89241,3,15,19,1,0.2,0.20486,0,0,0,0,0,0,0,0,0,0
4139,b1t-chidc2.zemanta.com,legit,3.87966,5,12,22,0,0.41667,0.17635,3,0,0,0,3,4,0,0,0,4
4867,cdn3.optimizely.com,legit,3.72161,5,11,19,0,0.45455,0.19587,4,1,0,0,5,4,0,0,0,4
1080,mail.me.com,legit,2.84535,4,5,11,0,0.8,0.25867,2,0,0,0,2,1,0,0,0,1
5707,hrgwtkaaryplkmsiucr.net,dga,4.05596,5,17,23,1,0.29412,0.17635,2,0,0,0,2,2,0,0,0,2
7874,alexandreastrickland.net,dga,3.52206,8,15,24,1,0.53333,0.14675,5,1,0,0,6,10,1,0,0,11
6835,tusacgumluc.com,dga,3.13957,5,9,15,1,0.55556,0.2093,1,0,0,0,1,1,0,0,0,1
5329,yakyyccquusiiass.org,dga,3.44644,7,12,20,1,0.58333,0.17232,1,0,0,0,1,2,1,0,0,3
4738,e12627.g.akamaiedge.net,legit,3.58835,8,7,23,0,1.14286,0.15602,5,5,5,3,18,4,0,0,0,4
208,gs-loc.apple.com,legit,3.375,4,9,16,0,0.44444,0.21094,6,4,3,2,15,1,0,0,0,1
8626,hmymoovueqdc.pw,dga,3.64022,4,10,15,1,0.4,0.24268,1,0,0,0,1,0,0,0,0,0
5479,usdoten.com,dga,3.27761,4,6,11,1,0.66667,0.29796,3,0,0,0,3,2,0,0,0,2
4162,centralindia.cloudapp.azure.com,legit,3.80872,12,16,31,0,0.75,0.12286,14,5,3,4,26,6,2,0,0,8
7782,xsiafpfy.co.nz,dga,3.52164,3,9,14,1,0.33333,0.25155,2,1,0,0,3,2,1,0,0,3
9807,dezyfzmi.pl,dga,3.27761,2,8,11,1,0.25,0.29796,1,0,0,0,1,2,0,0,0,2
7543,dajsrmdwhv.dynserv.com,dga,3.78875,3,17,22,1,0.17647,0.17222,3,1,1,0,5,4,5,5,4,18
6972,aerctqfqbex.cc,dga,3.18201,3,10,14,1,0.3,0.22729,1,0,0,0,1,2,3,2,1,8
713,sync.search.spotxchange.com,legit,3.73601,6,18,27,0,0.33333,0.13837,3,0,0,0,3,5,1,0,0,6
7559,ftugbhxqnnguqnkb.eu,dga,3.43162,4,14,19,1,0.28571,0.18061,0,0,0,0,0,0,0,0,0,0
7786,elcsfdz.lu,dga,3.12193,2,7,10,1,0.28571,0.31219,0,0,0,0,0,1,0,0,0,1
9515,digewosi.info,dga,3.18083,6,6,13,1,1.0,0.24468,1,0,0,0,1,2,0,0,0,2
5936,wnsvansjqgjqlcc.net,dga,3.57662,2,16,19,1,0.125,0.18824,0,0,0,0,0,2,1,0,0,3
3196,sync.cootlogix.com,legit,3.35021,5,11,18,0,0.45455,0.18612,4,1,0,0,5,1,1,0,0,2
3576,hbrt.adobe.com,legit,3.37878,4,8,14,0,0.5,0.24134,2,0,0,0,2,1,0,0,0,1
3300,fonts.net,legit,2.72548,2,6,9,0,0.33333,0.30283,2,0,0,0,2,1,0,0,0,1
3422,pix.adrta.com,legit,3.39275,4,7,13,0,0.57143,0.26098,4,0,0,0,4,1,0,0,0,1
1435,beacon.lynx.cognitivlabs.com,legit,3.84237,8,17,28,0,0.47059,0.13723,5,2,0,0,7,9,2,0,0,11
4592,msft.com.trafficmanager.net,legit,3.57806,7,17,27,0,0.41176,0.13252,8,6,3,4,21,8,3,1,0,12
7863,translate-danger.sh,dga,3.47135,5,12,19,1,0.41667,0.1827,5,0,0,0,5,8,3,0,0,11
6125,cumunestdonecomfacereeq.com,dga,3.52824,11,15,27,1,0.73333,0.13068,7,1,0,0,8,11,4,0,0,15
1403,caldav.fe.apple-dns.net,legit,3.55553,6,13,23,0,0.46154,0.15459,7,5,3,2,17,4,1,0,0,5
2574,api.spotify.com,legit,3.37356,5,8,15,0,0.625,0.2249,3,1,1,0,5,1,0,0,0,1
9368,7podspifafw4aby.ddns.net,dga,3.88684,5,15,24,1,0.33333,0.16195,4,1,0,0,5,4,3,2,2,11
8050,lemunwihol.com,dga,3.37878,5,8,14,1,0.625,0.24134,1,0,0,0,1,2,0,0,0,2
8487,raffyhijtlsgsi.org,dga,3.61437,4,13,18,1,0.30769,0.2008,1,0,0,0,1,2,0,0,0,2
1667,winatp-gw-cus.microsoft.com,legit,3.88416,7,16,27,0,0.4375,0.14386,10,8,7,6,31,4,0,0,0,4
4316,platform-lookaside.fbsbx.com,legit,4.02164,8,17,28,0,0.47059,0.14363,5,0,0,0,5,6,0,0,0,6
8729,nyauaptksk.com,dga,3.52164,4,9,14,1,0.44444,0.25155,1,0,0,0,1,0,0,0,0,0
8017,emwwycaiquewuqiy.org,dga,3.58418,8,11,20,1,0.72727,0.17921,0,0,0,0,0,2,0,0,0,2
7846,contraforindulg.com,dga,3.68188,6,12,19,1,0.5,0.19378,5,1,0,0,6,7,3,0,1,11
9387,chkwtdxnwi.com,dga,3.52164,2,11,14,1,0.18182,0.25155,0,0,0,0,0,0,0,0,0,0
7920,novogat.info,dga,3.02206,5,6,12,1,0.83333,0.25184,1,0,0,0,1,1,0,0,0,1
5344,consequenceexchangestrip.com,dga,3.79434,10,17,28,1,0.58824,0.13551,8,1,0,0,9,11,5,1,0,17
8466,itcwbeurecnxfbx.biz,dga,3.57662,5,13,19,1,0.38462,0.18824,1,0,0,0,1,4,0,0,0,4
5983,jfveed.tv,dga,2.72548,2,6,9,1,0.33333,0.30283,1,0,0,0,1,2,0,0,0,2
8620,e0a4eg6sekec.org,dga,3.375,6,6,16,1,1.0,0.21094,1,0,0,0,1,2,0,0,0,2
973,pull-cmaf-f16-sg01.tiktokcdn.com,legit,4.20282,5,18,32,0,0.27778,0.13134,5,6,9,9,29,3,0,0,0,3
5906,dadfixariseclaimpreventlack.com,dga,3.97792,11,19,31,1,0.57895,0.12832,6,1,0,0,7,10,2,0,0,12
6448,magyfum.info,dga,3.25163,4,7,12,1,0.57143,0.27097,1,0,0,0,1,1,0,0,0,1
6830,uamkck.net,dga,3.12193,3,6,10,1,0.5,0.31219,1,0,0,0,1,1,0,0,0,1
5963,plcomgpi.yi.org,dga,3.24022,4,9,15,1,0.44444,0.21601,3,1,0,0,4,2,1,0,0,3
2948,hsadspixel.net,legit,3.52164,4,9,14,0,0.44444,0.25155,3,0,0,0,3,1,0,0,0,1
4790,portal.office.com,legit,3.45482,6,9,17,0,0.66667,0.20322,4,4,4,3,15,4,0,0,0,4
6665,jykse21lxhrmykve51d20hvb28cykyluk57kw.ru,dga,4.31281,4,25,40,1,0.16,0.10782,1,0,0,0,1,2,0,0,0,2
1961,di.rlcdn.com,legit,3.08496,2,8,12,0,0.25,0.25708,2,1,0,0,3,1,0,0,0,1
5648,hcrjyiypzzgt.com,dga,3.625,2,13,16,1,0.15385,0.22656,1,0,0,0,1,0,0,0,0,0
839,pm.w55c.net,legit,3.0958,1,6,11,0,0.16667,0.28144,0,0,0,0,0,0,0,0,0,0
2107,1191120050.rsc.cdn77.org,legit,3.60539,1,8,24,0,0.125,0.15022,3,1,0,0,4,1,0,0,0,1
8348,avqlne.net,dga,2.92193,3,6,10,1,0.5,0.29219,0,0,0,0,0,1,0,0,0,1
5924,wbmbbwg.net,dga,2.84535,1,9,11,1,0.11111,0.25867,0,0,0,0,0,0,0,0,0,0
2253,6-courier.push.apple.com,legit,3.77206,8,11,24,0,0.72727,0.15717,9,4,3,2,18,4,0,0,0,4
7907,igxxumfbguudlijq.com,dga,3.68418,6,13,20,1,0.46154,0.18421,1,0,0,0,1,0,0,0,0,0
459,fls.doubleclick.net,legit,3.68188,5,12,19,0,0.41667,0.19378,6,0,0,0,6,4,0,0,0,4
6676,rwslukmqmfvi.org,dga,3.75,3,12,16,1,0.25,0.23438,0,0,0,0,0,0,0,0,0,0
2558,array507.prod.do.dsp.mp.microsoft.com,legit,3.71259,8,20,37,0,0.4,0.10034,12,12,10,9,43,5,2,0,0,7
2897,cs.emxdgt.com,legit,3.2389,2,9,13,0,0.22222,0.24915,1,0,0,0,1,1,0,0,0,1
5310,wghxsplbbjht.com,dga,3.75,1,14,16,1,0.07143,0.23438,1,0,0,0,1,0,0,0,0,0
7555,fohaympehn.com,dga,3.37878,4,9,14,1,0.44444,0.24134,0,0,0,0,0,0,0,0,0,0
560,z.moatads.com,legit,3.08506,4,7,13,0,0.57143,0.23731,5,0,0,0,5,2,0,0,0,2
4723,www.cnn.com,legit,2.48171,1,8,11,0,0.125,0.22561,1,0,0,0,1,0,0,0,0,0
7002,pilcanwe.ru,dga,3.45943,4,6,11,1,0.66667,0.31449,1,0,0,0,1,2,0,0,0,2
4780,global.albtls.t.co,legit,3.01688,4,11,18,0,0.36364,0.1676,4,0,0,0,4,0,0,0,0,0
7125,dmk55wkzlit4wy7hqb.cn,dga,4.1066,1,15,21,1,0.06667,0.19555,1,0,0,0,1,1,0,0,0,1
9603,mowyeadqwaebnin.info,dga,3.58418,8,11,20,1,0.72727,0.17921,3,0,0,0,3,3,0,0,0,3
1630,goguardian.com,legit,3.37878,6,7,14,0,0.85714,0.24134,0,0,0,0,0,2,0,0,0,2
5564,vuqqyuihgghy.biz,dga,3.25,4,11,16,1,0.36364,0.20312,0,0,0,0,0,0,0,0,0,0
3520,stickyadstv.com.akadns.net,legit,3.66123,6,17,26,0,0.35294,0.14082,9,6,7,7,29,7,3,1,0,11
6301,girosdo.com,dga,3.02717,4,6,11,1,0.66667,0.2752,1,1,0,0,2,0,0,0,0,0
7743,petrusqumultominus.com,dga,3.60694,8,13,22,1,0.61538,0.16395,3,0,0,0,3,4,0,0,0,4
5298,inchmfygepetwkd.com,dga,3.93214,4,14,19,1,0.28571,0.20695,2,0,0,0,2,3,0,0,0,3
3254,ca.iadsdk.apple.com,legit,3.43162,6,10,19,0,0.6,0.18061,7,4,3,2,16,2,0,0,0,2
1893,track1.aniview.com,legit,3.72548,6,9,18,0,0.66667,0.20697,2,0,0,0,2,4,1,0,0,5
7571,dikukozztingefyvnzkbghex.info,dga,3.92627,8,20,29,1,0.4,0.13539,3,0,0,0,3,3,1,0,0,4
4011,web-prem.ssp.yahoo.com,legit,3.66353,6,12,22,0,0.5,0.16652,4,0,0,1,5,2,0,0,0,2
7200,umamitsilaalr.ddns.net,dga,3.51603,7,13,22,1,0.53846,0.15982,5,1,0,0,6,10,3,2,1,16
9880,ecafmfbdlcccfmme.co.uk,dga,3.31764,5,15,22,1,0.33333,0.1508,3,1,0,0,4,3,1,0,0,4
7852,xtjwodxqwihkwqvail.biz,dga,3.84535,5,16,22,1,0.3125,0.17479,0,0,0,0,0,0,0,0,0,0
8177,vatqicmi.ru,dga,3.27761,4,6,11,1,0.66667,0.29796,3,0,0,0,3,3,0,0,0,3
8679,ojyhgmylgascducmbgaxljsclb.com,dga,3.76474,5,24,30,1,0.20833,0.12549,1,0,0,0,1,1,0,0,0,1
9317,catherinaelizabeth.net,dga,3.39081,9,12,22,1,0.75,0.15413,4,0,0,0,4,8,3,1,1,13
4396,a4.applovin.com,legit,3.37356,5,7,15,0,0.71429,0.2249,6,3,2,1,12,1,0,0,0,1
9372,spjkynr.ir,dga,3.12193,1,8,10,1,0.125,0.31219,0,0,0,0,0,0,0,0,0,0
2772,fa000000110.resources.office.net,legit,3.52621,9,11,32,0,0.81818,0.11019,7,4,4,3,18,4,1,0,0,5
4691,decide.mixpanel.com,legit,3.47135,7,10,19,0,0.7,0.1827,3,1,0,0,4,6,0,0,0,6
6119,mhyoqkxtacthaodaipl.com,dga,3.76227,7,15,23,1,0.46667,0.16358,2,0,0,0,2,2,0,0,0,2
5554,inwahossa.com,dga,3.2389,5,7,13,1,0.71429,0.24915,1,0,0,0,1,1,0,0,0,1
914,sync.taboola.com,legit,3.32782,5,9,16,0,0.55556,0.20799,3,0,0,0,3,2,0,0,0,2
3397,trace.popin.cc,legit,3.18201,4,8,14,0,0.5,0.22729,5,0,0,0,5,4,1,0,0,5
9585,lwfbycfkjpefjejpmdafc.so,dga,3.80351,4,19,24,1,0.21053,0.15848,0,0,0,0,0,0,0,0,0,0
3870,pull-flv-f11-sg01.tiktokcdn.com,legit,4.10695,4,18,31,0,0.22222,0.13248,4,6,9,9,28,2,0,0,0,2
3689,cc-api-behance.adobe.io,legit,3.46858,10,9,23,0,1.11111,0.15081,6,1,0,0,7,3,1,1,0,5
1690,cedexis.com,legit,3.0958,4,6,11,0,0.66667,0.28144,2,0,0,0,2,4,0,0,0,4
4911,telemetry.malwarebytes.com,legit,3.50354,8,16,26,0,0.5,0.13475,6,0,0,0,6,9,0,0,0,9
8652,cumafwad.ru,dga,3.0958,4,6,11,1,0.66667,0.28144,2,0,0,0,2,1,0,0,0,1
6751,hvgfmtlzqcauhlrvojfydmrcwg.org,dga,4.12323,4,25,30,1,0.16,0.13744,0,0,0,0,0,1,0,0,0,1
2870,ws-goguardian.pusher.com,legit,4.00163,8,13,24,0,0.61538,0.16673,2,0,0,0,2,3,1,0,0,4
6497,designclaiminformdrinkpray.com,dga,3.89807,9,20,30,1,0.45,0.12994,5,0,0,0,5,9,1,0,0,10
1616,tiktokcdn.com.c.bytefcdn-oversea.com,legit,3.91661,9,22,36,0,0.40909,0.10879,9,9,9,6,33,9,5,1,0,15
7521,fogaxew.net,dga,3.27761,4,6,11,1,0.66667,0.29796,0,0,0,0,0,0,0,0,0,0
4984,wixstatic.com,legit,3.2389,4,8,13,0,0.5,0.24915,5,0,0,0,5,5,1,0,0,6
840,geller-pa.googleapis.com,legit,3.54248,9,12,24,0,0.75,0.1476,7,6,4,4,21,6,0,0,0,6
3812,manage.agent-cluster3.prod.us001-prod.arcticwolf.net,legit,4.27978,14,27,52,0,0.51852,0.0823,15,6,3,4,28,10,3,0,0,13
4720,intl.miui.com,legit,3.02699,5,6,13,0,0.83333,0.23285,4,1,0,0,5,2,0,0,0,2
8864,fitintelligatcontraeccl.com,dga,3.51378,9,17,27,1,0.52941,0.13014,9,1,0,0,10,10,2,1,1,14
4606,cem.cloud.us,legit,3.08496,4,6,12,0,0.66667,0.25708,4,3,3,2,12,2,0,0,0,2
6391,sgpbabiyqqjautrx.com,dga,4.02193,5,14,20,1,0.35714,0.2011,0,0,0,0,0,0,0,0,0,0
887,nym1-ib.adnxs.com,legit,3.73452,3,10,17,0,0.3,0.21968,3,0,0,0,3,1,0,0,0,1
4480,gslb.pinterest.com,legit,3.72548,4,12,18,0,0.33333,0.20697,8,0,0,0,8,6,4,1,0,11
1201,adgrx.com,legit,3.16993,2,6,9,0,0.33333,0.35221,1,0,0,0,1,0,0,0,0,0
7784,ikcxprddotvp.com,dga,3.5,3,12,16,1,0.25,0.21875,1,0,0,0,1,1,0,0,0,1
5991,enkderhwqhiu.info,dga,3.61687,6,10,17,1,0.6,0.21276,2,0,0,0,2,3,0,0,0,3
5866,rtcmksbcqxhhgjydqv.com,dga,3.97057,1,20,22,1,0.05,0.18048,0,0,0,0,0,0,0,0,0,0
2898,lptag.liveperson.net,legit,3.58418,6,12,20,0,0.5,0.17921,4,0,0,0,4,4,1,0,0,5
2460,allawnos.com,legit,3.08496,4,7,12,0,0.57143,0.25708,0,0,0,0,0,1,0,0,0,1
174,teams.cdn.office.net,legit,3.44644,6,11,20,0,0.54545,0.17232,10,6,5,3,24,6,0,0,0,6
110,aria.microsoft.com,legit,3.2391,7,9,18,0,0.77778,0.17995,6,8,7,6,27,4,0,0,0,4
1296,wdcp.microsoft.com,legit,3.41938,4,12,18,0,0.33333,0.18997,7,8,7,7,29,2,0,0,0,2
620,us-west-2.amazonaws.com,legit,3.67531,7,11,23,0,0.63636,0.1598,7,1,3,3,14,5,1,0,0,6
1252,kinesis.us-east-1.amazonaws.com,legit,3.78115,11,14,31,0,0.78571,0.12197,10,2,3,3,18,11,1,0,0,12
3683,wfram-a-3.prod.infra.webex.com,legit,3.92323,8,15,30,0,0.53333,0.13077,6,4,3,2,15,4,2,0,0,6
9073,owwirudsaf.com,dga,3.52164,5,8,14,1,0.625,0.25155,1,0,0,0,1,0,0,0,0,0
9961,sosieeuangeliciomn.com,dga,3.4474,11,10,22,1,1.1,0.1567,3,0,0,0,3,6,0,0,0,6
644,analytics.twitter.com,legit,3.63041,6,13,21,0,0.46154,0.17288,6,0,0,0,6,6,1,0,0,7
5688,bkebb37xklxllmtogp.com,dga,3.66353,3,16,22,1,0.1875,0.16652,0,0,0,0,0,0,0,0,0,0
4608,update.msft.com.trafficmanager.net,legit,3.78556,10,20,34,0,0.5,0.11134,12,6,3,4,25,10,4,1,0,15
2058,m.hotmail.com,legit,3.02699,4,7,13,0,0.57143,0.23285,1,0,0,0,1,1,0,0,0,1
6422,ldvqjrjpdffrsqkig.com,dga,3.91613,2,18,21,1,0.11111,0.18648,0,0,0,0,0,0,0,0,0,0
7847,dmrcewtxuyeyadp.su,dga,3.72548,5,12,18,1,0.41667,0.20697,2,0,0,0,2,1,0,0,0,1
8666,jhvugdmlxobhrxoiwmo.mx,dga,3.72013,5,16,22,1,0.3125,0.1691,0,0,0,0,0,0,0,0,0,0
5402,nailhostmarketadvantageallow.com,dga,3.88205,12,19,32,1,0.63158,0.12131,8,1,0,0,9,8,0,0,0,8
1668,su.itunes.apple.com,legit,3.57662,7,9,19,0,0.77778,0.18824,7,4,3,2,16,5,0,0,0,5
4677,reachable.webex.com,legit,3.40582,7,10,19,0,0.7,0.17925,4,0,0,0,4,5,2,0,0,7
7583,hezdkzxyheuaeofeyqspbkfonqg.com,dga,4.15565,9,21,31,1,0.42857,0.13405,2,0,0,0,2,1,0,0,0,1
7677,haxaduqu.ru,dga,2.84535,5,5,11,1,1.0,0.25867,1,0,0,0,1,0,0,0,0,0
579,gs-loc-new.ls-apple.com.akadns.net,legit,3.8366,8,19,34,0,0.42105,0.11284,11,9,9,9,38,6,3,1,0,10
7416,ovkiuksuatu.ddns.net,dga,3.48418,7,11,20,1,0.63636,0.17421,3,1,0,0,4,6,3,3,2,14
1902,mask-api.fe.apple-dns.net,legit,3.64307,7,13,25,0,0.53846,0.14572,9,6,4,2,21,5,1,0,0,6
6000,mcdbcecabcnllfab.com,dga,3.2037,4,15,20,1,0.26667,0.16018,2,0,0,0,2,3,0,0,0,3
7827,mg2o24u4yges.org,dga,3.32782,4,7,16,1,0.57143,0.20799,2,0,0,0,2,2,0,0,0,2
4697,pbs.nextmillmedia.com,legit,3.78494,6,13,21,0,0.46154,0.18024,3,0,0,0,3,3,0,0,0,3
8914,oj70k2mp1lovy8u.ddns.net,dga,4.25163,4,13,24,1,0.30769,0.17715,3,1,0,0,4,4,3,3,2,12
6679,p52btcyo51e21d60k47pymxfql58k67kterfrgu.org,dga,4.5829,5,23,43,1,0.21739,0.10658,2,0,0,0,2,2,1,0,0,3
8762,lomownic.com,dga,2.85539,4,7,12,1,0.57143,0.23795,2,0,0,0,2,3,0,0,0,3
6702,zzpkcfwew.com.ki,dga,3.375,3,11,16,1,0.27273,0.21094,2,2,1,0,5,2,2,1,0,5
2683,onedscolprdwus12.westus.cloudapp.azure.com,legit,3.98709,13,23,42,0,0.56522,0.09493,17,4,3,4,28,7,2,0,0,9
4323,onedscolprduks02.uksouth.cloudapp.azure.com,legit,4.02536,14,23,43,0,0.6087,0.09361,13,4,3,4,24,5,1,0,0,6
1791,fundingchoicesmessages.google.com,legit,3.68819,12,19,33,0,0.63158,0.11176,8,7,4,3,22,7,2,0,0,9
3439,comm-main.ess-apple.com.akadns.net,legit,3.72674,10,18,34,0,0.55556,0.10961,13,9,9,9,40,8,4,1,0,13
2425,ipv4only.arpa,legit,3.39275,4,7,13,0,0.57143,0.26098,1,0,0,0,1,1,0,0,0,1
9308,xcgxokfzmw.com,dga,3.23593,2,11,14,1,0.18182,0.23114,0,0,0,0,0,0,0,0,0,0
3295,va.v.liveperson.net,legit,3.39189,6,10,19,0,0.6,0.17852,3,0,0,0,3,3,1,0,0,4
2825,cdn.discordapp.com,legit,3.30827,4,12,18,0,0.33333,0.18379,6,3,1,0,10,5,0,0,0,5
5583,eeqpjkdsholapet.org,dga,3.78714,6,12,19,1,0.5,0.19932,2,0,0,0,2,2,0,5,5,12
1167,kargo.com,legit,2.9477,3,5,9,0,0.6,0.32752,0,0,0,0,0,1,0,0,0,1
5908,gahyroz.com,dga,3.27761,3,7,11,1,0.42857,0.29796,1,0,0,0,1,0,0,0,0,0
6001,idjahnyv.com.hn,dga,3.50689,3,10,15,1,0.3,0.23379,2,2,1,0,5,2,2,1,0,5
1764,array506.prod.do.dsp.mp.microsoft.com,legit,3.71259,8,20,37,0,0.4,0.10034,12,12,10,9,43,5,2,0,0,7
9597,30excf7tcpwf763.ddns.net,dga,3.83496,2,14,24,1,0.14286,0.15979,2,1,0,0,3,4,3,2,2,11
5793,myoujnwgfvtakhf.com,dga,3.93214,4,14,19,1,0.28571,0.20695,2,0,0,0,2,1,0,0,0,1
4522,api-glb-ause2a.smoot.apple.com,legit,3.8314,11,13,30,0,0.84615,0.12771,9,5,3,2,19,2,0,0,0,2
4111,sn.webrootcloudav.com,legit,3.82089,7,12,21,0,0.58333,0.18195,4,3,2,1,10,0,0,0,0,0
9122,cqsqcekm02oi.top,dga,3.625,4,9,16,1,0.44444,0.22656,1,0,0,0,1,1,0,0,0,1
1832,geo.privacymanager.io,legit,3.59447,9,10,21,0,0.9,0.17117,4,2,0,3,9,6,0,1,0,7
1964,sharepointonline.com,legit,3.64644,8,11,20,0,0.72727,0.18232,5,0,0,0,5,5,1,0,0,6
3241,api.bazaarvoice.com,legit,3.40582,9,8,19,0,1.125,0.17925,4,2,1,0,7,3,0,0,0,3
102,yahoo.com,legit,2.6416,4,4,9,0,1.0,0.29351,1,0,0,1,2,0,0,0,0,0
463,pixel.tapad.com,legit,3.50689,5,8,15,0,0.625,0.23379,5,0,0,0,5,2,0,0,0,2
903,moatpixel.com,legit,3.39275,5,7,13,0,0.71429,0.26098,2,0,0,0,2,2,0,0,0,2
4700,cm.rtbsystem.com,legit,3.20282,2,12,16,0,0.16667,0.20018,2,0,0,0,2,3,0,0,0,3
9927,asig28uwewa8.net,dga,3.5,6,6,16,1,1.0,0.21875,0,0,0,0,0,2,0,0,0,2
9691,armdpidvchlgpyqgc.com,dga,3.78494,3,17,21,1,0.17647,0.18024,1,0,0,0,1,1,0,0,0,1
1889,region1.app-measurement.com,legit,3.83804,10,13,27,0,0.76923,0.14215,8,3,1,0,12,7,2,0,0,9
1248,simage4.pubmatic.com,legit,3.68418,7,10,20,0,0.7,0.18421,5,1,0,0,6,6,1,0,0,7
5789,ddirnunyxykl.com,dga,3.625,3,12,16,1,0.25,0.22656,0,0,0,0,0,1,0,0,0,1
8092,perfectamipsadisceptare.com,dga,3.5599,10,16,27,1,0.625,0.13185,7,0,0,0,7,9,0,0,0,9
8238,68mwm42gi0iw.org,dga,3.5,3,7,16,1,0.42857,0.21875,0,0,0,0,0,0,0,0,0,0
2612,gdmf.v.aaplimg.com,legit,3.41938,4,11,18,0,0.36364,0.18997,4,0,0,0,4,0,0,0,0,0
7637,tktkejqahkpopqitdkc.com,dga,3.62118,5,17,23,1,0.29412,0.15744,0,0,0,0,0,1,0,0,0,1
5563,agguhodsome.com,dga,3.32323,6,8,15,1,0.75,0.22155,1,0,0,0,1,1,0,0,0,1
2577,tnc16-platform-useast1a.tiktokv.com,legit,4.12587,9,19,35,0,0.47368,0.11788,8,6,4,3,21,8,0,0,0,8
2759,b-0005.b-msedge.net,legit,3.43162,3,8,19,0,0.375,0.18061,3,2,1,0,6,3,0,0,0,3
757,bid.g.doubleclick.net,legit,3.59447,6,12,21,0,0.5,0.17117,6,0,0,0,6,4,0,0,0,4
1130,us.bootstrap.endpoint.ingress.rapid7.com,legit,3.88733,12,22,40,0,0.54545,0.09718,13,1,0,0,14,7,4,0,0,11
1600,hp.com,legit,2.58496,1,4,6,0,0.25,0.43083,0,0,0,0,0,0,0,0,0,0
581,csp.microsoft.com,legit,3.17512,4,11,17,0,0.36364,0.18677,7,8,7,7,29,2,0,0,0,2
3167,connectad.io,legit,3.08496,5,6,12,0,0.83333,0.25708,4,1,0,0,5,5,1,0,0,6
1330,okta.com,legit,2.75,3,4,8,0,0.75,0.34375,1,0,0,0,1,1,0,0,0,1
7206,canolibmumarbonidicsuum.com,dga,3.53194,11,15,27,1,0.73333,0.13081,4,0,0,0,4,8,0,0,0,8
4609,manage.trellix.com,legit,3.61437,6,10,18,0,0.6,0.2008,6,1,0,2,9,5,0,0,0,5
1732,www.recaptcha.net,legit,3.21953,4,11,17,0,0.36364,0.18938,2,0,0,0,2,3,1,0,0,4
592,stackadapt.com,legit,3.18201,4,9,14,0,0.44444,0.22729,4,0,0,0,4,3,0,0,0,3
5318,lyrelox.info,dga,3.25163,4,7,12,1,0.57143,0.27097,2,0,0,0,2,2,0,0,0,2
8404,vkghuobpad.com,dga,3.6645,4,9,14,1,0.44444,0.26175,1,0,0,0,1,0,0,0,0,0
56,com.akadns.net,legit,3.37878,4,8,14,0,0.5,0.24134,4,5,6,6,21,4,2,0,0,6
5334,mznaoclbtr.com,dga,3.37878,3,10,14,1,0.3,0.24134,0,0,0,0,0,0,0,0,0,0
3370,e15275.g.akamaiedge.net,legit,3.58835,8,7,23,0,1.14286,0.15602,5,5,5,3,18,4,0,0,0,4
6371,ezvhpek.com,dga,3.27761,3,7,11,1,0.42857,0.29796,0,0,0,0,0,0,0,0,0,0
9611,gatonibapyr.eu,dga,3.6645,6,7,14,1,0.85714,0.26175,3,0,0,0,3,3,0,0,0,3
6435,dosojew.info,dga,3.18872,5,6,12,1,0.83333,0.26573,0,1,0,0,1,0,0,0,0,0
6657,iytodejgdebt.club,dga,3.61687,5,11,17,1,0.45455,0.21276,0,0,0,0,0,1,0,0,0,1
8204,8i868u8e4yk2.top,dga,3.5,4,4,16,1,1.0,0.21875,0,0,0,0,0,0,0,0,0,0
5480,mfeemabdcakbcfdb.website,dga,3.50163,7,16,24,1,0.4375,0.1459,1,0,0,0,1,3,0,0,0,3
6934,forgetplease.net,dga,3.375,6,9,16,1,0.66667,0.21094,5,1,0,0,6,7,0,0,0,7
4599,clienttoken.spotify.com,legit,3.67531,7,14,23,0,0.5,0.1598,4,2,0,0,6,2,1,0,0,3
1654,pull-f5-tt01.fcdn.us.tiktokv.com,legit,4.0625,5,18,32,0,0.27778,0.12695,6,7,7,4,24,2,0,0,0,2
9906,twlatqchp.com,dga,3.39275,2,10,13,1,0.2,0.26098,1,0,0,0,1,2,0,0,0,2
8074,dixemib.info,dga,3.18872,5,6,12,1,0.83333,0.26573,1,0,0,0,1,2,0,0,0,2
8029,qyjgglvhmv.com,dga,3.37878,1,12,14,1,0.08333,0.24134,0,0,0,0,0,0,0,0,0,0
632,news-edge.apple.com,legit,3.61635,6,10,19,0,0.6,0.19033,8,6,4,2,20,4,0,0,0,4
2378,bamgrid.com,legit,3.27761,3,7,11,0,0.42857,0.29796,1,0,0,0,1,2,0,0,0,2
9067,sh55rj8wvh45k82gum.ru,dga,3.78494,2,11,21,1,0.18182,0.18024,0,0,0,0,0,0,0,0,0,0
5365,lafogge.com,dga,3.0958,4,6,11,1,0.66667,0.28144,1,0,0,0,1,2,0,0,0,2
4936,b-0008.b-msedge.net,legit,3.43162,3,8,19,0,0.375,0.18061,3,2,1,0,6,3,0,0,0,3
3213,gsp-ssl-geomap.ls-apple.com.akadns.net,legit,3.72492,9,22,38,0,0.40909,0.09802,13,9,9,9,40,7,3,1,0,11
8718,ukviqoagriquwei.ddns.net,dga,3.88684,9,13,24,1,0.69231,0.16195,2,1,0,0,3,5,4,3,2,14
9482,befcwpguldvvyefx.eu,dga,3.68188,5,13,19,1,0.38462,0.19378,0,0,0,0,0,1,0,0,0,1
4817,do.dsp.trafficmanager.net,legit,3.78347,7,15,25,0,0.46667,0.15134,9,3,1,3,16,7,2,0,0,9
1745,rocket-cdn.com,legit,3.32486,3,9,14,0,0.33333,0.23749,3,1,0,0,4,2,0,0,0,2
4857,s2s.t13.io,legit,2.92193,2,3,10,0,0.66667,0.29219,2,0,0,0,2,0,0,0,0,0
288,ocsp.r2m01.amazontrust.com,legit,3.76718,6,14,26,0,0.42857,0.14489,8,1,3,3,15,4,0,0,0,4
1306,arcus-uswest.amazon.com,legit,3.67531,8,12,23,0,0.66667,0.1598,7,1,3,3,14,6,1,0,0,7
9020,thesesome.net,dga,2.77736,5,7,13,1,0.71429,0.21364,2,0,0,0,2,3,0,0,0,3
8443,swhwvwyhyodnwlte.eu,dga,3.51109,4,14,19,1,0.28571,0.18479,2,0,0,0,2,2,0,0,0,2
1713,ttoverseaus.net,legit,3.13957,6,8,15,0,0.75,0.2093,4,0,0,0,4,4,3,0,0,7
2584,japaneast.cloudapp.azure.com,legit,3.76738,11,14,28,0,0.78571,0.13455,10,5,3,4,22,6,0,0,0,6
3852,metrics.media-amazon.com,legit,3.63684,9,12,24,0,0.75,0.15154,7,1,3,2,13,7,0,0,0,7
366,cookielaw.org,legit,3.33468,6,6,13,0,1.0,0.25651,2,0,0,0,2,3,0,0,0,3
91,business.bing.com,legit,3.33718,5,10,17,0,0.5,0.1963,4,0,0,0,4,4,3,0,0,7
6704,oaflnedfamdadbca.com,dga,3.28418,7,12,20,1,0.58333,0.16421,3,0,0,0,3,4,0,0,0,4
5751,modohnam.com,dga,2.79248,4,7,12,1,0.57143,0.23271,1,0,0,0,1,1,0,0,0,1
8618,lygyvid.com,dga,3.27761,2,8,11,1,0.25,0.29796,0,0,0,0,0,0,0,0,0,0
4695,2df7e.v.fwmrm.net,legit,3.45482,2,10,17,0,0.2,0.20322,1,0,0,0,1,0,0,0,0,0
2436,graph.bluecava.com,legit,3.68354,6,10,18,0,0.6,0.20464,2,0,0,0,2,3,0,0,0,3
436,secure.adnxs.com,legit,3.5,5,9,16,0,0.55556,0.21875,6,0,0,0,6,4,0,0,0,4
1896,trends.revcontent.com,legit,3.3321,5,14,21,0,0.35714,0.15867,8,2,0,0,10,6,2,0,0,8
7712,relationships-military.ki,dga,3.77947,9,14,25,1,0.64286,0.15118,7,0,0,0,7,11,4,2,1,18
9098,bobdocfnkaecfafl.com,dga,3.40869,6,13,20,1,0.46154,0.17043,0,0,0,0,0,1,0,0,0,1
1408,apple.com.edgekey.net,legit,3.51782,7,11,21,0,0.63636,0.16752,9,8,5,3,25,5,2,1,0,8
8102,sotennaha.com,dga,3.2389,5,7,13,1,0.71429,0.24915,2,0,0,0,2,2,0,0,0,2
917,login.mso.msidentity.com,legit,3.54248,7,14,24,0,0.5,0.1476,6,1,0,0,7,6,1,0,0,7
4889,platinumai.net,legit,3.23593,6,7,14,0,0.85714,0.23114,5,0,0,0,5,5,1,0,0,6
7372,anldbmflaefnfneb.de,dga,3.0761,5,13,19,1,0.38462,0.1619,0,0,0,0,0,3,0,0,0,3
179,mail.google.com,legit,3.05656,6,7,15,0,0.85714,0.20377,3,5,4,3,15,2,0,0,0,2
7460,pnuiifjbrsqh.com,dga,3.875,4,11,16,1,0.36364,0.24219,0,0,0,0,0,0,0,0,0,0
3522,bats.video.yahoo.com,legit,3.58418,8,9,20,0,0.88889,0.17921,3,0,0,1,4,2,0,0,0,2
5123,52axmn5xqfkhc6q.ddns.net,dga,3.97018,2,16,24,1,0.125,0.16542,2,1,0,0,3,4,3,3,2,12
1554,net.edgekey.net,legit,2.73291,5,8,15,0,0.625,0.18219,2,2,1,0,5,4,0,0,0,4
5439,garisletag.com,dga,3.52164,5,8,14,1,0.625,0.25155,2,0,0,0,2,6,1,0,0,7
1741,pull-a5-tt01.fcdn.us.tiktokv.com,legit,4.125,6,17,32,0,0.35294,0.12891,6,7,7,4,24,2,0,0,0,2
3956,forgeofempires.com,legit,3.30827,7,10,18,0,0.7,0.18379,5,0,0,0,5,5,1,0,0,6
2021,wo.vzwwo.com,legit,2.62581,3,7,12,0,0.42857,0.21882,0,0,0,0,0,0,0,0,0,0
824,app-analytics-v2.snapchat.com,legit,3.7849,7,17,29,0,0.41176,0.13051,5,1,0,0,6,4,1,0,0,5
3837,aws.adobess.com,legit,3.1899,5,8,15,0,0.625,0.21266,4,0,0,0,4,2,1,0,0,3
4561,stackpathcdn.com,legit,3.45282,3,12,16,0,0.25,0.2158,5,1,0,0,6,5,0,0,0,5
4081,tag.demandbase.com,legit,3.46132,6,10,18,0,0.6,0.1923,4,0,0,0,4,9,1,0,0,10
7841,vowydic.com,dga,3.0958,3,7,11,1,0.42857,0.28144,1,0,0,0,1,1,0,0,0,1
9128,iqoqwgeuaocsqymi.org,dga,3.64644,8,11,20,1,0.72727,0.18232,2,0,0,0,2,2,0,0,0,2
3857,star.facebook.com,legit,3.45482,6,9,17,0,0.66667,0.20322,4,0,0,0,4,5,0,0,0,5
3144,images.archive-digger.com,legit,3.67327,9,13,25,0,0.69231,0.14693,6,1,0,0,7,6,0,0,0,6
9374,vkrxnteovhnrmhyk.eu,dga,3.61635,4,14,19,1,0.28571,0.19033,2,0,0,0,2,1,0,0,0,1
3877,myapps.classlink.com,legit,3.48418,4,14,20,0,0.28571,0.17421,6,1,0,0,7,3,1,0,0,4
8088,iivqurfuueed.com,dga,3.45282,8,7,16,1,1.14286,0.2158,1,0,0,0,1,1,0,0,0,1
7808,casetear.net,dga,2.85539,5,6,12,1,0.83333,0.23795,3,0,0,0,3,7,0,0,0,7
901,beap-bc.yahoo.com,legit,3.33718,6,8,17,0,0.75,0.1963,3,0,0,1,4,2,0,0,0,2
4616,profile.ess.apple.com,legit,3.42733,7,11,21,0,0.63636,0.16321,11,5,3,2,21,2,2,0,0,4
984,treatment.grammarly.com,legit,3.38162,6,15,23,0,0.4,0.14703,8,1,0,0,9,8,1,0,0,9
9739,securedcouples.dk,dga,3.33718,6,10,17,1,0.6,0.1963,8,1,0,0,9,7,0,0,0,7
206,linkedin.com,legit,3.25163,4,7,12,0,0.57143,0.27097,3,0,0,0,3,2,0,0,0,2
272,trafficmanager.net,legit,3.35021,6,11,18,0,0.54545,0.18612,5,3,1,3,12,6,1,0,0,7
5418,trtexwdrselpmcafy.tw,dga,3.78418,3,16,20,1,0.1875,0.18921,2,0,0,0,2,4,0,0,0,4
8410,heovilke.ru,dga,3.27761,5,5,11,1,1.0,0.29796,0,0,0,0,0,0,0,0,0,0
5337,qsr5eln4pqtnxlxrlp.cn,dga,3.55852,1,17,21,1,0.05882,0.16945,0,0,0,0,0,1,0,0,0,1
3650,dbankcloud.eu,legit,3.39275,5,7,13,0,0.71429,0.26098,2,3,2,1,8,1,0,0,0,1
1606,com.c.bytefcdn-oversea.com,legit,3.76718,7,15,26,0,0.46667,0.14489,8,3,1,0,12,8,4,0,0,12
4002,cs.mobfox.com,legit,2.87314,3,8,13,0,0.375,0.22101,2,0,0,0,2,0,0,0,0,0
924,query.yahoo.com,legit,3.32323,6,7,15,0,0.85714,0.22155,2,0,0,1,3,1,0,0,0,1
6805,iddwnvcejhwvqwao.eu,dga,3.68188,6,12,19,1,0.5,0.19378,1,0,0,0,1,2,0,0,0,2
1062,pull-a5-tt02-infra.fcdn.us.tiktokv.com,legit,4.22806,8,20,38,0,0.4,0.11126,8,7,7,4,26,4,0,0,0,4
502,go-mpulse.net,legit,3.54659,4,7,13,0,0.57143,0.27281,1,0,0,0,1,1,0,0,0,1
9360,stfapqqlrapt.biz,dga,3.5,3,12,16,1,0.25,0.21875,3,0,0,0,3,2,0,0,0,2
469,outbrain.com,legit,3.4183,5,6,12,0,0.83333,0.28486,3,0,0,0,3,2,0,0,0,2
2391,mp.4dex.io,legit,3.12193,3,4,10,0,0.75,0.31219,1,0,0,0,1,1,0,0,0,1
3184,aw.sc-cdn.net,legit,3.2389,2,8,13,0,0.25,0.24915,2,1,0,0,3,1,0,0,0,1
119,pagead2.googlesyndication.com,legit,3.8404,11,15,29,0,0.73333,0.13243,10,6,4,3,23,10,3,2,1,16
444,adform.net,legit,3.32193,3,6,10,0,0.5,0.33219,1,0,0,0,1,1,0,0,0,1
6503,osuhgatle.com,dga,3.54659,5,7,13,1,0.71429,0.27281,2,0,0,0,2,3,0,0,0,3
956,translate.googleapis.com,legit,3.68872,9,13,24,0,0.69231,0.1537,9,6,4,4,23,9,3,0,0,12
472,inappcheck.itunes.apple.com,legit,3.70805,9,15,27,0,0.6,0.13734,8,4,3,2,17,6,0,0,0,6
8261,it50ox58mha85xqtmhovwly.ddns.net,dga,4.20282,5,19,32,1,0.26316,0.13134,2,1,0,0,3,5,3,2,2,12
220,instagram.com,legit,3.39275,4,8,13,0,0.5,0.26098,5,0,0,0,5,6,0,0,0,6
1615,is4-ssl.mzstatic.com,legit,3.42193,4,12,20,0,0.33333,0.1711,6,0,0,0,6,6,1,0,0,7
6714,ylid7xqpqf1hs05dmre.ddns.net,dga,4.1645,3,19,28,1,0.15789,0.14873,5,1,0,0,6,5,4,3,2,14
5060,canxoxeo.ru,dga,3.0958,5,5,11,1,1.0,0.28144,0,0,0,0,0,2,0,0,0,2
2379,fmf.fe.apple-dns.net,legit,3.40869,4,12,20,0,0.33333,0.17043,7,5,3,2,17,3,1,0,0,4
534,dsum-sec.casalemedia.com,legit,3.42769,9,12,24,0,0.75,0.14282,5,0,0,0,5,8,0,0,0,8
6939,eyyittteyehk.pw,dga,2.95591,4,10,15,1,0.4,0.19706,1,0,0,0,1,2,0,0,0,2
8559,dinqpejwxwum.pw,dga,3.45656,3,11,15,1,0.27273,0.23044,1,0,0,0,1,1,0,0,0,1
7255,fsfqatdxg63ptksexbqdrjqeqjxftmumy.com,dga,4.26298,5,29,37,1,0.17241,0.11522,2,0,0,0,2,2,0,0,0,2
7041,qqjpkxjzczk.dynserv.com,dga,4.00182,2,19,23,1,0.10526,0.17399,3,1,1,0,5,4,5,5,4,18
9196,lgdfbbwymz.com,dga,3.52164,1,12,14,1,0.08333,0.25155,0,0,0,0,0,0,0,0,0,0
3261,rd.linksynergy.com,legit,3.72548,3,13,18,0,0.23077,0.20697,4,0,0,0,4,3,0,0,0,3
8202,igfqca.info,dga,3.0958,4,6,11,1,0.66667,0.28144,0,0,0,0,0,1,0,0,0,1
2597,wdm-a.wbx2.com,legit,3.37878,2,8,14,0,0.25,0.24134,0,0,0,0,0,0,0,0,0,0
5888,aufsqsadfftxdvcnarmsj.mu,dga,3.7406,5,18,24,1,0.27778,0.15586,1,0,0,0,1,1,0,0,0,1
5907,pleasantenter.net,dga,2.93983,6,10,17,1,0.6,0.17293,7,2,0,0,9,7,2,0,0,9
6871,subscribers-discusses.kz,dga,3.26615,6,16,24,1,0.375,0.13609,5,0,0,0,5,7,1,0,0,8
612,geolocation.onetrust.com,legit,3.56977,10,12,24,0,0.83333,0.14874,7,0,0,0,7,8,4,2,1,15
2500,tag.idsync.analytics.yahoo.com,legit,3.6314,9,17,30,0,0.52941,0.12105,7,0,0,1,8,4,0,0,0,4
5662,ltlujzkxgxm59k57lsm59jzerc69k47ivbyj16.biz,dga,4.42733,4,25,42,1,0.16,0.10541,1,0,0,0,1,1,0,0,0,1
6066,hillhalf.net,dga,3.02206,3,8,12,1,0.375,0.25184,0,0,0,0,0,0,0,0,0,0
3384,continuum.dds.microsoft.com,legit,3.48583,8,16,27,0,0.5,0.1291,14,9,7,6,36,8,2,0,0,10
7928,aaklxiqrrspwxdsvup.mn,dga,3.91613,4,16,21,1,0.25,0.18648,1,0,0,0,1,0,0,0,0,0
3566,pull-flv-f11-va01.tiktokcdn.com,legit,4.04243,5,17,31,0,0.29412,0.1304,4,6,9,9,28,2,0,0,0,2
7209,laqctzltew.tv,dga,3.18083,2,10,13,1,0.2,0.24468,1,0,0,0,1,2,0,0,0,2
3851,launchpad-wrapper.privacymanager.io,legit,3.94329,12,20,35,0,0.6,0.11267,8,3,0,3,14,8,0,1,0,9
9388,kouhehubwiernio.ddns.net,dga,3.68872,9,13,24,1,0.69231,0.1537,4,1,0,0,5,6,4,3,2,15
5469,16gjat74127n30g4ohcdi0q.ddns.net,dga,4.26532,4,15,32,1,0.26667,0.13329,4,1,0,0,5,5,3,3,2,13
6565,wpfgosfisv.tj,dga,3.39275,2,10,13,1,0.2,0.26098,0,0,0,0,0,1,0,0,0,1
6987,rhkrpeqzgiroljhidfudzxso.org,dga,3.99468,7,20,28,1,0.35,0.14267,1,0,0,0,1,0,0,0,0,0
6164,fcafllcabbedcoco.co.uk,dga,3.26104,7,13,22,1,0.53846,0.14823,3,1,0,0,4,4,1,0,0,5
8909,fqbivclbinlnuoirxsrodlxkozswl.org,dga,4.02895,8,24,33,1,0.33333,0.12209,2,1,0,0,3,1,1,0,0,2
6812,cfeqjo.mooo.com,dga,2.73291,6,7,15,1,0.85714,0.18219,2,0,0,0,2,0,1,2,1,4
7824,journeyminute.net,dga,3.29277,7,9,17,1,0.77778,0.19369,4,0,0,0,4,4,0,0,0,4
2550,t-ring-fdv2.msedge.net,legit,3.69785,4,13,22,0,0.30769,0.16808,5,2,1,0,8,5,2,0,0,7
8605,rstpyrdpnoasguv.com,dga,3.82687,4,14,19,1,0.28571,0.20141,1,0,0,0,1,2,0,0,0,2
1354,dlx.addthis.com,legit,3.45656,3,10,15,0,0.3,0.23044,2,0,0,0,2,2,0,0,0,2
779,a.tribalfusion.com,legit,3.72548,7,9,18,0,0.77778,0.20697,3,0,0,0,3,3,1,0,0,4
3000,genuine.adobe.com,legit,3.45482,8,7,17,0,1.14286,0.20322,6,0,0,0,6,5,1,0,0,6
7605,lxapmxbbgrqn.ug,dga,3.50689,2,12,15,1,0.16667,0.23379,1,0,0,0,1,0,0,0,0,0
2201,content-storage-upload.googleapis.com,legit,3.89785,14,19,37,0,0.73684,0.10535,17,9,4,4,34,11,2,0,0,13
7716,predicatiodesperationis.com,dga,3.58786,12,14,27,1,0.85714,0.13288,10,0,0,0,10,13,3,2,1,19
2741,icloud.com.akadns.net,legit,3.6897,7,11,21,0,0.63636,0.1757,9,9,9,8,35,5,3,1,0,9
3633,cluster.b.redcloak.secureworks.com,legit,3.69012,10,20,34,0,0.5,0.10853,8,1,0,0,9,8,1,0,0,9
9841,xfqcbegmndwbacaw.eu,dga,3.72161,5,13,19,1,0.38462,0.19587,0,0,0,0,0,4,0,0,0,4
1260,ping.chartbeat.net,legit,3.46132,5,11,18,0,0.45455,0.1923,5,0,0,0,5,5,2,1,0,8
3716,sf16-ies-music-sg.tiktokcdn.com,legit,3.9134,7,17,31,0,0.41176,0.12624,7,6,7,6,26,5,0,0,0,5
866,fcdn.us.tiktokv.com,legit,3.57662,4,12,19,0,0.33333,0.18824,6,7,5,3,21,2,0,0,0,2
2073,contentsquare.net,legit,3.24837,6,10,17,0,0.6,0.19108,6,2,0,0,8,6,2,0,0,8
1239,service.minerva.devices.a2z.com,legit,3.60341,11,15,31,0,0.73333,0.11624,12,3,1,1,17,10,4,1,0,15
8371,tfkkdpxnxk.com,dga,3.32486,1,12,14,1,0.08333,0.23749,0,0,0,0,0,0,0,0,0,0
1310,config.edge.skype.com.trafficmanager.net,legit,3.89709,12,23,40,0,0.52174,0.09743,11,9,4,5,29,10,4,1,0,15
7998,pgwpfihldcbj.pw,dga,3.45656,1,13,15,1,0.07692,0.23044,0,0,0,0,0,0,0,0,0,0
9637,irwccegtrww.com,dga,3.13957,3,11,15,1,0.27273,0.2093,1,0,0,0,1,1,0,0,0,1
3631,redcloak.secureworks.com,legit,3.54248,8,14,24,0,0.57143,0.1476,4,1,0,0,5,5,0,0,0,5
8779,buxwiwoq.ru,dga,3.0958,4,6,11,1,0.66667,0.28144,0,0,0,0,0,0,0,0,0,0
9260,thosecourse.net,dga,3.1899,6,8,15,1,0.75,0.21266,3,0,0,0,3,3,0,0,0,3
1155,scdn.co,legit,2.52164,1,5,7,0,0.2,0.36023,2,1,0,0,3,1,0,0,0,1
6029,stephanie-input.kr,dga,3.61437,6,10,18,1,0.6,0.2008,3,0,0,0,3,5,0,0,0,5
6578,kdbkeonfbfacdbfd.info,dga,3.2728,5,15,21,1,0.33333,0.15585,2,0,0,0,2,2,0,0,0,2
364,smartadserver.com,legit,3.33718,5,11,17,0,0.45455,0.1963,6,1,1,0,8,6,3,1,0,10
3820,gateway.discord.gg,legit,3.57243,5,11,18,0,0.45455,0.19847,4,0,0,0,4,6,1,0,0,7
6329,jlxnvnrhnv.com,dga,3.32486,1,12,14,1,0.08333,0.23749,0,0,0,0,0,0,0,0,0,0
3955,api16-access-sg.pangle.io,legit,3.70347,8,11,25,0,0.72727,0.14814,5,2,0,0,7,5,1,0,0,6
7285,hwbgdlrcofknxrhte.pw,dga,4.02193,2,17,20,1,0.11765,0.2011,3,0,0,0,3,2,0,0,0,2
5155,iyjpbiwfoifa.org,dga,3.45282,6,9,16,1,0.66667,0.2158,0,0,0,0,0,0,0,0,0,0
4240,discord.media,legit,3.18083,5,7,13,0,0.71429,0.24468,1,0,0,0,1,3,0,0,0,3
2910,onedscolprdcus04.centralus.cloudapp.azure.com,legit,3.91643,14,25,45,0,0.56,0.08703,19,5,3,4,31,8,3,0,0,11
788,grammarly.com,legit,3.02699,3,9,13,0,0.33333,0.23285,3,0,0,0,3,4,0,0,0,4
5349,vihezuk.net,dga,3.27761,4,6,11,1,0.66667,0.29796,0,0,0,0,0,0,0,0,0,0
5867,qgtmkgfqbex.org,dga,3.45656,2,12,15,1,0.16667,0.23044,0,0,0,0,0,1,3,2,1,7
3829,sync.im-apps.net,legit,3.5,3,10,16,0,0.3,0.21875,2,1,0,0,3,0,0,0,0,0
1891,streetviewpixels-pa.googleapis.com,legit,3.89249,13,18,34,0,0.72222,0.11448,7,6,4,4,21,7,0,0,0,7
6256,ckomkxvbviw.com,dga,3.24022,3,11,15,1,0.27273,0.21601,0,0,0,0,0,1,0,0,0,1
4375,hb.brainlyads.com,legit,3.73452,4,11,17,0,0.36364,0.21968,4,0,0,0,4,2,0,0,0,2
3916,sfchecker.goskope.com,legit,3.42733,6,13,21,0,0.46154,0.16321,1,1,0,0,2,2,0,0,0,2
4612,dms-akam.licdn.com,legit,3.46132,4,11,18,0,0.36364,0.1923,5,2,1,0,8,3,0,0,0,3
476,media-amazon.com,legit,3.28064,7,7,16,0,1.0,0.20504,4,1,3,2,10,4,0,0,0,4
6108,relative-prediction.co,dga,3.66353,9,11,22,1,0.81818,0.16652,7,0,0,0,7,9,3,1,1,14
8178,bxjzeskqd40cvj56d30e21ntp32oxnqc39hzm39.biz,dga,4.61801,4,24,43,1,0.16667,0.1074,2,0,0,0,2,1,0,0,0,1
4349,global.asimov.events.data.trafficmanager.net,legit,3.86816,15,24,44,0,0.625,0.08791,14,4,1,3,22,13,2,0,0,15
9173,36gyatfn4jue8t1f1p.cn,dga,4.01137,3,11,21,1,0.27273,0.19102,1,0,0,0,1,1,0,0,0,1
646,googlehosted.l.googleusercontent.com,legit,3.51643,13,20,36,0,0.65,0.09768,13,8,4,3,28,9,3,0,0,12
7180,papasermiremissionis.com,dga,3.30351,10,13,24,1,0.76923,0.13765,6,1,0,0,7,10,2,0,0,12
9445,cioceqcoouoiuwwe.org,dga,3.1037,11,8,20,1,1.375,0.15518,4,0,0,0,4,2,0,0,0,2
2829,cm-supply-web.gammaplatform.com,legit,3.95034,7,20,31,0,0.35,0.12743,6,1,0,0,7,6,0,0,0,6
5742,jfulslmuuujm.com,dga,2.95282,5,10,16,1,0.5,0.18455,0,0,0,0,0,0,0,0,0,0
8015,ennoroll.com,dga,2.85539,4,7,12,1,0.57143,0.23795,2,0,0,0,2,2,0,0,0,2
377,cdp.microsoft.com,legit,3.29277,4,11,17,0,0.36364,0.19369,8,8,7,7,30,2,0,0,0,2
3199,api.mapbox.com,legit,3.09307,5,7,14,0,0.71429,0.22093,4,1,1,0,6,1,0,0,0,1
3423,fast.fonts.net,legit,2.89629,3,9,14,0,0.33333,0.20688,3,1,0,0,4,3,0,0,0,3
6899,mhy436mjcpyrqh7rsfk6un1.ddns.net,dga,4.35141,2,22,32,1,0.09091,0.13598,2,1,0,0,3,4,3,2,1,10
7579,wihudleting.com,dga,3.77356,5,9,15,1,0.55556,0.25157,3,0,0,0,3,4,1,0,0,5
928,grid.bidswitch.net,legit,3.57243,4,12,18,0,0.33333,0.19847,2,0,0,0,2,2,0,0,0,2
3003,uca.cloud.unity3d.com,legit,3.52257,7,10,21,0,0.7,0.16774,4,3,3,2,12,3,0,0,0,3
5930,dfsbtcdfbydurncxg.com,dga,3.74899,2,18,21,1,0.11111,0.17852,1,0,0,0,1,0,0,0,0,0
9969,fsvmlkskpqhw.com,dga,3.625,1,14,16,1,0.07143,0.22656,0,0,0,0,0,0,0,0,0,0
6287,odstkcmvso.com,dga,3.03915,3,10,14,1,0.3,0.21708,2,0,0,0,2,1,0,0,0,1
5665,tradeuntil.net,dga,3.18201,5,8,14,1,0.625,0.22729,4,0,0,0,4,3,1,0,0,4
6223,nigodnloingfdfqs.com,dga,3.44644,5,14,20,1,0.35714,0.17232,3,0,0,0,3,3,1,0,0,4
4949,bit.ly,legit,2.58496,1,4,6,0,0.25,0.43083,0,0,0,0,0,1,0,0,0,1
7243,dutyhear.net,dga,3.25163,4,7,12,1,0.57143,0.27097,1,0,0,0,1,2,0,0,0,2
9513,kjjkkcluqk.la,dga,2.77736,2,10,13,1,0.2,0.21364,0,0,0,0,0,0,0,0,0,0
7976,ylilotiqbhpitvbp.eu,dga,3.57662,6,12,19,1,0.5,0.18824,4,0,0,0,4,2,0,0,0,2
1094,ipv6.msftconnecttest.com,legit,3.55351,5,16,24,0,0.3125,0.14806,6,1,0,0,7,7,2,0,0,9
7393,tenantenjoying.top,dga,3.2391,6,11,18,1,0.54545,0.17995,4,0,0,0,4,4,2,0,0,6
7497,50cpcvmv7tgfohgtavqbkxo.ddns.net,dga,4.32782,4,23,32,1,0.17391,0.13524,3,1,0,0,4,5,4,3,2,14
9769,oq0u8a8mwe4m.org,dga,3.625,5,6,16,1,0.83333,0.22656,0,0,0,0,0,0,0,0,0,0
5037,qqplezdjxv.com,dga,3.6645,2,11,14,1,0.18182,0.26175,2,1,0,0,3,1,0,0,0,1
6825,wzknodogki.com,dga,3.32486,4,9,14,1,0.44444,0.23749,0,0,0,0,0,0,0,0,0,0
1281,clean.gg,legit,2.75,2,5,8,0,0.4,0.34375,2,0,0,0,2,3,0,0,0,3
5128,msmwesukesi0.top,dga,3.45282,5,9,16,1,0.55556,0.2158,1,0,0,0,1,3,0,0,0,3
2698,onedscolprdeus00.eastus.cloudapp.azure.com,legit,3.84423,15,21,42,0,0.71429,0.09153,17,5,3,4,29,9,1,0,0,10
2150,com.c.bytetcdn.com,legit,3.12799,3,12,18,0,0.25,0.17378,5,3,1,0,9,5,1,0,0,6
2290,comodoca.com.cdn.cloudflare.net,legit,3.47116,10,17,31,0,0.58824,0.11197,7,8,6,3,24,7,2,1,0,10
2758,dspg.akamaiedge.net,legit,3.43162,7,10,19,0,0.7,0.18061,6,5,5,3,19,4,0,0,0,4
1867,reson8.com,legit,3.12193,3,5,10,0,0.6,0.31219,3,0,0,0,3,3,1,0,0,4
1752,p.tvpixel.com,legit,3.39275,3,8,13,0,0.375,0.26098,3,0,0,0,3,1,0,0,0,1
7906,fauejjyuui.com,dga,3.32486,7,6,14,1,1.16667,0.23749,0,0,0,0,0,0,0,0,0,0
4829,push.prod.dradis.netflix.com,legit,3.99468,7,17,28,0,0.41176,0.14267,9,4,3,2,18,5,1,0,0,6
5849,obevsukuuxge.ddns.net,dga,3.55852,7,12,21,1,0.58333,0.16945,4,1,0,0,5,7,4,3,2,16
4105,yahoosandbox.com,legit,3.375,6,9,16,0,0.66667,0.21094,1,0,0,1,2,2,1,0,0,3
6479,odinm6cnw0on18q8ijk.ddns.net,dga,3.93719,5,16,28,1,0.3125,0.14061,4,1,0,0,5,6,3,2,2,13
7911,fojxng.mooo.com,dga,2.86625,5,8,15,1,0.625,0.19108,2,0,0,0,2,0,1,2,1,4
3909,t-ring-fallback.msedge.net,legit,3.9791,6,16,26,0,0.375,0.15304,5,2,1,0,8,6,2,0,0,8
8516,wnota0evojcxmtenmfa.ddns.net,dga,3.82486,7,18,28,1,0.38889,0.1366,5,1,0,0,6,7,4,3,2,16
7857,petittribulationesvere.com,dga,3.74833,11,14,26,1,0.78571,0.14417,6,0,0,0,6,12,6,2,1,21
3314,lfodown01-gyr-maverick.cloudsink.net,legit,4.40576,9,21,36,0,0.42857,0.12238,8,3,3,2,16,7,2,0,0,9
8159,htwsfyq.ug,dga,3.32193,1,8,10,1,0.125,0.33219,0,0,0,0,0,0,0,0,0,0
7193,068a0uw2si4u.top,dga,3.75,5,4,16,1,1.25,0.23438,0,0,0,0,0,1,0,0,0,1
6407,utatcina.ddns.net,dga,3.17512,5,10,17,1,0.5,0.18677,5,1,0,0,6,7,4,3,2,16
4956,config.office.com,legit,3.01307,6,9,17,0,0.66667,0.17724,5,5,4,3,17,4,1,0,0,5
1841,rtbc-ue1.doubleverify.com,legit,3.97366,8,13,25,0,0.61538,0.15895,4,0,0,0,4,5,2,0,0,7
1574,voilatile-pa.googleapis.com,legit,3.63397,12,12,27,0,1.0,0.13459,7,6,4,4,21,6,1,0,0,7
2036,mtunnel4.meraki.com,legit,3.68188,6,10,19,0,0.6,0.19378,3,0,0,0,3,4,0,0,0,4
1429,script.4dex.io,legit,3.52164,4,7,14,0,0.57143,0.25155,1,0,0,0,1,2,0,0,0,2
835,storequality.microsoft.com,legit,3.74833,9,15,26,0,0.6,0.14417,9,8,7,6,30,6,0,0,0,6
5472,fjead.es,dga,2.75,3,4,8,1,0.75,0.34375,2,0,0,0,2,1,0,0,0,1
8672,jhmcrywjow.com,dga,3.09307,2,11,14,1,0.18182,0.22093,1,0,0,0,1,0,0,0,0,0
1981,lax1-ib.adnxs.com,legit,3.73452,4,9,17,0,0.44444,0.21968,3,0,0,0,3,2,0,0,0,2
6240,hbryxsbjvedt.xyz,dga,3.625,1,14,16,1,0.07143,0.22656,1,0,0,0,1,2,0,0,0,2
8191,kckrowiq.biz,dga,3.25163,3,8,12,1,0.375,0.27097,1,0,0,0,1,0,0,0,0,0
1584,g03.yahoodns.net,legit,3.625,4,8,16,0,0.5,0.22656,2,1,0,1,4,2,1,0,0,3
298,bidswitch.net,legit,3.39275,3,9,13,0,0.33333,0.26098,1,0,0,0,1,1,0,0,0,1
4356,nrdp.prod.dradis.netflix.com,legit,3.78039,6,18,28,0,0.33333,0.13501,9,4,3,2,18,5,1,0,0,6
9495,uocasadwgsyspeicb.net,dga,3.88018,7,13,21,1,0.53846,0.18477,2,0,0,0,2,3,0,0,0,3
3069,imtwjwoasak.com,legit,3.37356,5,9,15,0,0.55556,0.2249,0,0,0,0,0,1,0,0,0,1
58,googletagmanager.com,legit,3.24644,8,11,20,0,0.72727,0.16232,6,5,3,5,19,7,0,0,0,7
4137,pswec.com,legit,2.9477,2,6,9,0,0.33333,0.32752,0,0,0,0,0,1,0,0,0,1
1321,edgeapi.slack.com,legit,3.61687,6,9,17,0,0.66667,0.21276,5,3,2,0,10,5,0,0,0,5
6146,somrvw.cc,dga,2.9477,1,7,9,1,0.14286,0.32752,0,0,0,0,0,1,0,0,0,1
47,push.prod.netflix.com,legit,3.97542,5,13,21,0,0.38462,0.18931,5,4,3,2,14,2,1,0,0,3
4941,algolia.net,legit,3.0958,5,5,11,0,1.0,0.28144,1,0,0,0,1,0,0,0,0,0
5650,tbyabzmgpe.com,dga,3.52164,3,10,14,1,0.3,0.25155,0,0,0,0,0,0,0,0,0,0
3005,update.adsrvr.org,legit,3.45482,5,10,17,0,0.5,0.20322,6,0,0,0,6,2,1,0,0,3
8918,phaseratewellpriestdiscover.com,dga,3.82131,11,19,31,1,0.57895,0.12327,9,1,0,0,10,13,5,0,0,18
8434,isbgyambvktflgofowf.com,dga,3.84922,5,17,23,1,0.29412,0.16736,2,0,0,0,2,2,0,0,0,2
9022,montgomeryecclestone.net,dga,3.3402,8,15,24,1,0.53333,0.13918,6,0,0,0,6,8,2,0,0,10
6850,odacemgol.ddns.net,dga,3.46132,5,11,18,1,0.45455,0.1923,3,1,0,0,4,7,3,2,1,13
8727,afvv.com.jm,dga,2.91398,2,7,11,1,0.28571,0.26491,2,2,1,0,5,2,2,1,0,5
2776,array801.prod.do.dsp.mp.microsoft.com,legit,3.71259,8,20,37,0,0.4,0.10034,12,12,10,9,43,5,2,0,0,7
1447,inapps.appsflyer.com,legit,3.62193,5,13,20,0,0.38462,0.1811,6,2,1,0,9,2,0,0,0,2
4347,heytapmobile.com,legit,3.625,6,9,16,0,0.66667,0.22656,3,0,0,0,3,2,0,0,0,2
7154,mcppbjyvaiasssile.tw,dga,3.78418,5,14,20,1,0.35714,0.18921,2,0,0,0,2,3,1,0,0,4
9857,mfebfkfldaccdccm.com,dga,3.16596,3,16,20,1,0.1875,0.1583,1,0,0,0,1,1,0,0,0,1
2115,rum.browser-intake-datadoghq.com,legit,4.17923,10,18,32,0,0.55556,0.1306,8,1,0,0,9,5,1,0,0,6
3823,aws.duplex.sc-gw.com,legit,3.78418,4,12,20,0,0.33333,0.18921,4,1,0,0,5,2,0,0,0,2
9679,qd2rhg3xwrfhebo52l.biz,dga,4.0958,3,14,22,1,0.21429,0.18617,0,0,0,0,0,0,0,0,0,0
325,metrics.icloud.com,legit,3.46132,6,10,18,0,0.6,0.1923,4,3,2,1,10,3,0,0,0,3
5582,dwhclhpenyprtrxwo.cc,dga,3.68418,2,17,20,1,0.11765,0.18421,2,0,0,0,2,1,0,0,0,1
4213,static-azur.licdn.com,legit,3.78494,6,12,21,0,0.5,0.18024,8,1,0,0,9,6,1,0,0,7
3262,a.klaviyo.com,legit,3.2389,5,6,13,0,0.83333,0.24915,0,0,0,0,0,1,0,0,0,1
8522,ciuecgeykoayywgo.org,dga,3.40869,8,11,20,1,0.72727,0.17043,1,0,0,0,1,2,0,0,0,2
8780,acwyccsiwldmqlpwku.com,dga,3.69785,4,17,22,1,0.23529,0.16808,0,0,0,0,0,2,0,0,0,2
3207,mobile.yahoo.com,legit,3.25,7,7,16,0,1.0,0.20312,3,0,0,1,4,1,0,0,0,1
7774,bmbvvpakwmxwy.info,dga,3.72548,3,14,18,1,0.21429,0.20697,0,0,0,0,0,0,0,0,0,0
5267,gvtv.co.za,dga,2.92193,2,6,10,1,0.33333,0.29219,2,1,0,0,3,1,1,0,0,2
3874,cdn0.forter.com,legit,3.37356,3,9,15,0,0.33333,0.2249,4,1,0,0,5,4,1,0,0,5
1003,pull-flv-f77-gcp01.tiktokcdn.com,legit,4.11673,4,19,32,0,0.21053,0.12865,4,6,9,9,28,2,0,0,0,2
685,pixel-sync.sitescout.com,legit,3.77206,7,14,24,0,0.5,0.15717,5,0,0,0,5,6,0,0,0,6
9590,icwjqqclk.nf,dga,3.25163,1,10,12,1,0.1,0.27097,1,0,0,0,1,1,0,0,0,1
7315,tolergomdu.com,dga,3.32486,5,8,14,1,0.625,0.23749,2,0,0,0,2,3,0,0,0,3
6541,rwsqtklpltby.info,dga,3.85217,2,14,17,1,0.14286,0.2266,1,0,0,0,1,0,0,0,0,0
8524,hhuejcqdbjrnv.com,dga,3.73452,3,13,17,1,0.23077,0.21968,0,0,0,0,0,0,0,0,0,0
4931,cdn.datatables.net,legit,3.19716,5,11,18,0,0.45455,0.17762,7,2,1,0,10,6,0,0,0,6
7656,krypfortpw.com,dga,3.37878,2,11,14,1,0.18182,0.24134,0,0,0,0,0,1,0,0,0,1
7576,kjfrxntowbffpnxr.eu,dga,3.68188,3,15,19,1,0.2,0.19378,1,0,0,0,1,0,0,0,0,0
2074,tagan.adlightning.com,legit,3.42733,6,13,21,0,0.46154,0.16321,5,0,0,0,5,4,1,0,0,5
7658,zcbtrcn.com,dga,3.02717,1,9,11,1,0.11111,0.2752,0,0,0,0,0,0,0,0,0,0
7489,adckdkbccdfffnfk.com,dga,3.04644,2,17,20,1,0.11765,0.15232,2,0,0,0,2,0,0,0,0,0
7449,iniemcmzk.com,dga,3.02699,4,8,13,1,0.5,0.23285,1,0,0,0,1,3,0,0,0,3
9560,lygyjuj.com,dga,3.0958,2,8,11,1,0.25,0.28144,0,0,0,0,0,0,0,0,0,0
3288,vip.prod.criteo.com,legit,3.32636,6,10,19,0,0.6,0.17507,7,4,3,2,16,3,1,0,0,4
7899,bandlecturepurposeground.com,dga,3.84237,10,17,28,1,0.58824,0.13723,5,0,0,0,5,6,2,0,0,8
4589,prod.mrodevicemgr.live.com.akadns.net,legit,3.89515,11,21,37,0,0.52381,0.10527,13,10,9,9,41,9,4,1,0,14
187,xx.fbcdn.net,legit,3.08496,1,9,12,0,0.11111,0.25708,2,1,0,0,3,1,0,0,0,1
2063,discover-pa.googleapis.com,legit,3.77736,10,13,26,0,0.76923,0.14528,7,6,4,4,21,6,2,0,0,8
8018,zglnpodkrh.com,dga,3.6645,2,11,14,1,0.18182,0.26175,0,0,0,0,0,0,0,0,0,0
9635,pwbupfmlfeghctbq.eu,dga,3.72161,4,14,19,1,0.28571,0.19587,0,0,0,0,0,0,0,0,0,0
1177,semasio.net,legit,3.0958,5,5,11,0,1.0,0.28144,2,0,0,0,2,5,0,0,0,5
3832,code.yengo.com,legit,3.03915,5,7,14,0,0.71429,0.21708,3,0,0,0,3,3,0,0,0,3
4935,ssp.api.tappx.com,legit,3.10188,4,10,17,0,0.4,0.18246,7,3,1,0,11,1,0,0,0,1
9238,movgkvsmlvlmwwj.com,dga,3.26083,2,16,19,1,0.125,0.17162,0,0,0,0,0,0,0,0,0,0
688,simage2.pubmatic.com,legit,3.68418,7,10,20,0,0.7,0.18421,5,1,0,0,6,6,1,0,0,7
7678,ficowusqtwwy.org,dga,3.57782,4,11,16,1,0.36364,0.22361,3,1,0,0,4,2,0,0,0,2
6935,islumowno.com,dga,3.18083,5,7,13,1,0.71429,0.24468,0,0,0,0,0,1,0,0,0,1
8150,relationaveragediscoverreplace.com,dga,3.70453,15,18,34,1,0.83333,0.10896,11,1,0,0,12,15,5,2,1,23
763,cxm-bcn.publisher-services.amazon.dev,legit,4.17527,10,22,37,0,0.45455,0.11285,11,3,4,4,22,9,3,1,0,13
3687,public.wfram-a-3.prod.infra.webex.com,legit,4.09812,10,19,37,0,0.52632,0.11076,8,4,3,2,17,5,2,0,0,7
5172,maybellinerichardson.net,dga,3.85539,8,15,24,1,0.53333,0.16064,7,0,0,0,7,10,3,1,0,14
6820,vfmqnhdcoednyowt.eu,dga,3.82687,5,13,19,1,0.38462,0.20141,3,0,0,0,3,3,0,0,0,3
3941,datadome.co,legit,2.91398,5,5,11,0,1.0,0.26491,3,0,0,0,3,3,0,0,0,3
2538,wac-ring.msedge.net,legit,3.68188,5,11,19,0,0.45455,0.19378,5,2,1,0,8,6,2,0,0,8
3247,ca4-bid.adsrvr.org,legit,3.57243,4,10,18,0,0.4,0.19847,4,0,0,0,4,1,0,0,0,1
540,apps.mzstatic.com,legit,3.26393,4,11,17,0,0.36364,0.192,9,1,0,0,10,5,1,0,0,6
1019,pull-flv-f10-sg01.tiktokcdn.com,legit,4.1313,4,18,31,0,0.22222,0.13327,4,6,9,9,28,2,0,0,0,2
6243,visitfine.net,dga,2.87314,5,7,13,1,0.71429,0.22101,1,0,0,0,1,5,1,0,0,6
9281,vocub.eu,dga,2.75,4,3,8,1,1.33333,0.34375,0,0,0,0,0,0,0,0,0,0
3926,na.aadrm.com,legit,2.85539,4,6,12,0,0.66667,0.23795,2,0,0,0,2,0,0,0,0,0
4644,wac.edgecastcdn.net,legit,3.2211,5,12,19,0,0.41667,0.16953,5,4,1,0,10,8,0,0,0,8
6938,bmlkchruaxxqcqhn.eu,dga,3.72161,4,14,19,1,0.28571,0.19587,0,0,0,0,0,0,0,0,0,0
8811,xzlcmr.lv,dga,2.9477,0,8,9,1,0.0,0.32752,0,0,0,0,0,0,0,0,0,0
2503,log.outbrainimg.com,legit,3.57662,7,10,19,0,0.7,0.18824,4,0,0,0,4,3,0,0,0,3
1280,displaycatalog.mp.microsoft.com,legit,3.76002,9,19,31,0,0.47368,0.12129,11,8,7,7,33,7,0,0,0,7
7377,cmntkprg.cc,dga,3.02717,0,10,11,1,0.0,0.2752,2,0,0,0,2,0,0,0,0,0
2072,data.flurry.com,legit,3.50689,4,9,15,0,0.44444,0.23379,2,0,0,0,2,2,0,0,0,2
307,pool.ntp.org,legit,2.85539,3,7,12,0,0.42857,0.23795,2,0,0,0,2,0,0,0,0,0
4343,nrdp-ixanycast.ftl.netflix.com,legit,4.0314,6,20,30,0,0.3,0.13438,2,1,0,0,3,6,0,0,0,6
4249,api-glb-ause1c.smoot.apple.com,legit,3.87291,10,14,30,0,0.71429,0.1291,9,5,3,2,19,2,0,0,0,2
1324,invstatic101.creativecdn.com,legit,3.75343,8,15,28,0,0.53333,0.13405,12,1,0,0,13,11,1,0,0,12
6710,sdushanansnan.org,dga,3.05748,5,11,17,1,0.45455,0.17985,1,0,0,0,1,2,2,4,3,11
1781,aax-us-iad.amazon.com,legit,3.45853,9,8,21,0,1.125,0.16469,7,1,3,3,14,3,0,0,0,3
9978,bkfoebdlccafmfbe.org,dga,3.54644,5,14,20,1,0.35714,0.17732,0,0,0,0,0,2,0,0,0,2
5980,qxaxo6ytgxkbu2o.ddns.net,dga,3.97018,5,15,24,1,0.33333,0.16542,2,1,0,0,3,4,4,3,2,13
2991,linksynergy.com,legit,3.64022,3,11,15,0,0.27273,0.24268,3,0,0,0,3,3,0,0,0,3
8662,ogiwsowouecwioyo.org,dga,3.10869,10,9,20,1,1.11111,0.15543,1,0,0,0,1,1,0,0,0,1
9957,uhinghyf.dyndns.org,dga,3.47135,3,14,19,1,0.21429,0.1827,3,1,0,0,4,5,4,4,3,16
3629,mobile.crashtracking.prod.ring.com,legit,3.96203,9,21,34,0,0.42857,0.11653,9,4,3,2,18,6,4,0,0,10
9991,udyj1rovovi8mvi.ddns.net,dga,3.85539,6,14,24,1,0.42857,0.16064,3,1,0,0,4,4,4,3,2,13
8000,icziiroqpr.com,dga,3.03915,5,8,14,1,0.625,0.21708,3,0,0,0,3,1,0,0,0,1
1216,locus-a.wbx2.com,legit,3.625,4,8,16,0,0.5,0.22656,2,0,0,0,2,0,0,0,0,0
5884,ufwxe7k5y3wh.net,dga,3.75,3,9,16,1,0.33333,0.23438,0,0,0,0,0,0,0,0,0,0
8140,kariwwlqgw.net,dga,3.46772,3,10,14,1,0.3,0.24769,0,0,0,0,0,2,0,0,0,2
1590,tidaltv.com,legit,3.27761,3,7,11,0,0.42857,0.29796,1,0,0,0,1,1,0,0,0,1
2565,client.teamviewer.com,legit,3.53517,8,11,21,0,0.72727,0.16834,8,1,0,0,9,5,1,0,0,6
5253,ffphiznksfwxt3enys.biz,dga,3.87966,3,17,22,1,0.17647,0.17635,1,0,0,0,1,1,0,0,0,1
5233,vikjujsiuw.com,dga,3.37878,5,8,14,1,0.625,0.24134,0,0,0,0,0,1,0,0,0,1
2455,cdn.krxd.net,legit,3.08496,1,9,12,0,0.11111,0.25708,2,2,1,0,5,1,0,0,0,1
538,match.sharethrough.com,legit,3.45943,6,14,22,0,0.42857,0.15725,5,0,0,0,5,5,0,0,0,5
3381,clinch.co,legit,2.6416,2,6,9,0,0.33333,0.29351,2,0,0,0,2,1,0,0,0,1
6848,i2k8gl3ret5rcr3.ddns.net,dga,3.88684,3,14,24,1,0.21429,0.16195,4,1,0,0,5,6,3,2,2,13
5524,dunxhcqeoyjtvrnub.pw,dga,4.12193,4,15,20,1,0.26667,0.2061,0,0,0,0,0,0,0,0,0,0
7818,qcilodkxufblsufdk.net,dga,3.91613,5,15,21,1,0.33333,0.18648,1,0,0,0,1,1,0,0,0,1
8851,raqbqvjotrmhrmp.info,dga,3.78418,4,15,20,1,0.26667,0.18921,1,0,0,0,1,1,0,0,0,1
6974,rqrxwdttatvvvle.ac,dga,3.41938,3,14,18,1,0.21429,0.18997,3,0,0,0,3,3,0,0,0,3
7854,sicknice.net,dga,2.9183,4,7,12,1,0.57143,0.24319,2,1,0,0,3,4,0,0,0,4
3473,udmserve.net,legit,3.18872,4,7,12,0,0.57143,0.26573,2,1,1,0,4,3,2,1,0,6
9713,clk0c41xel5vapi.ddns.net,dga,4.08496,4,14,24,1,0.28571,0.17021,4,2,1,0,7,5,4,3,2,14
4881,updates2.cdc.carbonblack.io,legit,3.88416,8,15,27,0,0.53333,0.14386,6,0,0,0,6,8,1,0,0,9
1181,browser-intake-datadoghq.com,legit,4.11058,9,16,28,0,0.5625,0.14681,8,1,0,0,9,5,1,0,0,6
663,sync-tm.everesttech.net,legit,3.32314,5,15,23,0,0.33333,0.14448,5,0,0,0,5,7,4,0,0,11
7283,third-menus.ch,dga,3.6645,3,9,14,1,0.33333,0.26175,2,0,0,0,2,1,0,0,0,1
7830,yjw2mjw03fsp72a.ddns.net,dga,4.00163,2,15,24,1,0.13333,0.16673,2,1,0,0,3,4,4,3,2,13
5960,czaanvr.hu,dga,3.12193,3,6,10,1,0.5,0.31219,0,0,0,0,0,1,0,0,0,1
2754,v16m.tiktokcdn-us.com,legit,3.82089,4,12,21,0,0.33333,0.18195,5,6,7,6,24,2,0,0,0,2
1292,logx.optimizely.com,legit,3.57662,6,11,19,0,0.54545,0.18824,3,0,0,0,3,3,0,0,0,3
1425,js.monitor.azure.com,legit,3.64644,7,10,20,0,0.7,0.18232,5,0,0,2,7,5,0,0,0,5
5280,wsdtzfu.net,dga,3.27761,2,8,11,1,0.25,0.29796,0,0,0,0,0,0,0,0,0,0
7650,olerwahofomaaq.ddns.net,dga,3.76227,8,13,23,1,0.61538,0.16358,6,1,0,0,7,8,3,3,2,16
428,pubads.g.doubleclick.net,legit,3.88684,7,14,24,0,0.5,0.16195,8,0,0,0,8,4,0,0,0,4
6930,qr7x10o8klmv7tur5v5.ddns.net,dga,4.23593,3,16,28,1,0.1875,0.15128,2,1,0,0,3,4,4,2,2,12
2670,casalemedia.com.cdn.cloudflare.net,legit,3.69012,12,18,34,0,0.66667,0.10853,9,8,6,3,26,11,2,1,0,14
5905,proremicertissimieqnec.com,dga,3.38257,10,15,26,1,0.66667,0.1301,8,3,0,0,11,12,1,0,0,13
7503,dakacaadflfnmadf.com,dga,3.06596,6,13,20,1,0.46154,0.1533,2,1,0,0,3,3,0,0,0,3
5023,guzcwufqbex.org,dga,3.64022,4,10,15,1,0.4,0.24268,0,0,0,0,0,1,3,2,2,8
5121,ndjboirblxfr.ru,dga,3.45656,3,11,15,1,0.27273,0.23044,0,0,0,0,0,1,0,0,0,1
5670,gbnrghtrajlvw.nf,dga,3.625,1,14,16,1,0.07143,0.22656,1,0,0,0,1,1,1,0,0,2
6988,ozizkpjtjt.com,dga,3.23593,3,10,14,1,0.3,0.23114,0,0,0,0,0,0,0,0,0,0
2163,pull-flv-l16-va01.tiktokcdn.com.atomile.com,legit,4.10931,10,22,43,0,0.45455,0.09557,10,10,13,11,44,7,2,1,0,10
837,cl2.apple.com,legit,3.08506,3,7,13,0,0.42857,0.23731,5,4,3,2,14,1,0,0,0,1
3302,learnplatform.com,legit,3.49923,5,11,17,0,0.45455,0.20584,4,0,0,0,4,6,0,0,0,6
490,api.smoot.apple.com,legit,3.28663,7,9,19,0,0.77778,0.17298,7,5,4,2,18,1,0,0,0,1
3744,mailchimp.com,legit,3.02699,4,8,13,0,0.5,0.23285,1,0,0,0,1,1,0,0,0,1
7353,gqiwaafwxsngwwlg.eu,dga,3.47135,5,13,19,1,0.38462,0.1827,0,0,0,0,0,0,0,0,0,0
815,reddit.com,legit,3.12193,3,6,10,0,0.5,0.31219,2,0,0,0,2,4,0,0,0,4
7253,tgamdmeajrrjncvgfyhythnjtg.biz,dga,4.0314,4,25,30,1,0.16,0.13438,2,0,0,0,2,2,0,0,0,2
86,roaming.officeapps.live.com,legit,3.78212,10,14,27,0,0.71429,0.14008,12,5,4,3,24,7,1,0,0,8
7901,euusulkkbuxw.com,dga,3.375,6,9,16,1,0.66667,0.21094,1,0,0,0,1,1,0,0,0,1
4397,fdz.flashtalking.com,legit,3.92193,4,14,20,0,0.28571,0.1961,2,0,0,0,2,4,1,0,0,5
6318,ktafoxmt7hs0qjc.ddns.net,dga,4.05351,3,17,24,1,0.17647,0.1689,3,1,0,0,4,5,3,2,2,12
9591,gohiddifiwg.com,dga,3.1899,5,9,15,1,0.55556,0.21266,0,0,0,0,0,1,0,0,0,1
6106,yaeofrwhsi.tw,dga,3.54659,4,8,13,1,0.5,0.27281,1,0,0,0,1,1,0,0,0,1
2958,micro.rubiconproject.com,legit,3.47018,8,14,24,0,0.57143,0.14459,7,5,2,1,15,5,2,0,0,7
4046,civicscience.com,legit,2.85222,6,9,16,0,0.66667,0.17826,3,0,0,0,3,3,1,1,0,5
8325,2cao6wmgyc2g.net,dga,3.625,3,9,16,1,0.33333,0.22656,0,0,0,0,0,1,0,0,0,1
1753,push-rtmp-f5-tt01.fcdn.us.tiktokv.com,legit,4.11852,5,22,37,0,0.22727,0.11131,6,7,5,3,21,2,0,0,0,2
848,dit.whatsapp.net,legit,3.32782,4,10,16,0,0.4,0.20799,3,1,0,0,4,2,0,0,0,2
2707,onedscolprdwus11.westus.cloudapp.azure.com,legit,3.93947,13,23,42,0,0.56522,0.0938,17,4,3,4,28,7,2,0,0,9
6777,ck1dg4lw3h21barjxz.net,dga,4.36852,2,14,22,1,0.14286,0.19857,0,0,0,0,0,1,0,0,0,1
2439,zem.outbrainimg.com,legit,3.68188,7,10,19,0,0.7,0.19378,3,0,0,0,3,4,0,0,0,4
1369,us-east-2.amazonaws.com,legit,3.62118,8,10,23,0,0.8,0.15744,7,2,3,3,15,6,0,0,0,6
5386,atnozgfqbex.cc,dga,3.6645,3,10,14,1,0.3,0.26175,1,0,0,0,1,2,3,2,1,8
6377,ohvtqwqdsendrc.com,dga,3.72548,3,14,18,1,0.21429,0.20697,3,0,0,0,3,3,0,0,0,3
9447,veniascsimpliciterminni.com,dga,3.50398,10,16,27,1,0.625,0.12978,8,0,0,0,8,11,1,0,0,12
4286,cdn.registerdisney.go.com,legit,3.62347,7,15,25,0,0.46667,0.14494,6,3,1,0,10,7,2,0,0,9
3668,cdn.onesignal.com,legit,3.45482,5,10,17,0,0.5,0.20322,4,2,1,0,7,5,1,0,0,6
315,augloop.office.com,legit,3.39215,8,8,18,0,1.0,0.18845,6,4,4,3,17,2,0,0,0,2
7317,lyhcoqsewpyhpuhv.eu,dga,3.57662,5,13,19,1,0.38462,0.18824,2,0,0,0,2,2,0,0,0,2
3162,capitaloneshopping.com,legit,3.66353,8,13,22,0,0.61538,0.16652,8,1,0,0,9,7,3,0,0,10
5704,girlinstallappropriatemarket.com,dga,3.71814,11,20,32,1,0.55,0.11619,11,2,0,0,13,12,2,0,0,14
766,amcdn.msftauth.net,legit,3.46132,4,12,18,0,0.33333,0.1923,5,2,1,0,8,3,0,0,0,3
9385,4tyrghy7otqf.com,dga,3.625,2,11,16,1,0.18182,0.22656,0,0,0,0,0,0,0,0,0,0
9762,itnoviindaoslu.ddns.net,dga,3.41444,8,13,23,1,0.61538,0.14845,3,1,0,0,4,7,3,3,2,15
1114,lookaside.facebook.com,legit,3.47718,10,10,22,0,1.0,0.15805,4,0,0,0,4,5,0,0,0,5
755,amplitude.com,legit,3.54659,5,7,13,0,0.71429,0.27281,3,0,0,0,3,3,0,0,0,3
8755,vhtjklgekncqonjq.biz,dga,3.92193,3,16,20,1,0.1875,0.1961,2,0,0,0,2,2,0,0,0,2
9942,kxxyactupsmtuaii.eu,dga,3.57662,8,10,19,1,0.8,0.18824,0,0,0,0,0,1,0,0,0,1
2971,dmp.adform.net,legit,3.37878,3,9,14,0,0.33333,0.24134,3,0,0,0,3,1,0,0,0,1
3045,gcs-us-00003.content-storage-upload.googleapis.com,legit,4.05817,15,23,50,0,0.65217,0.08116,19,10,4,4,37,11,3,0,0,14
8418,papamultidixit.com,dga,3.46132,7,10,18,1,0.7,0.1923,3,0,0,0,3,3,0,0,0,3
6980,mnumbhptcuyddsmdixghba.ru,dga,3.91327,5,19,25,1,0.26316,0.15653,1,0,0,0,1,1,0,0,0,1
7625,ctiswadsholapet.org,dga,3.82687,6,12,19,1,0.5,0.20141,4,0,0,0,4,4,0,5,5,14
1298,data.trafficmanager.net,legit,3.37728,8,13,23,0,0.61538,0.14684,8,3,1,3,15,8,1,0,0,9
9971,ikmk20mom8mw.net,dga,3.375,3,9,16,1,0.33333,0.21094,0,0,0,0,0,1,0,0,0,1
3678,encryption-a.wbx2.com,legit,4.01137,5,12,21,0,0.41667,0.19102,4,0,0,0,4,3,2,1,0,6
9680,r8zo78xd3igvc6pkwc.com,dga,4.06148,3,13,22,1,0.23077,0.18461,0,0,0,0,0,0,0,0,0,0
7947,mabklnabnnondnbf.website,dga,3.60123,6,17,24,1,0.35294,0.15005,3,0,0,0,3,4,0,0,0,4
6842,ubkfoxfrodxsetsh.eu,dga,3.61635,6,12,19,1,0.5,0.19033,2,1,0,0,3,2,0,0,0,2
6496,cxjoeomfyslwgoguwh.com,dga,3.73216,6,15,22,1,0.4,0.16964,0,0,0,0,0,1,0,0,0,1
6292,qoktmfhpjgsjelnenvn.com,dga,3.969,4,18,23,1,0.22222,0.17257,1,0,0,0,1,3,0,0,0,3
3203,jimapinternal.imap.mail.g03.yahoodns.net,legit,3.97257,13,20,40,0,0.65,0.09931,11,2,0,1,14,6,2,1,0,9
3102,hcdnl.pulltiktokf10.ovc.gslb.rocket-cdn.com,legit,4.20001,7,28,43,0,0.25,0.09767,4,5,4,2,15,3,0,0,0,3
4117,fe3.delivery.mp.microsoft.com,legit,3.81437,8,16,29,0,0.5,0.13153,10,8,7,7,32,7,1,0,0,8
802,fp.msedge.net,legit,3.18083,3,8,13,0,0.375,0.24468,5,2,1,0,8,3,0,0,0,3
4369,b-0016.b-dc-msedge.net.b-0016.b-msedge.net,legit,3.6427,6,18,42,0,0.33333,0.08673,4,2,1,0,7,5,0,0,0,5
3287,prod.criteo.com,legit,3.1899,5,8,15,0,0.625,0.21266,6,3,2,1,12,3,1,0,0,4
1104,cms.analytics.yahoo.com,legit,3.43576,7,13,23,0,0.53846,0.14938,5,0,0,1,6,3,0,0,0,3
5763,4msmwywmsmoe.top,dga,3.125,3,11,16,1,0.27273,0.19531,0,0,0,0,0,0,0,0,0,0
2488,pki.strln.net,legit,3.2389,2,9,13,0,0.22222,0.24915,1,0,0,0,1,1,0,0,0,1
5580,ciwypum.su,dga,3.12193,3,6,10,1,0.5,0.31219,0,0,0,0,0,0,0,0,0,0
2093,a1918.us.akamai.net,legit,3.47135,7,5,19,0,1.4,0.1827,5,3,4,3,15,2,0,0,0,2
3515,mem.gfx.ms,legit,2.64644,1,7,10,0,0.14286,0.26464,0,0,0,0,0,1,0,0,0,1
3008,rest.gti.trellix.com,legit,3.44644,5,12,20,0,0.41667,0.17232,6,0,0,0,6,5,2,0,0,7
8959,novecukinin.eu,dga,3.03915,7,6,14,1,1.16667,0.21708,1,0,0,0,1,4,1,0,0,5
7441,xjhentpw.pk,dga,3.27761,1,9,11,1,0.11111,0.29796,2,1,0,0,3,1,1,0,0,2
5279,acyvyadrbkvij.org,dga,3.61687,4,12,17,1,0.33333,0.21276,1,0,0,0,1,1,0,0,0,1
1663,quantummetric.com,legit,3.45482,6,10,17,0,0.6,0.20322,2,0,0,0,2,4,0,0,0,4
8637,nlpekkrvdcs.mooo.com,dga,3.52193,5,13,20,1,0.38462,0.1761,3,0,0,0,3,0,1,2,1,4
9688,lkdgsrvstsxdsvxy.eu,dga,3.51109,2,16,19,1,0.125,0.18479,2,0,0,0,2,1,0,0,0,1
7482,kwnombsorltjsqesoos.com,dga,3.58401,6,16,23,1,0.375,0.15583,2,0,0,0,2,3,0,0,0,3
7993,rrbehgtunkkj.com,dga,3.75,3,12,16,1,0.25,0.23438,0,0,0,0,0,1,0,0,0,1
1026,ssc-cms.33across.com,legit,2.94145,3,12,20,0,0.25,0.14707,3,2,1,0,6,1,0,0,0,1
9151,pqeymdkufc.com,dga,3.52164,3,10,14,1,0.3,0.25155,0,0,0,0,0,0,0,0,0,0
6619,aimbvmwceer.com,dga,3.32323,5,9,15,1,0.55556,0.22155,2,0,0,0,2,2,0,0,0,2
6316,cixouedqijpm.com,dga,3.5,6,9,16,1,0.66667,0.21875,2,0,0,0,2,1,0,0,0,1
4320,alt4-mtalk.google.com,legit,3.46328,6,11,21,0,0.54545,0.16492,3,5,4,3,15,2,0,0,0,2
2270,s-0005.s-msedge.net,legit,3.28663,3,8,19,0,0.375,0.17298,3,2,1,0,6,3,0,0,0,3
2252,29-courier.push.apple.com,legit,3.86347,8,11,25,0,0.72727,0.15454,9,4,3,2,18,4,0,0,0,4
7313,etg4ct1h1hu4aruno27.ddns.net,dga,3.96772,6,14,28,1,0.42857,0.1417,2,1,0,0,3,6,3,3,2,14
6390,rmvjrqpbtze.net,dga,3.50689,2,12,15,1,0.16667,0.23379,0,0,0,0,0,0,0,0,0,0
8040,gqwgeosswywyqaik.org,dga,3.44644,5,14,20,1,0.35714,0.17232,1,0,0,0,1,1,0,0,0,1
1947,cdn.heapanalytics.com,legit,3.74899,6,13,21,0,0.46154,0.17852,6,2,1,0,9,5,0,0,0,5
2674,onedscolprdwus14.westus.cloudapp.azure.com,legit,3.98709,13,23,42,0,0.56522,0.09493,17,4,3,4,28,7,2,0,0,9
9754,pollutionperfectbreakfast.com,dga,3.9523,10,18,29,1,0.55556,0.13629,6,1,0,0,7,8,2,1,0,11
6520,rneawraprjtoncjsq.pw,dga,3.58418,4,15,20,1,0.26667,0.17921,5,0,0,0,5,4,0,0,0,4
658,appsforoffice.microsoft.com,legit,3.40805,9,16,27,0,0.5625,0.12622,10,13,10,8,41,4,0,0,0,4
2255,30-courier.push.apple.com,legit,3.86347,8,11,25,0,0.72727,0.15454,9,4,3,2,18,4,0,0,0,4
3340,guc3-spclient.spotify.com,legit,3.97366,6,15,25,0,0.4,0.15895,4,1,0,0,5,2,1,0,0,3
2120,b.sharethrough.com,legit,3.57243,5,11,18,0,0.45455,0.19847,3,0,0,0,3,3,0,0,0,3
7505,cicaieqyaeciagmk.org,dga,3.40869,9,10,20,1,0.9,0.17043,1,0,0,0,1,3,0,0,0,3
4015,global.prd.cdn.globalsign.com,legit,3.63351,6,19,29,0,0.31579,0.12529,6,3,1,0,10,2,0,0,0,2
4663,shopifycloud.com,legit,3.57782,5,10,16,0,0.5,0.22361,3,3,2,1,9,0,0,0,0,0
9555,cxfofwsftg.com,dga,3.18201,2,11,14,1,0.18182,0.22729,1,0,0,0,1,0,0,0,0,0
7152,oyxecyfqbex.com,dga,3.24022,4,10,15,1,0.4,0.21601,0,0,0,0,0,2,3,2,1,8
2736,go-mpulse.net.edgekey.net,legit,3.59327,8,13,25,0,0.61538,0.14373,4,2,1,0,7,5,0,0,0,5
280,g.live.com,legit,3.12193,3,5,10,0,0.6,0.31219,1,0,0,0,1,1,0,0,0,1
503,amazon.dev,legit,3.12193,4,5,10,0,0.8,0.31219,3,1,3,2,9,3,0,0,0,3
7391,pjdhejidkvei.com,dga,3.5,5,10,16,1,0.5,0.21875,0,0,0,0,0,1,0,0,0,1
1531,cdn.indexww.com,legit,3.24022,3,10,15,0,0.3,0.21601,3,2,1,0,6,4,0,0,0,4
9333,eurkdirhhlfy.biz,dga,3.625,4,11,16,1,0.36364,0.22656,0,0,0,0,0,0,0,0,0,0
5950,afdamauwuf.ddns.net,dga,3.32636,6,11,19,1,0.54545,0.17507,4,2,0,0,6,6,3,2,1,12
1910,array505.prod.do.dsp.mp.microsoft.com,legit,3.65853,8,20,37,0,0.4,0.09888,12,12,10,9,43,5,2,0,0,7
9467,gi8mcigus2wq.org,dga,3.57782,4,9,16,1,0.44444,0.22361,1,0,0,0,1,0,0,0,0,0
7643,chrisdeclaratio.com,dga,3.57662,7,11,19,1,0.63636,0.18824,3,0,0,0,3,9,3,1,1,14
6114,vmkgyhaxxi.com,dga,3.52164,3,10,14,1,0.3,0.25155,0,0,0,0,0,0,0,0,0,0
4988,api.pushnami.com,legit,3.375,6,8,16,0,0.75,0.21094,5,1,1,0,7,2,0,0,0,2
8022,jecozix.info,dga,3.25163,5,6,12,1,0.83333,0.27097,1,0,0,0,1,2,0,0,0,2
4854,api.boomtrain.com,legit,3.33718,7,8,17,0,0.875,0.1963,5,1,1,0,7,3,1,0,0,4
296,openx.net,legit,2.72548,3,5,9,0,0.6,0.30283,1,0,0,0,1,1,0,0,0,1
1945,a1838.dscw154.akamai.net,legit,3.88684,6,8,24,0,0.75,0.16195,5,3,4,3,15,3,0,0,0,3
2362,api.onesignal.com,legit,3.49923,7,8,17,0,0.875,0.20584,4,1,1,0,6,4,1,0,0,5
5780,uhdixvyeibpgcbboc.pw,dga,3.78418,5,14,20,1,0.35714,0.18921,0,0,0,0,0,0,0,0,0,0
1443,cm.adgrx.com,legit,3.08496,2,8,12,0,0.25,0.25708,2,0,0,0,2,0,0,0,0,0
2534,pps.whatsapp.net,legit,3.0,3,11,16,0,0.27273,0.1875,4,1,0,0,5,1,0,0,0,1
2973,fcmatch.youtube.com,legit,3.47135,6,11,19,0,0.54545,0.1827,3,0,0,0,3,3,0,0,0,3
2039,bobdi-exter-1vqeilnw5zym1-5134ab8e5a874149.elb.us-east-1.amazonaws.com,legit,4.58624,18,27,70,0,0.66667,0.06552,9,2,3,3,17,9,1,0,0,10
2349,vc.hotjar.io,legit,3.25163,4,6,12,0,0.66667,0.27097,0,0,0,0,0,1,0,0,0,1
9960,ujpne2g6zcijhumvbk.cn,dga,4.01137,4,14,21,1,0.28571,0.19102,0,0,0,0,0,1,0,0,0,1
9274,paronoseuangsua.com,dga,3.43162,9,9,19,1,1.0,0.18061,3,0,0,0,3,5,0,0,0,5
8313,dqbauboq.com,dga,3.08496,4,7,12,1,0.57143,0.25708,0,0,0,0,0,0,0,0,0,0
784,aws-proxy-gcp.api.snapchat.com,legit,3.85656,7,18,30,0,0.38889,0.12855,7,3,1,0,11,1,2,0,0,3
372,play-fe.googleapis.com,legit,3.69785,8,11,22,0,0.72727,0.16808,7,6,4,4,21,4,0,0,0,4
34,self.events.data.microsoft.com,legit,3.73957,9,17,30,0,0.52941,0.12465,13,9,7,6,35,9,1,0,0,10
6857,yrfdtvcuhoymmacgan.com,dga,3.75444,5,16,22,1,0.3125,0.17066,1,0,0,0,1,3,0,0,0,3
4560,api16-normal-c-useast2a.tiktokv.com,legit,4.15029,11,16,35,0,0.6875,0.11858,9,7,4,3,23,7,0,0,0,7
6163,rememberstream.net,dga,2.88551,6,11,18,1,0.54545,0.16031,5,0,0,0,5,7,1,0,0,8
9157,djigfe.mooo.com,dga,3.10689,6,7,15,1,0.85714,0.20713,3,0,0,0,3,0,1,2,1,4
9179,papaeilleavariciamsixii.com,dga,3.38009,14,12,27,1,1.16667,0.12519,5,0,0,0,5,7,0,0,0,7
845,s.youtube.com,legit,3.2389,5,6,13,0,0.83333,0.24915,2,0,0,0,2,1,0,0,0,1
9694,gotwyyeoya.info,dga,3.27291,6,8,15,1,0.75,0.21819,0,0,0,0,0,0,0,1,0,1
3228,video.yahoo.com,legit,3.24022,7,6,15,0,1.16667,0.21601,1,0,0,1,2,1,0,0,0,1
6395,ddnbdeecjstaebnsp.su,dga,3.40869,5,14,20,1,0.35714,0.17043,3,0,0,0,3,7,1,0,0,8
497,dds.microsoft.com,legit,3.21953,4,11,17,0,0.36364,0.18938,8,8,7,6,29,3,0,0,0,3
4100,apr-52dd2-0.edgecastdns.net,legit,3.76397,5,14,27,0,0.35714,0.13941,6,4,1,0,11,9,1,0,0,10
2179,id.hadron.ad.gt,legit,3.13957,4,8,15,0,0.5,0.2093,5,0,0,0,5,1,0,0,0,1
9503,tqtsgfeterkw.com,dga,3.57782,3,12,16,1,0.25,0.22361,2,0,0,0,2,3,1,0,0,4
9977,k37f12b28pza37kvfth54gydvgqayoujxdreu.biz,dga,4.72341,7,23,41,1,0.30435,0.11521,2,0,0,0,2,1,0,0,0,1
5910,dkbkbfbddddmebom.online,dga,3.23619,5,17,23,1,0.29412,0.1407,0,0,0,0,0,2,0,0,0,2
1958,tpsc-video-ue.doubleverify.com,legit,4.01506,11,15,30,0,0.73333,0.13384,5,0,0,0,5,6,3,0,0,9
7670,hywdbhewfgseu.bit,dga,3.61687,4,12,17,1,0.33333,0.21276,1,0,0,0,1,1,0,0,0,1
3548,cti.w55c.net,legit,2.9183,2,6,12,0,0.33333,0.24319,1,0,0,0,1,1,0,0,0,1
6545,sugeufabm.ddns.net,dga,3.50326,5,11,18,1,0.45455,0.19463,3,1,0,0,4,6,3,2,2,13
789,exelator.com,legit,3.25163,5,6,12,0,0.83333,0.27097,1,0,0,0,1,4,0,0,0,4
5352,5nk85vyveluh3dk.ddns.net,dga,3.77206,3,15,24,1,0.2,0.15717,2,1,0,0,3,6,3,2,2,13
8451,edakalbbnkbdeedd.net,dga,2.98418,6,13,20,1,0.46154,0.14921,1,1,0,0,2,3,0,0,0,3
2824,dsp.trafficmanager.net,legit,3.69785,6,14,22,0,0.42857,0.16808,8,3,1,3,15,6,1,0,0,7
3532,stas.outbrain.com,legit,3.49923,6,9,17,0,0.66667,0.20584,6,0,0,0,6,5,0,0,0,5
4968,chat.openai.com,legit,3.37356,6,7,15,0,0.85714,0.2249,2,0,0,0,2,2,1,0,0,3
6526,dbnpiqsxksyfouum.eu,dga,3.89241,6,12,19,1,0.5,0.20486,2,0,0,0,2,0,0,0,0,0
9181,8i61d3atvxefesaa2k.biz,dga,4.06148,7,9,22,1,0.77778,0.18461,2,0,0,0,2,2,0,0,0,2
6312,fbalbamobfkcfdlb.com,dga,3.18418,4,15,20,1,0.26667,0.15921,1,0,0,0,1,1,0,0,0,1
2203,k-ring.msedge.net,legit,3.45482,4,10,17,0,0.4,0.20322,5,2,1,0,8,5,2,0,0,7
3726,spl.zeotap.com,legit,3.37878,4,8,14,0,0.5,0.24134,3,0,0,0,3,1,0,0,0,1
3719,analytics.rlcdn.com,legit,3.57662,4,13,19,0,0.30769,0.18824,5,1,0,0,6,4,0,0,0,4
9924,k0kxc03hkfgxy65bwjy.ddns.net,dga,4.20897,1,20,28,1,0.05,0.15032,2,1,0,0,3,4,3,2,2,11
3895,apis.classlink.com,legit,3.35021,5,11,18,0,0.45455,0.18612,6,1,0,0,7,4,1,0,0,5
1627,mssdk16-platform-useast5.us.tiktokv.com,legit,4.14106,9,22,39,0,0.40909,0.10618,9,6,4,3,22,8,0,0,0,8
99,www.facebook.com,legit,3.15564,5,9,16,0,0.55556,0.19723,2,0,0,0,2,2,0,0,0,2
747,targeting.unrulymedia.com,legit,3.84386,9,14,25,0,0.64286,0.15375,5,0,0,0,5,7,1,0,0,8
6621,quarterdecidemarketlandoperate.com,dga,3.70453,14,19,34,1,0.73684,0.10896,5,0,0,0,5,13,3,0,0,16
8128,dtc69lwbycznvp32h34augwgsc29i65cwlxc39.com,dga,4.49293,4,25,42,1,0.16,0.10697,0,0,0,0,0,0,0,0,0,0
1380,4.tlu.dl.delivery.mp.microsoft.com,legit,3.8588,8,19,34,0,0.42105,0.11349,11,8,7,7,33,7,1,0,0,8
8164,cracktowerproposereducebehave.com,dga,3.72592,13,19,33,1,0.68421,0.11291,9,3,0,0,12,9,3,0,0,12
2109,ib-ibi.com,legit,2.64644,4,4,10,0,1.0,0.26464,0,0,0,0,0,0,0,0,0,0
4331,e121995.a.akamaiedge.net,legit,3.55351,9,6,24,0,1.5,0.14806,5,5,5,3,18,4,0,0,0,4
523,krxd.net,legit,3.0,1,6,8,0,0.16667,0.375,0,0,0,0,0,0,0,0,0,0
2435,sls.update.microsoft.com,legit,3.7406,7,14,24,0,0.5,0.15586,10,8,7,6,31,4,1,0,0,5
6009,nuhnrncmwi.com,dga,3.18201,3,10,14,1,0.3,0.22729,0,0,0,0,0,0,0,0,0,0
1203,ispot.tv,legit,2.75,2,5,8,0,0.4,0.34375,0,0,0,0,0,1,0,0,0,1
930,sync.ipredictive.com,legit,3.64644,6,12,20,0,0.5,0.18232,5,0,0,0,5,5,0,0,0,5
6385,oqpyt711fiwqg3kae3.cn,dga,4.1066,4,11,21,1,0.36364,0.19555,0,0,0,0,0,0,0,0,0,0
4951,network.bazaarvoice.com,legit,3.76227,9,12,23,0,0.75,0.16358,2,1,0,0,3,6,0,0,0,6
6890,puvuqoiparlu.ddns.net,dga,3.78494,7,12,21,1,0.58333,0.18024,2,1,0,0,3,5,3,3,2,13
5857,cgsowiiugkeq.biz,dga,3.57782,6,9,16,1,0.66667,0.22361,0,0,0,0,0,0,0,3,2,5
8557,xudoqyr.info,dga,3.4183,4,7,12,1,0.57143,0.28486,0,0,0,0,0,0,0,0,0,0
7336,vulkbwzjmg.tv,dga,3.54659,1,11,13,1,0.09091,0.27281,0,0,0,0,0,0,0,0,0,0
7385,eagvynlxrn.com,dga,3.6645,3,10,14,1,0.3,0.26175,1,0,0,0,1,1,0,0,0,1
1507,remote-settings.prod.webservices.mozgcp.net,legit,3.91089,12,26,43,0,0.46154,0.09095,14,6,4,3,27,11,4,1,0,16
4636,v25.tiktokcdn-us.com.c.footprint.net,legit,3.92745,8,20,36,0,0.4,0.1091,12,9,9,7,37,6,3,1,0,10
8963,hhcjftaixkxctef.net,dga,3.47135,4,14,19,1,0.28571,0.1827,2,0,0,0,2,2,0,0,0,2
256,criteo.com,legit,2.92193,4,5,10,0,0.8,0.29219,2,0,0,0,2,3,0,0,0,3
3728,dual-spo-0003.spo-msedge.net,legit,3.84237,7,12,28,0,0.58333,0.13723,3,2,1,0,6,3,0,0,0,3
1623,cdn.odc.officeapps.live.com,legit,3.61582,8,15,27,0,0.53333,0.13392,10,7,5,3,25,5,0,0,0,5
6721,soqafils.ru,dga,3.27761,4,6,11,1,0.66667,0.29796,0,0,0,0,0,0,0,0,0,0
6339,ryrtufoxaysro.com,dga,3.41042,5,11,17,1,0.45455,0.20061,1,0,0,0,1,0,0,0,0,0
8904,heowivit.ru,dga,3.27761,5,5,11,1,1.0,0.29796,0,0,0,0,0,1,0,0,0,1
1993,js.hs-banner.com,legit,3.625,3,10,16,0,0.3,0.22656,2,0,0,0,2,3,0,0,0,3
5225,cewumsur.com,dga,3.08496,4,7,12,1,0.57143,0.25708,1,0,0,0,1,2,0,0,0,2
362,android.googleapis.com,legit,3.64125,9,11,22,0,0.81818,0.16551,7,6,4,4,21,5,1,0,0,6
7473,uponenjoy.net,dga,3.02699,5,7,13,1,0.71429,0.23285,2,0,0,0,2,3,1,0,0,4
9950,pufolal.info,dga,3.08496,5,6,12,1,0.83333,0.25708,0,0,0,0,0,1,0,0,0,1
4741,www.tm.v4.a.prd.aadg.trafficmanager.net,legit,3.71038,9,22,39,0,0.40909,0.09514,10,4,1,3,18,6,1,0,0,7
2906,x1.i.lencr.org,legit,3.32486,3,7,14,0,0.42857,0.23749,3,0,0,0,3,2,0,0,0,2
5054,i828ywu0ywqs.net,dga,3.625,3,8,16,1,0.375,0.22656,0,0,0,0,0,0,0,0,0,0
8863,fclanmddkbafbdca.online,dga,3.55553,6,16,23,1,0.375,0.15459,0,0,0,0,0,4,0,0,0,4
5021,eqsaadnus.ddns.net,dga,3.04411,5,11,18,1,0.45455,0.16912,5,1,0,0,6,4,3,3,2,12
4218,a.prd.aadg.trafficmanager.net,legit,3.46954,9,16,29,0,0.5625,0.11964,10,4,1,3,18,6,1,0,0,7
2490,cagenerator.pki.strln.net,legit,3.61288,7,15,25,0,0.46667,0.14452,6,1,0,0,7,9,0,0,0,9
9968,oldutinw.com,dga,3.4183,4,7,12,1,0.57143,0.28486,2,0,0,0,2,2,0,0,0,2
9429,zixw.am,dga,2.80735,2,4,7,1,0.5,0.40105,0,0,0,0,0,0,0,0,0,0
6478,esuoawgo.com.mx,dga,3.32323,6,7,15,1,0.85714,0.22155,3,2,1,0,6,4,2,1,0,7
2940,adtelligent.com,legit,3.50689,5,9,15,0,0.55556,0.23379,6,1,0,0,7,4,1,0,0,5
9544,ficlimxcsscmary.com,dga,3.36609,4,14,19,1,0.28571,0.17716,3,1,0,0,4,3,0,0,0,3
9596,gcdykiqaafrhanh.co,dga,3.68354,5,12,18,1,0.41667,0.20464,1,0,0,0,1,1,0,0,0,1
8222,s0stm0qfobubqbs.ddns.net,dga,3.55351,3,17,24,1,0.17647,0.14806,4,1,0,0,5,5,3,3,2,13
616,secure.netflix.com,legit,3.68354,6,10,18,0,0.6,0.20464,4,0,0,0,4,5,0,0,0,5
3028,syndication.twimg.com,legit,3.59447,6,13,21,0,0.46154,0.17117,5,0,0,0,5,6,3,2,1,12
1637,ecs.nel.measure.office.net,legit,3.48853,10,12,26,0,0.83333,0.13417,8,4,4,3,19,9,0,0,0,9
98,ecs.office.com,legit,2.89629,5,7,14,0,0.71429,0.20688,4,4,4,3,15,3,0,0,0,3
8715,zlcqpryjhknjlno.com,dga,3.72161,2,16,19,1,0.125,0.19587,1,0,0,0,1,0,0,0,0,0
5794,saenukut.ddns.net,dga,3.10188,5,10,17,1,0.5,0.18246,3,1,0,0,4,5,3,2,1,11
9159,hpcfhnbduy.com,dga,3.52164,2,11,14,1,0.18182,0.25155,0,0,0,0,0,0,0,0,0,0
4901,connexity.net,legit,3.02699,4,8,13,0,0.5,0.23285,2,1,0,0,3,4,1,0,0,5
9399,mnhbrcighypyofbtf.net,dga,3.82089,3,17,21,1,0.17647,0.18195,1,0,0,0,1,0,0,0,0,0
6685,xxphxlhhlcsaks.ru,dga,3.29277,2,14,17,1,0.14286,0.19369,0,0,0,0,0,0,0,0,0,0
5510,ikjwladsholapet.cc,dga,3.83659,5,12,18,1,0.41667,0.21314,3,0,0,0,3,2,0,5,5,12
3157,vpaid.vidoomy.com,legit,3.21953,6,9,17,0,0.66667,0.18938,2,0,0,0,2,1,0,0,0,1
7520,rwtdikqvii.com,dga,3.46772,4,9,14,1,0.44444,0.24769,0,0,0,0,0,0,0,0,0,0
9828,dcmnflcdlccafaoa.co,dga,2.96558,5,13,19,1,0.38462,0.15608,1,0,0,0,1,1,0,0,0,1
7071,experienceinterviewwakescale.com,dga,3.70282,14,17,32,1,0.82353,0.11571,8,0,0,0,8,9,4,2,0,15
9300,uxthhdxilsycvki.info,dga,3.88418,5,14,20,1,0.35714,0.19421,0,0,0,0,0,0,0,0,0,0
8967,slqxjsnfojuhh.info,dga,3.50326,4,13,18,1,0.30769,0.19463,0,0,0,0,0,0,0,0,0,0
6851,woodenmason.com,dga,3.10689,6,8,15,1,0.75,0.20713,4,0,0,0,4,5,0,0,0,5
3725,cs.minutemedia-prebid.com,legit,3.83327,9,13,25,0,0.69231,0.15333,8,1,0,0,9,6,0,0,0,6
2015,memex-pa.googleapis.com,legit,3.55553,9,11,23,0,0.81818,0.15459,5,6,4,4,19,4,0,0,0,4
9498,ijmvhvphsdujcu.net,dga,3.72548,4,13,18,1,0.30769,0.20697,0,0,0,0,0,0,0,0,0,0
7450,osmvmcdnxi.com,dga,3.18201,3,10,14,1,0.3,0.22729,2,1,0,0,3,1,0,0,0,1
1784,push-rtmp-f5-tt02.fcdn.us.tiktokv.com,legit,4.11852,5,22,37,0,0.22727,0.11131,6,7,5,3,21,2,0,0,0,2
2141,a1947.z.akamai.net,legit,3.46132,6,5,18,0,1.2,0.1923,3,3,4,3,13,2,0,0,0,2
2196,pull-w5-gcp01.tiktokcdn.com.c.bytefcdn-oversea.com,legit,4.41617,10,29,50,0,0.34483,0.08832,10,10,12,10,42,9,5,1,0,15
566,tiktok.com,legit,2.72193,3,6,10,0,0.5,0.27219,1,4,3,2,10,1,0,0,0,1
2164,prod-scout-reg.rootsoc.com,legit,3.43046,8,14,26,0,0.57143,0.13194,6,2,1,0,9,2,1,0,0,3
5672,byoljbjregchfbtd.eu,dga,3.78714,4,14,19,1,0.28571,0.19932,1,0,0,0,1,1,0,0,0,1
4335,graph-fallback.facebook.com,legit,3.73601,8,16,27,0,0.5,0.13837,4,0,0,0,4,3,0,0,0,3
2981,nextmillmedia.com,legit,3.45482,6,10,17,0,0.6,0.20322,2,0,0,0,2,3,0,0,0,3
4434,e9126.x.akamaiedge.net,legit,3.66353,8,7,22,0,1.14286,0.16652,5,5,5,3,18,4,0,0,0,4
2030,go.trouter.teams.microsoft.com,legit,3.46958,10,16,30,0,0.625,0.11565,13,8,7,6,34,6,1,0,0,7
6635,tracksperiod.net,dga,3.625,5,10,16,1,0.5,0.22656,2,0,0,0,2,4,2,0,0,6
5238,wentjuly.net,dga,3.08496,3,8,12,1,0.375,0.25708,2,1,0,0,3,1,1,0,0,2
1320,excelonline.nel.measure.office.net,legit,3.53585,14,16,34,0,0.875,0.104,11,4,4,3,22,10,1,0,0,11
8454,bnmwtrjn.com,dga,3.25163,1,10,12,1,0.1,0.27097,0,0,0,0,0,0,0,0,0,0
3044,imgix.net,legit,2.9477,3,5,9,0,0.6,0.32752,0,0,0,0,0,0,0,0,0,0
180,arc.msn.com,legit,2.91398,2,7,11,0,0.28571,0.26491,1,0,0,0,1,1,0,0,0,1
7592,blpjrcfjfgtximybi.tw,dga,3.82193,2,17,20,1,0.11765,0.1911,0,0,0,0,0,0,0,0,0,0
9930,q0mgqoi46si8.top,dga,3.625,4,7,16,1,0.57143,0.22656,0,0,0,0,0,1,0,0,0,1
2959,calendars.icloud.com,legit,3.58418,7,11,20,0,0.63636,0.17921,6,3,2,1,12,6,0,0,0,6
4706,boomtrain.com,legit,3.18083,5,7,13,0,0.71429,0.24468,3,0,0,0,3,3,1,0,0,4
3201,guce.yahoo.com,legit,3.18201,6,6,14,0,1.0,0.22729,3,0,0,1,4,1,0,0,0,1
8829,4ridsn88b8rp363l3f.biz,dga,3.75444,2,11,22,1,0.18182,0.17066,1,0,0,0,1,1,0,0,0,1
6726,ergttxirjrmnqnd.net,dga,3.39189,3,15,19,1,0.2,0.17852,1,0,0,0,1,2,0,0,0,2
9367,qg68u0y4ecm4.top,dga,3.875,3,7,16,1,0.42857,0.24219,0,0,0,0,0,1,0,0,0,1
4180,events.ads.vungle.com,legit,3.65376,6,12,21,0,0.5,0.17399,7,2,0,0,9,3,1,0,0,4
1894,waluigi.goguardian.com,legit,3.53831,10,10,22,0,1.0,0.16083,0,1,0,0,1,2,0,0,0,2
4559,kaspersky.com,legit,3.39275,3,9,13,0,0.33333,0.26098,1,0,0,0,1,2,1,0,0,3
134,cloudflare.com,legit,3.37878,5,8,14,0,0.625,0.24134,3,3,2,1,9,3,0,0,0,3
6232,atauncejdrredc.co.uk,dga,3.48418,7,11,20,1,0.63636,0.17421,7,1,0,0,8,6,2,0,0,8
8259,jtromgn.com,dga,3.0958,2,8,11,1,0.25,0.28144,1,0,0,0,1,1,0,0,0,1
1816,a.fc.namequery.com,legit,3.46132,6,9,18,0,0.66667,0.1923,2,0,0,0,2,2,0,0,0,2
8661,awi4yomsqkm8.net,dga,3.875,4,9,16,1,0.44444,0.24219,0,0,0,0,0,1,0,0,0,1
8082,bnhdxovertxnbtcvbxnu.org,dga,3.65727,4,19,24,1,0.21053,0.15239,1,0,0,0,1,2,2,0,0,4
9941,psbnsmmuqoni.xyz,dga,3.625,3,12,16,1,0.25,0.22656,1,0,0,0,1,3,0,0,0,3
181,update.microsoft.com,legit,3.68418,7,11,20,0,0.63636,0.18421,9,8,7,6,30,4,1,0,0,5
2254,49-courier.push.apple.com,legit,3.86347,8,11,25,0,0.72727,0.15454,9,4,3,2,18,4,0,0,0,4
97,googlesyndication.com,legit,3.63041,8,12,21,0,0.66667,0.17288,7,4,3,2,16,8,3,2,1,14
3761,buy.itunes.apple.com,legit,3.78418,7,10,20,0,0.7,0.18921,7,4,3,2,16,4,0,0,0,4
1428,ping.citrix.com,legit,3.32323,4,9,15,0,0.44444,0.22155,3,0,0,0,3,3,1,0,0,4
25,update.googleapis.com,legit,3.6897,9,10,21,0,0.9,0.1757,8,6,4,4,22,5,1,0,0,6
6126,oqge4ic6k2ce.net,dga,3.57782,5,7,16,1,0.71429,0.22361,3,0,0,0,3,3,0,0,0,3
2796,widget-mediator.zopim.com,legit,3.75327,9,13,25,0,0.69231,0.15013,4,1,0,0,5,5,0,0,0,5
1794,com.atomile.com,legit,3.00624,6,7,15,0,0.85714,0.20042,5,2,2,1,10,5,1,0,0,6
3040,config.uca.cloud.unity3d.com,legit,3.68201,9,14,28,0,0.64286,0.1315,6,4,3,2,15,5,1,0,0,6
3711,suggestqueries.l.google.com,legit,3.48583,10,14,27,0,0.71429,0.1291,7,5,4,3,19,7,2,0,0,9
7080,lwtvtfsnkujjrblj.xxx,dga,3.64644,1,18,20,1,0.05556,0.18232,0,0,0,0,0,0,0,0,0,0
1914,player.aniview.com,legit,3.72548,7,9,18,0,0.77778,0.20697,3,0,0,0,3,4,0,0,0,4
4004,cksync.yahoo.co.jp,legit,3.26633,4,11,18,0,0.36364,0.18146,3,1,0,1,5,1,1,0,0,2
4192,signal-metrics-collector-beta.s-onetag.com,legit,3.81459,13,23,42,0,0.56522,0.09082,5,0,0,0,5,12,1,0,0,13
9869,xgbjvkogtfednprc.com,dga,4.02193,3,16,20,1,0.1875,0.2011,3,0,0,0,3,2,0,0,0,2
426,notifications-pa.googleapis.com,legit,3.71663,13,15,31,0,0.86667,0.11989,9,7,4,4,24,9,3,2,1,15
8236,vswtyxbyfmdbhkcj.eu,dga,4.0374,2,16,19,1,0.125,0.21249,0,0,0,0,0,0,0,0,0,0
6469,om8a46smsqw2.net,dga,3.75,3,8,16,1,0.375,0.23438,0,0,0,0,0,1,0,0,0,1
3357,public.wnrtm-a-2.prod.infra.webex.com,legit,4.17257,9,20,37,0,0.45,0.11277,7,4,3,2,16,4,2,0,0,6
5517,ce8qsecusq4m.net,dga,3.32782,4,9,16,1,0.44444,0.20799,3,0,0,0,3,3,0,0,0,3
5373,xeiwahhkos.com,dga,3.52164,5,8,14,1,0.625,0.25155,0,0,0,0,0,0,0,0,0,0
5104,mabonuk.info,dga,3.25163,5,6,12,1,0.83333,0.27097,2,0,0,0,2,2,0,0,0,2
8761,issamuwgo.com,dga,3.2389,5,7,13,1,0.71429,0.24915,1,0,0,0,1,2,0,0,0,2
1090,js7k.com,legit,3.0,1,5,8,0,0.2,0.375,0,0,0,0,0,0,0,0,0,0
3969,transient.amazon.com,legit,3.44644,7,11,20,0,0.63636,0.17232,7,2,3,3,15,8,3,0,0,11
4957,api16-core-c-useast1a.tiktokv.com,legit,3.96032,11,14,33,0,0.78571,0.12001,10,7,4,3,24,8,0,0,0,8
9134,aedxymrpcwhoxrxvg.me,dga,3.78418,4,15,20,1,0.26667,0.18921,1,0,0,0,1,1,0,0,0,1
7347,olimhooperreddeiiquo.com,dga,3.45499,12,11,24,1,1.09091,0.14396,5,0,0,0,5,5,0,0,0,5
6984,orvzopuprtrcofw.com,dga,3.36609,5,13,19,1,0.38462,0.17716,3,0,0,0,3,2,0,0,0,2
8716,rabonismaioris.com,dga,3.19716,8,9,18,1,0.88889,0.17762,3,0,0,0,3,7,1,0,0,8
275,beacons.gvt2.com,legit,3.625,4,9,16,0,0.44444,0.22656,4,1,0,0,5,6,1,0,0,7
2288,js.hs-scripts.com,legit,3.38158,2,12,17,0,0.16667,0.19892,2,0,0,0,2,1,0,0,0,1
7213,aylpej.be,dga,2.9477,3,5,9,1,0.6,0.32752,0,0,0,0,0,0,0,0,0,0
3134,contile-images.services.mozilla.com,legit,3.79987,13,18,35,0,0.72222,0.10857,14,4,1,1,20,12,3,1,0,16
3091,spotifycdn.com,legit,3.52164,3,10,14,0,0.3,0.25155,3,1,0,0,4,2,0,0,0,2
3838,client-log.box.com,legit,3.57243,5,10,18,0,0.5,0.19847,4,1,0,0,5,1,1,0,0,2
5383,olihwef.com,dga,3.27761,4,6,11,1,0.66667,0.29796,1,0,0,0,1,0,0,0,0,0
3059,sharethru.com,legit,3.39275,4,8,13,0,0.5,0.26098,1,0,0,0,1,3,0,0,0,3
8054,iktrbhwaonoyqlul.eu,dga,3.93214,7,11,19,1,0.63636,0.20695,1,1,0,0,2,1,0,0,0,1
3313,alcmpn.com,legit,2.92193,2,7,10,0,0.28571,0.29219,0,0,0,0,0,0,0,0,0,0
8766,indulgentiarumexcipiendo.com,dga,3.82486,12,15,28,1,0.8,0.1366,6,1,0,0,7,6,1,0,0,7
3462,img-prod.pocket.prod.cloudops.mozgcp.net,legit,3.86596,10,24,40,0,0.41667,0.09665,8,7,6,4,25,1,1,0,0,2
4302,a1744.dscw154.akamai.net,legit,3.77206,6,8,24,0,0.75,0.15717,5,3,4,3,15,3,0,0,0,3
3915,tag.wknd.ai,legit,3.0958,3,6,11,0,0.5,0.28144,1,0,0,0,1,2,0,0,0,2
8689,lkkricsdyfbe.com,dga,3.75,3,12,16,1,0.25,0.23438,1,0,0,0,1,3,0,0,0,3
6781,tfmhsvvikdiagotkb.cc,dga,3.82193,4,15,20,1,0.26667,0.1911,0,0,0,0,0,0,0,0,0,0
339,waconafd.officeapps.live.com,legit,3.74398,10,15,28,0,0.66667,0.13371,11,6,4,3,24,7,1,0,0,8
3657,telem-edge.smartscreen.microsoft.com,legit,3.72439,11,21,36,0,0.52381,0.10346,14,10,8,6,38,12,0,0,0,12
7057,unwvjxmdncwxewamj.su,dga,3.58418,4,15,20,1,0.26667,0.17921,2,0,0,0,2,2,0,0,0,2
8274,gy4mcmk6k2g6.top,dga,3.5,1,10,16,1,0.1,0.21875,0,0,0,0,0,0,0,0,0,0
7562,mctnyoydu.com,dga,3.08506,3,9,13,1,0.33333,0.23731,0,0,0,0,0,0,0,0,0,0
6144,toolpersuaderealizeguyhave.com,dga,4.00291,14,15,30,1,0.93333,0.13343,6,0,0,0,6,6,2,0,0,8
3634,i.ebayimg.com,legit,3.2389,5,6,13,0,0.83333,0.24915,0,0,0,0,0,0,0,0,0,0
1051,pull-cmaf-l16-gcp01.tiktokcdn.com,legit,4.08955,5,19,33,0,0.26316,0.12393,5,6,9,9,29,3,0,0,0,3
5459,hcqgwtbaixwxcgsk.eu,dga,3.82687,4,14,19,1,0.28571,0.20141,0,0,0,0,0,0,0,0,0,0
8331,folirgafda.com,dga,3.37878,5,8,14,1,0.625,0.24134,1,0,0,0,1,0,0,0,0,0
9789,gradeorganizetwistbecome.com,dga,3.85182,11,16,28,1,0.6875,0.13756,4,1,0,0,5,12,2,0,0,14
2303,images.outbrainimg.com,legit,3.66353,9,11,22,0,0.81818,0.16652,7,1,0,0,8,6,0,0,0,6
1710,kampyle.com,legit,3.27761,3,7,11,0,0.42857,0.29796,2,0,0,0,2,2,0,0,0,2
3724,prod.rewardsplatform.microsoft.com,legit,3.71308,9,22,34,0,0.40909,0.10921,12,11,9,7,39,7,1,0,0,8
7596,uipwhxlkvvwg.biz,dga,3.625,3,12,16,1,0.25,0.22656,0,0,0,0,0,0,0,0,0,0
588,events.data.msn.com,legit,3.36609,5,11,19,0,0.45455,0.17716,7,1,0,0,8,5,1,0,0,6
7788,yftd.com.bs,dga,3.27761,1,8,11,1,0.125,0.29796,3,2,1,0,6,2,2,1,0,5
318,v.aaplimg.com,legit,3.2389,4,7,13,0,0.57143,0.24915,4,0,0,0,4,0,0,0,0,0
2405,remote-data.urbanairship.com,legit,3.92325,11,14,28,0,0.78571,0.14012,4,0,0,0,4,6,0,0,0,6
7490,muatosdxfrexb28ctgre31j36jqn10gqmueu.info,dga,4.54024,10,22,41,1,0.45455,0.11074,2,0,0,0,2,2,0,0,0,2
2118,1666945197.rsc.cdn77.org,legit,3.65727,1,8,24,0,0.125,0.15239,3,1,0,0,4,1,0,0,0,1
7257,kygccyuiuwoqguoo.org,dga,3.24644,8,11,20,1,0.72727,0.16232,1,0,0,0,1,0,0,0,0,0
5588,ozpfguliks.com,dga,3.6645,4,9,14,1,0.44444,0.26175,1,0,0,0,1,0,0,0,0,0
7478,7rgv1hiv3li8ytwp3p5.ddns.net,dga,4.23593,3,17,28,1,0.17647,0.15128,3,1,0,0,4,4,3,2,2,11
7425,cloudexcusebluestrikeclaim.com,dga,3.7899,12,17,30,1,0.70588,0.12633,6,3,2,1,12,7,1,0,0,8
4423,byoip.nt.meraki.com,legit,3.68188,6,10,19,0,0.6,0.19378,5,0,0,0,5,2,0,0,0,2
7734,awwohidse.com,dga,3.39275,5,7,13,1,0.71429,0.26098,2,0,0,0,2,1,0,0,0,1
7204,eltcgpyyulnviahsztm.com,dga,4.08878,5,17,23,1,0.29412,0.17777,0,0,0,0,0,1,0,0,0,1
4461,bookkeeper.itunes.apple.com,legit,3.72251,11,13,27,0,0.84615,0.13787,9,4,3,2,18,5,0,0,0,5
4199,optimized-by.rubiconproject.com,legit,3.93775,10,18,31,0,0.55556,0.12702,8,2,0,0,10,7,2,0,0,9
653,ads.yieldmo.com,legit,3.37356,5,8,15,0,0.625,0.2249,3,0,0,0,3,1,0,0,0,1
3418,6.ras.yahoo.com,legit,3.13957,5,6,15,0,0.83333,0.2093,3,0,0,1,4,2,0,0,0,2
4533,cs.chocolateplatform.com,legit,3.50163,7,15,24,0,0.46667,0.1459,6,0,0,0,6,5,1,0,0,6
65,youtube.com,legit,3.0958,5,5,11,0,1.0,0.28144,1,0,0,0,1,1,0,0,0,1
9677,soioemkyieqmmmik.org,dga,3.24644,8,11,20,1,0.72727,0.16232,1,0,0,0,1,2,0,0,0,2
4604,b1-chidc2.zemanta.com,legit,3.88018,5,11,21,0,0.45455,0.18477,3,0,0,0,3,4,0,0,0,4
2470,cws.conviva.com,legit,3.1899,4,9,15,0,0.44444,0.21266,4,2,0,0,6,2,2,0,0,4
5818,bokrokfi.ru,dga,2.91398,4,6,11,1,0.66667,0.26491,1,0,0,0,1,0,0,0,0,0
735,cms.quantserve.com,legit,3.61437,5,11,18,0,0.45455,0.2008,4,1,1,0,6,4,2,1,0,7
2957,telephonyspamprotect-pa.googleapis.com,legit,3.86032,13,22,38,0,0.59091,0.10159,10,7,4,4,25,8,1,0,0,9
1720,deviceintegritytokens-pa.googleapis.com,legit,4.02593,15,21,39,0,0.71429,0.10323,11,8,4,4,27,12,0,1,0,13
2239,42-courier.push.apple.com,legit,3.86347,8,11,25,0,0.72727,0.15454,9,4,3,2,18,4,0,0,0,4
1937,gycpi.b.yahoodns.net,legit,3.78418,5,12,20,0,0.41667,0.18921,3,1,0,1,5,2,1,0,0,3
2209,2-courier.push.apple.com,legit,3.77206,8,11,24,0,0.72727,0.15717,9,4,3,2,18,4,0,0,0,4
1212,aadcdn.msauth.net,legit,3.33718,5,10,17,0,0.5,0.1963,4,2,1,0,7,1,0,0,0,1
2016,abs.twimg.com,legit,3.39275,3,8,13,0,0.375,0.26098,2,0,0,0,2,0,0,0,0,0
8753,cxssnceeuulvauw.com,dga,3.53689,7,11,19,1,0.63636,0.18615,1,0,0,0,1,1,1,0,0,2
9820,khysxjotlwnqtef.ru,dga,4.05881,3,14,18,1,0.21429,0.22549,1,0,0,0,1,1,0,0,0,1
1822,trc-events.taboola.com,legit,3.66353,7,12,22,0,0.58333,0.16652,6,1,0,0,7,4,1,0,0,5
8251,knqrfnjgmrfxr.com,dga,3.45482,1,15,17,1,0.06667,0.20322,0,0,0,0,0,0,0,0,0,0
8747,newiasir.ddns.net,dga,3.21953,5,10,17,1,0.5,0.18938,2,1,0,0,3,7,3,2,1,13
78,content-autofill.googleapis.com,legit,3.82131,12,16,31,0,0.75,0.12327,11,8,4,4,27,7,2,0,0,9
9547,emswwccseiqemsaq.org,dga,3.44644,6,13,20,1,0.46154,0.17232,1,0,0,0,1,2,0,0,0,2
6303,fbmlobommbdcmaaa.eu,dga,3.2211,7,11,19,1,0.63636,0.16953,2,0,0,0,2,2,0,0,0,2
6902,1pudktw6ihk8cxyfk83nwpa.ddns.net,dga,4.24173,4,21,32,1,0.19048,0.13255,2,1,0,0,3,4,4,3,2,13
1225,cpe.dotomi.com,legit,3.03915,5,7,14,0,0.71429,0.21708,3,0,0,0,3,3,1,0,0,4
5926,simonettedonaldson.net,dga,3.26558,8,13,22,1,0.61538,0.14844,4,0,0,0,4,6,1,0,0,7
3795,cds.d2s7q6s2.hwcdn.net,legit,3.53831,1,14,22,0,0.07143,0.16083,5,1,0,0,6,2,0,0,0,2
4247,tags.rd.linksynergy.com,legit,3.88205,4,16,23,0,0.25,0.16878,6,0,0,0,6,4,0,0,0,4
4492,appboycdn.com,legit,3.2389,3,9,13,0,0.33333,0.24915,4,2,0,0,6,1,0,0,0,1
781,gspe19-ssl.ls.apple.com,legit,3.46858,4,13,23,0,0.30769,0.15081,6,4,3,2,15,1,0,0,0,1
4602,com-v1.edgesuite.net,legit,3.72193,7,9,20,0,0.77778,0.1861,5,3,1,0,9,8,1,0,0,9
2295,rubiconproject.net.akadns.net,legit,3.81437,9,17,29,0,0.52941,0.13153,8,5,4,3,20,8,3,0,0,11
638,verisign.com,legit,3.4183,4,7,12,0,0.57143,0.28486,1,0,0,0,1,5,3,0,0,8
5475,xulaked.info,dga,3.58496,5,6,12,1,0.83333,0.29875,1,0,0,0,1,2,0,0,0,2
350,bat.bing.com,legit,3.25163,3,7,12,0,0.42857,0.27097,2,0,0,0,2,2,1,0,0,3
3701,video.us.bytedance.map.fastly.net,legit,3.91956,10,18,33,0,0.55556,0.11877,11,1,0,0,12,8,1,1,0,10
338,r2m02.amazontrust.com,legit,3.59447,5,11,21,0,0.45455,0.17117,7,1,3,3,14,4,0,0,0,4
2693,onedscolprdwus02.westus.cloudapp.azure.com,legit,3.98709,13,23,42,0,0.56522,0.09493,17,4,3,4,28,7,2,0,0,9
23,g.doubleclick.net,legit,3.61687,5,10,17,0,0.5,0.21276,5,0,0,0,5,4,0,0,0,4
9195,bkiuelpyudxpjaxve.ga,dga,3.82193,7,12,20,1,0.58333,0.1911,0,0,0,0,0,2,0,0,0,2
2484,chatsvcagg.gcc.teams.microsoft.com,legit,3.5569,8,22,34,0,0.36364,0.10461,12,8,7,6,33,7,1,0,0,8
5165,fnqqnqkvvuuv.com,dga,3.15564,3,12,16,1,0.25,0.19723,0,0,0,0,0,0,0,0,0,0
9118,emqucqyaiqqmqmku.org,dga,3.4037,6,13,20,1,0.46154,0.17018,0,0,0,0,0,1,0,0,0,1
6059,lvrofiaqfdojerwljvkwpllbi.org,dga,3.90937,7,21,29,1,0.33333,0.13481,4,0,0,0,4,1,0,0,0,1
6762,rnuossqkexsqqiz.info,dga,3.54644,6,13,20,1,0.46154,0.17732,0,0,0,0,0,0,0,0,0,0
2495,update.rubiconproject.com,legit,3.78347,9,14,25,0,0.64286,0.15134,8,2,0,0,10,6,3,0,0,9
2375,wayfair.com,legit,3.27761,4,6,11,0,0.66667,0.29796,0,0,0,0,0,0,0,0,0,0
9339,oprsgekliuevrz.com,dga,3.83659,6,11,18,1,0.54545,0.21314,3,0,0,0,3,1,0,0,0,1
2183,pull-f5-gcp01.tiktokcdn.com.c.bytefcdn-oversea.com,legit,4.37617,10,29,50,0,0.34483,0.08752,10,10,12,10,42,9,5,1,0,15
9727,epvnmgncmbclemuvvbax.tw,dga,3.76227,4,18,23,1,0.22222,0.16358,1,0,0,0,1,2,0,0,0,2
6247,pfavoaogdsnqsplu.eu,dga,3.72161,7,11,19,1,0.63636,0.19587,2,0,0,0,2,0,0,0,0,0
2887,dellupdater.dell.com,legit,3.34644,6,12,20,0,0.5,0.16732,4,0,0,0,4,6,2,0,0,8
3180,proximity-a.wbx2.com,legit,3.82193,5,11,20,0,0.45455,0.1911,3,1,0,0,4,2,1,0,0,3
9294,mwxiyqeoya.info,dga,3.50689,6,8,15,1,0.75,0.23379,0,0,0,0,0,0,0,1,0,1
4813,mdcs.mshop.amazon.dev,legit,3.55852,5,13,21,0,0.38462,0.16945,7,1,3,3,14,3,0,0,0,3
1267,ocsp.godaddy.com,legit,3.15564,4,10,16,0,0.4,0.19723,2,1,0,0,3,1,0,0,0,1
9561,jtwijjocnl.com,dga,3.18201,3,10,14,1,0.3,0.22729,0,0,0,0,0,0,0,0,0,0
6653,surely-ranger.info,dga,3.68354,6,10,18,1,0.6,0.20464,4,0,0,0,4,7,0,0,0,7
2519,adcolony.com,legit,3.02206,4,7,12,0,0.57143,0.25184,4,0,0,0,4,2,0,0,0,2
4143,amazon.it,legit,2.9477,4,4,9,0,1.0,0.32752,3,1,3,2,9,3,0,0,0,3
6996,traumaearthquake.mo,dga,3.30056,9,9,19,1,1.0,0.17371,3,0,0,0,3,4,1,0,0,5
2623,shopifysvc.com,legit,3.37878,3,10,14,0,0.3,0.24134,1,0,0,0,1,0,0,0,0,0
9721,geltkertcx.com,dga,3.37878,3,10,14,1,0.3,0.24134,2,0,0,0,2,3,0,0,0,3
825,android-context-data.googleapis.com,legit,3.8973,13,18,35,0,0.72222,0.11135,12,7,4,4,27,10,2,0,0,12
495,gsp-ssl.ls-apple.com.akadns.net,legit,3.66793,6,19,31,0,0.31579,0.11832,10,9,9,9,37,5,3,1,0,9
907,tenable.com,legit,3.27761,4,6,11,0,0.66667,0.29796,3,0,0,0,3,3,0,0,0,3
7496,xbiuashsrp.com,dga,3.6645,4,9,14,1,0.44444,0.26175,0,0,0,0,0,1,0,0,0,1
6791,c37moca1um8wrfyjsm.cn,dga,3.93947,3,13,21,1,0.23077,0.18759,0,0,0,0,0,1,0,0,0,1
8702,cinotlo.com,dga,2.84535,4,6,11,1,0.66667,0.25867,2,0,0,0,2,1,0,0,0,1
3298,settings.data.microsoft.com,legit,3.63397,8,16,27,0,0.5,0.13459,13,8,7,6,34,9,1,0,0,10
228,rubiconproject.com,legit,3.53049,6,11,18,0,0.54545,0.19614,5,2,0,0,7,4,2,0,0,6
9373,gfjbrqdnvxoc.com,dga,3.75,2,13,16,1,0.15385,0.23438,1,0,0,0,1,1,0,0,0,1
2088,researchnow.com,legit,3.37356,5,9,15,0,0.55556,0.2249,4,0,0,0,4,5,1,0,0,6
1861,client.dropbox.com,legit,3.68354,5,11,18,0,0.45455,0.20464,5,1,0,0,6,2,1,0,0,3
4894,lf16-geckocdn.tiktokcdn-us.com,legit,3.9899,6,18,30,0,0.33333,0.133,6,7,8,6,27,4,0,0,0,4
1223,online.office.com,legit,3.10188,7,8,17,0,0.875,0.18246,7,4,4,3,18,5,1,0,0,6
7003,ygmiqtjuxdlafbbr.eu,dga,4.0374,5,13,19,1,0.38462,0.21249,1,0,0,0,1,2,0,0,0,2
2312,pitaya.us.tiktokv.com,legit,3.55852,7,11,21,0,0.63636,0.16945,6,5,4,3,18,3,1,0,0,4
4978,c2.piano.io,legit,2.91398,5,3,11,0,1.66667,0.26491,1,0,0,0,1,1,0,0,0,1
7383,zsqazyndypftsjwthkfj.com,dga,4.08496,2,21,24,1,0.09524,0.17021,0,0,0,0,0,1,0,0,0,1
511,imap.gmail.com,legit,3.03915,5,7,14,0,0.71429,0.21708,3,0,0,0,3,1,0,0,0,1
2694,onedscolprdwus09.westus.cloudapp.azure.com,legit,3.98709,13,23,42,0,0.56522,0.09493,17,4,3,4,28,7,2,0,0,9
861,time.android.com,legit,3.375,6,8,16,0,0.75,0.21094,4,0,0,0,4,3,1,0,0,4
4579,consumer.krxd.net,legit,3.61687,4,11,17,0,0.36364,0.21276,3,1,0,0,4,5,1,0,0,6
8235,skawqwqocmeuigow.org,dga,3.64644,7,12,20,1,0.58333,0.18232,0,0,0,0,0,0,0,0,0,0
1976,gemini.yahoo.com,legit,3.32782,7,7,16,0,1.0,0.20799,4,0,0,1,5,5,0,0,0,5
3855,hulu.com,legit,2.75,3,4,8,0,0.75,0.34375,0,0,0,0,0,0,0,0,0,0
9379,opyltkjvmefjeygmlb.com,dga,3.78875,4,17,22,1,0.23529,0.17222,0,0,0,0,0,0,0,0,0,0
2415,epdg.epc.mnc260.mcc310.pub.3gppnetwork.org,legit,4.044,6,23,42,0,0.26087,0.09629,2,0,0,0,2,3,0,0,0,3
9792,slrgoruwyugkntxd.eu,dga,3.78714,5,13,19,1,0.38462,0.19932,1,0,0,0,1,1,0,0,0,1
5485,gaomkaciw6sa.top,dga,3.57782,6,8,16,1,0.75,0.22361,0,0,0,0,0,2,0,0,0,2
7630,kuqysukamioickys.org,dga,3.58418,7,12,20,1,0.58333,0.17921,3,0,0,0,3,4,0,0,0,4
6171,rafspijepwfkwna.com,dga,3.82687,5,13,19,1,0.38462,0.20141,2,0,0,0,2,1,0,0,0,1
1588,us.akamai.net,legit,3.18083,6,5,13,0,1.2,0.24468,5,3,4,3,15,2,0,0,0,2
3052,wunderkind.co,legit,3.39275,4,8,13,0,0.5,0.26098,2,0,0,0,2,4,0,0,0,4
4171,cdn.liftoff-creatives.io,legit,3.77206,8,13,24,0,0.61538,0.15717,10,3,1,0,14,7,1,0,0,8
9453,ciaqoaayaiwiyaoc.org,dga,3.06596,11,8,20,1,1.375,0.1533,0,0,0,0,0,0,0,0,0,0
8179,o6w8ity8opoba0qps050o03.ddns.net,dga,4.0625,7,14,32,1,0.5,0.12695,2,1,0,0,3,5,3,2,2,12
9008,8e0qs6sy0e06.org,dga,3.32782,3,6,16,1,0.5,0.20799,0,0,0,0,0,0,0,0,0,0
9394,q67bcbw0781t7nc0wji.ddns.net,dga,3.96772,2,16,28,1,0.125,0.1417,2,1,0,0,3,4,4,3,2,13
2260,8-courier.push.apple.com,legit,3.77206,8,11,24,0,0.72727,0.15717,9,4,3,2,18,4,0,0,0,4
8023,qni0clevefmbotg.ddns.net,dga,3.93872,5,16,24,1,0.3125,0.16411,3,1,0,0,4,7,3,3,2,15
3343,shopifycdn.com,legit,3.52164,3,10,14,0,0.3,0.25155,3,1,0,0,4,1,0,0,0,1
880,cdn.pendo.io,legit,2.9183,4,6,12,0,0.66667,0.24319,3,2,1,0,6,3,0,0,0,3
756,instagram.c10r.instagram.com,legit,3.58362,7,16,28,0,0.4375,0.12799,6,0,0,0,6,6,0,0,0,6
8480,vuclpwdttkjr.info,dga,3.96982,3,13,17,1,0.23077,0.23352,0,0,0,0,0,0,0,0,0,0
9989,qybvtwtnfqxqiobabh.ru,dga,3.84423,4,16,21,1,0.25,0.18306,0,0,0,0,0,0,0,0,0,0
6602,rlcuscwtfeuq.co.uk,dga,3.53049,5,11,18,1,0.45455,0.19614,3,1,0,0,4,1,1,0,0,2
3541,widget.perfectmarket.com,legit,3.72018,7,15,24,0,0.46667,0.15501,3,1,0,0,4,6,0,0,0,6
891,comm-main.ess.apple.com,legit,3.44726,7,12,23,0,0.58333,0.14988,10,5,3,2,20,6,2,0,0,8
8455,mrep5vob7tw8sdwtcvi.ddns.net,dga,4.03915,4,19,28,1,0.21053,0.14426,3,1,0,0,4,5,4,3,2,14
8096,gwbgmsmhgsp.mooo.com,dga,3.08418,4,14,20,1,0.28571,0.15421,3,0,0,0,3,0,1,2,1,4
6895,areelrjr.lu,dga,2.66353,4,6,11,1,0.66667,0.24214,1,0,0,0,1,3,0,0,0,3
9140,wucy8uo2wy82.org,dga,3.25,4,7,16,1,0.57143,0.20312,0,0,0,0,0,0,0,0,0,0
9781,xafmanbi.ru,dga,3.27761,4,6,11,1,0.66667,0.29796,1,0,0,0,1,2,0,0,0,2
6670,kevapunivor.eu,dga,3.37878,7,6,14,1,1.16667,0.24134,1,0,0,0,1,2,0,0,0,2
9210,vinedem.info,dga,3.08496,5,6,12,1,0.83333,0.25708,2,0,0,0,2,5,1,0,0,6
695,services.mozilla.com,legit,3.52193,7,11,20,0,0.63636,0.1761,7,2,1,1,11,6,2,1,0,9
1334,outbrainimg.com,legit,3.50689,6,8,15,0,0.75,0.23379,3,0,0,0,3,3,0,0,0,3
5088,pdrjgeftdgaenhrg.eu,dga,3.53689,5,13,19,1,0.38462,0.18615,2,0,0,0,2,2,0,0,0,2
8491,fupfeaka.ru,dga,2.91398,5,5,11,1,1.0,0.26491,1,1,0,0,2,1,0,0,0,1
2498,dradis.netflix.com,legit,3.83659,5,11,18,0,0.45455,0.21314,4,0,0,0,4,4,0,0,0,4
415,gmail.com,legit,2.9477,3,5,9,0,0.6,0.32752,1,0,0,0,1,1,0,0,0,1
3026,pd.cdnwidget.com,legit,3.45282,3,11,16,0,0.27273,0.2158,5,2,0,0,7,3,0,0,0,3
2454,d.joinhoney.com,legit,3.32323,5,8,15,0,0.625,0.22155,3,0,0,0,3,3,1,0,0,4
5845,whalekept.eu,dga,3.18872,5,6,12,1,0.83333,0.26573,1,0,0,0,1,1,0,0,0,1
2217,www.paypal.com,legit,3.03915,3,9,14,0,0.33333,0.21708,0,0,0,0,0,0,0,0,0,0
8245,q4up12u6af72k2s.ddns.net,dga,3.97018,4,11,24,1,0.36364,0.16542,3,1,0,0,4,4,3,3,2,12
1404,oa.openxcdn.net,legit,3.1899,5,8,15,0,0.625,0.21266,3,1,0,0,4,2,0,0,0,2
3902,nytimes.com,legit,3.27761,3,7,11,0,0.42857,0.29796,2,0,0,0,2,2,0,0,0,2
9805,yuoxzs.ec,dga,3.16993,3,5,9,1,0.6,0.35221,0,0,0,0,0,0,0,0,0,0
3141,csync.smilewanted.com,legit,3.6897,5,14,21,0,0.35714,0.1757,5,0,0,0,5,5,0,0,0,5
3129,tag.bounceexchange.com,legit,3.57262,8,12,22,0,0.66667,0.16239,4,0,0,0,4,4,2,0,0,6
365,e10499.dsce9.akamaiedge.net,legit,3.72251,9,9,27,0,1.0,0.13787,8,5,5,3,21,6,0,0,0,6
5436,nkcomceobbcebnkb.co.uk,dga,3.02717,6,14,22,1,0.42857,0.1376,3,2,0,0,5,3,2,0,0,5
1879,c.betrad.com,legit,3.25163,3,7,12,0,0.42857,0.27097,2,0,0,0,2,3,1,0,0,4
9577,bepcndri.sc,dga,3.27761,2,8,11,1,0.25,0.29796,0,0,0,0,0,3,0,0,0,3
1054,pull-cmaf-l10-gcp01.tiktokcdn.com,legit,4.02895,5,19,33,0,0.26316,0.12209,5,6,9,9,29,3,0,0,0,3
4574,b16066390-frontier.amazonalexa.com,legit,4.21953,10,13,34,0,0.76923,0.1241,9,1,3,3,16,6,0,0,0,6
3483,websitereview.corp.apple.com,legit,3.69595,10,15,28,0,0.66667,0.132,11,5,3,2,21,8,3,0,0,11
6117,offerhome.net,dga,3.02699,5,7,13,1,0.71429,0.23285,2,1,0,0,3,2,0,0,0,2
4270,bugly.qq.com,legit,3.25163,2,8,12,0,0.25,0.27097,0,0,0,0,0,0,0,0,0,0
892,prebid-server.rubiconproject.com,legit,3.84002,10,19,32,0,0.52632,0.12,8,3,1,0,12,8,5,1,0,14
545,firebase-settings.crashlytics.com,legit,3.93442,9,21,33,0,0.42857,0.11922,9,0,0,0,9,8,1,0,0,9
5361,nightcomplete.net,dga,3.41042,5,11,17,1,0.45455,0.20061,4,2,0,0,6,6,1,0,0,7
5366,lysesu.info,dga,3.27761,4,6,11,1,0.66667,0.29796,2,0,0,0,2,3,0,0,0,3
2850,videoplayerhub.com,legit,3.9477,7,10,18,0,0.7,0.21932,2,0,0,0,2,3,0,0,0,3
8979,usmyumaeuuscyagg.org,dga,3.28418,8,11,20,1,0.72727,0.16421,2,0,0,0,2,1,0,0,0,1
9460,enpsln.com.jm,dga,3.2389,2,9,13,1,0.22222,0.24915,3,2,1,0,6,3,2,1,0,6
6495,kjrfvixpoipawunco.su,dga,3.92193,7,12,20,1,0.58333,0.1961,1,0,0,0,1,1,0,0,0,1
8343,onaaktdtgokbhagq.eu,dga,3.57662,7,11,19,1,0.63636,0.18824,1,0,0,0,1,1,0,0,0,1
1395,webservices.mozgcp.net,legit,3.82307,6,14,22,0,0.42857,0.17378,7,2,1,1,11,5,2,1,0,8
5020,searched-cookie.net,dga,3.61635,8,9,19,1,0.88889,0.19033,5,0,0,0,5,5,0,0,0,5
4749,iad-05.braze.com,legit,3.75,5,6,16,0,0.83333,0.23438,2,0,0,0,2,1,0,0,0,1
1579,pkicvs.cisco.com,legit,3.0,4,10,16,0,0.4,0.1875,4,0,0,0,4,3,0,0,0,3
1347,growth-pa.googleapis.com,legit,3.80351,8,13,24,0,0.61538,0.15848,6,6,4,4,20,3,0,0,0,3
7647,ekm0y0ica4e8.org,dga,3.75,5,6,16,1,0.83333,0.23438,1,0,0,0,1,2,0,0,0,2
2594,us.tiktokv.com.c.worldfcdn2.com,legit,3.8055,6,19,31,0,0.31579,0.12276,8,9,6,4,27,5,2,1,0,8
7075,tylezaq.net,dga,3.0958,3,7,11,1,0.42857,0.28144,1,0,0,0,1,1,0,0,0,1
6736,esj16d40nunqhwg53n20htntpvatp22k27kykr.com,dga,4.64208,4,25,42,1,0.16,0.11053,3,0,0,0,3,2,0,0,0,2
3479,cdn.acsbapp.com,legit,3.1899,3,10,15,0,0.3,0.21266,5,3,1,0,9,2,0,0,0,2
3533,cl2-cdn-us.origin-apple.com.akadns.net,legit,4.08307,10,20,38,0,0.5,0.10745,14,10,9,9,42,8,3,1,0,12
8200,ifgjsfjwo.dyndns.org,dga,3.52193,3,15,20,1,0.2,0.1761,2,1,0,0,3,4,4,4,3,15
9264,kobdadflfbkkneda.com,dga,3.44644,5,14,20,1,0.35714,0.17232,2,0,0,0,2,2,0,0,0,2
3704,one.impact-ad.jp,legit,3.625,5,8,16,0,0.625,0.22656,3,0,0,0,3,3,1,0,0,4
477,apps.apple.com,legit,2.95021,4,8,14,0,0.5,0.21073,6,4,3,2,15,1,0,0,0,1
5391,z3ktcq882wk6jrezyg.com,dga,4.0958,2,14,22,1,0.14286,0.18617,1,0,0,0,1,1,0,0,0,1
3049,global.siteimproveanalytics.io,legit,3.89807,12,16,30,0,0.75,0.12994,7,1,0,0,8,8,2,0,0,10
2913,casale-match.dotomi.com,legit,3.52271,8,12,23,0,0.66667,0.15316,5,0,0,0,5,8,0,0,0,8
1394,geo.yahoo.com,legit,2.93121,6,5,13,0,1.2,0.22548,2,0,0,1,3,1,0,0,0,1
7144,hnywdakvhxvuoeuap.com,dga,3.91613,7,13,21,1,0.53846,0.18648,1,0,0,0,1,0,0,0,0,0
7070,cbmfcfcaacmbecnd.com,dga,3.00869,4,15,20,1,0.26667,0.15043,0,0,0,0,0,5,0,0,0,5
8558,jpaoxujujbmusmsg.eu,dga,3.36609,7,11,19,1,0.63636,0.17716,1,0,0,0,1,0,0,0,0,0
7263,bblgzcsjuq.com,dga,3.52164,2,11,14,1,0.18182,0.25155,0,0,0,0,0,0,0,0,0,0
4053,sv.symcd.com,legit,2.9183,1,9,12,0,0.11111,0.24319,1,0,0,0,1,0,0,0,0,0
1975,cognito-identity.us-east-1.amazonaws.com,legit,3.97757,14,19,40,0,0.73684,0.09944,11,3,3,3,20,12,1,0,0,13
2420,gc.apple.com,legit,3.08496,3,7,12,0,0.42857,0.25708,5,4,3,2,14,1,0,0,0,1
7836,rfjorjhpodur.cc,dga,3.1899,3,11,15,1,0.27273,0.21266,0,0,0,0,0,1,0,0,0,1
5254,swimpharmacy.org,dga,3.625,4,11,16,1,0.36364,0.22656,1,0,0,0,1,3,0,0,0,3
6048,scylkkcqblaghtwkuxt.in,dga,3.97057,3,18,22,1,0.16667,0.18048,0,0,0,0,0,1,0,0,0,1
43,office.net,legit,2.92193,4,5,10,0,0.8,0.29219,3,4,3,2,12,2,0,0,0,2
4826,query.g03.yahoodns.net,legit,3.87966,6,11,22,0,0.54545,0.17635,3,1,0,1,5,3,1,0,0,4
2524,ec.azureedge.net,legit,3.1494,7,7,16,0,1.0,0.19684,4,2,1,2,9,4,0,0,0,4
5179,kfmkbbcflbnbbcad.co,dga,3.17611,2,16,19,1,0.125,0.16716,1,0,0,0,1,1,0,0,0,1
5964,paqdeamuolpydwaqplqszdfit.ru,dga,3.98523,8,19,28,1,0.42105,0.14233,3,0,0,0,3,4,0,0,0,4
1375,prod-streaming-video-msn-com.akamaized.net,legit,3.98709,14,22,42,0,0.63636,0.09493,12,7,7,6,32,11,3,0,0,14
7940,bittmukomwuida.ru,dga,3.45482,7,9,17,1,0.77778,0.20322,0,0,0,0,0,2,0,0,0,2
8502,lhmirpgebaooetcg.eu,dga,3.78714,8,10,19,1,0.8,0.19932,3,0,0,0,3,3,0,0,0,3
7662,ujnihftrygakpkb.net,dga,3.93214,4,14,19,1,0.28571,0.20695,0,0,0,0,0,1,0,0,0,1
1100,partners.tremorhub.com,legit,3.64125,6,14,22,0,0.42857,0.16551,4,0,0,0,4,6,1,0,0,7
1670,ssbsync-global.smartadserver.com,legit,3.90252,7,22,32,0,0.31818,0.12195,7,1,1,0,9,6,3,1,0,10
6231,yfcrnlkgjtlcgkhp.to,dga,3.72161,1,17,19,1,0.05882,0.19587,1,0,0,0,1,0,0,0,0,0
7800,mddbfaafanfaaadd.com,dga,2.80869,7,12,20,1,0.58333,0.14043,1,0,0,0,1,2,0,0,0,2
3893,augmentation.osi.office.net,legit,3.5501,12,12,27,0,1.0,0.13149,9,5,4,3,21,8,4,2,1,15
7177,iafyiqeoya.biz,dga,3.18201,7,6,14,1,1.16667,0.22729,0,0,0,0,0,0,0,1,0,1
3604,pixel.quantcount.com,legit,3.72193,7,11,20,0,0.63636,0.1861,4,0,0,0,4,3,0,0,0,3
4234,launchpad.classlink.com,legit,3.64249,6,15,23,0,0.4,0.15837,5,0,0,0,5,3,1,0,0,4
8873,bryryhbgtpgf.biz,dga,3.32782,1,14,16,1,0.07143,0.20799,0,0,0,0,0,0,0,0,0,0
1250,appsitemsuggest-pa.googleapis.com,legit,3.64243,12,18,33,0,0.66667,0.11038,10,7,4,4,25,11,1,0,0,12
2214,33-courier.push.apple.com,legit,3.78347,8,11,25,0,0.72727,0.15134,9,4,3,2,18,4,0,0,0,4
4703,shb-sync.com,legit,3.25163,1,9,12,0,0.11111,0.27097,0,0,0,0,0,0,0,0,0,0
7338,mjdufyfqbex.com,dga,3.64022,3,11,15,1,0.27273,0.24268,0,0,0,0,0,1,3,2,1,7
201,docs.google.com,legit,2.97356,5,8,15,0,0.625,0.19824,3,5,4,3,15,1,0,0,0,1
7753,ntfpqyvbdqgywg.net,dga,3.61437,1,16,18,1,0.0625,0.2008,1,0,0,0,1,0,0,0,0,0
4408,gspx-ssl.ls.apple.com,legit,3.3321,3,14,21,0,0.21429,0.15867,6,4,3,2,15,1,0,0,0,1
2060,beacon-iad3.rubiconproject.com,legit,3.90689,11,15,30,0,0.73333,0.13023,7,2,0,0,9,7,2,0,0,9
1890,gcp.api.sc-gw.com,legit,3.29277,3,10,17,0,0.3,0.19369,4,2,1,0,7,0,0,0,0,0
5678,sizijuh.info,dga,3.18872,5,6,12,1,0.83333,0.26573,0,0,0,0,0,1,0,0,0,1
9158,iwy02sa02km8.top,dga,3.75,3,7,16,1,0.42857,0.23438,0,0,0,0,0,0,0,0,0,0
8819,negotiationstationdevilhang.com,dga,3.63952,13,17,31,1,0.76471,0.1174,5,0,0,0,5,10,3,2,1,16
9976,huwexewoi.ddns.net,dga,3.46132,6,10,18,1,0.6,0.1923,2,1,0,0,3,4,4,3,2,13
1691,ib.anycast.adnxs.com,legit,3.54644,5,12,20,0,0.41667,0.17732,4,1,0,0,5,5,0,0,0,5
7553,relativestandplacelaycontinue.com,dga,3.86198,13,19,33,1,0.68421,0.11703,12,1,0,0,13,16,4,0,0,20
2984,evs.jivox.com,legit,3.2389,4,7,13,0,0.57143,0.24915,1,0,0,0,1,0,0,0,0,0
5852,u676otsfonc0crgl5xk.ddns.net,dga,4.13754,4,17,28,1,0.23529,0.14777,4,1,0,0,5,5,3,2,2,12
9586,facqdiustusucquoddistr.com,dga,3.53641,9,16,26,1,0.5625,0.13602,2,0,0,0,2,5,1,0,0,6
4367,radio.itunes.apple.com,legit,3.78875,9,10,22,0,0.9,0.17222,9,4,3,2,18,5,0,0,0,5
8670,enwehidl.com,dga,3.4183,4,7,12,1,0.57143,0.28486,1,0,0,0,1,1,0,0,0,1
8531,uvbrvlbptdc.cc,dga,3.18201,1,12,14,1,0.08333,0.22729,0,0,0,0,0,0,0,0,0,0
4266,api-glb-ausw2c.smoot.apple.com,legit,3.93957,9,15,30,0,0.6,0.13132,8,5,3,2,18,1,0,0,0,1
5591,fbigvcskc.com,dga,3.33468,2,10,13,1,0.2,0.25651,0,0,0,0,0,0,0,0,0,0
3845,tnc16-alisg.isnssdk.com,legit,3.82791,4,14,23,0,0.28571,0.16643,1,0,0,0,1,2,0,0,0,2
2199,ampcid.google.com,legit,3.33718,6,9,17,0,0.66667,0.1963,4,5,4,3,16,2,0,0,0,2
5453,pverbuminetnveniarum.com,dga,3.65727,9,14,24,1,0.64286,0.15239,4,0,0,0,4,9,2,0,0,11
7762,rjpqfyguh.com,dga,3.70044,2,10,13,1,0.2,0.28465,0,0,0,0,0,0,0,0,0,0
761,s3-1-w.amazonaws.com,legit,3.48418,5,9,20,0,0.55556,0.17421,4,1,3,3,11,3,0,0,0,3
210,amer.ng.msg.teams.microsoft.com,legit,3.51132,8,18,31,0,0.44444,0.11327,12,8,7,6,33,6,0,0,0,6
4576,ads.api.vungle.com,legit,3.79465,6,9,18,0,0.66667,0.21081,7,3,1,0,11,1,0,0,0,1
6829,oysvtnahnxc.so,dga,3.37878,3,10,14,1,0.3,0.24134,0,0,0,0,0,0,0,0,0,0
5659,kfurfsnkzakz.com,dga,3.45282,3,12,16,1,0.25,0.2158,0,0,0,0,0,0,0,0,0,0
9395,gldfdtradbbbejg.info,dga,3.64644,4,15,20,1,0.26667,0.18232,2,0,0,0,2,2,1,0,0,3
1492,us.criteo.com,legit,3.2389,5,6,13,0,0.83333,0.24915,5,0,0,0,5,3,0,0,0,3
3380,gameplayapi.intel.com,legit,3.59447,8,11,21,0,0.72727,0.17117,7,1,1,0,9,5,0,1,0,6
1515,frontier.us.tiktokv.com,legit,3.64249,7,13,23,0,0.53846,0.15837,8,5,4,3,20,3,0,0,0,3
5207,3l1tytgh5vsf7j7n383.ddns.net,dga,4.01219,1,17,28,1,0.05882,0.14329,2,1,0,0,3,4,3,2,2,11
6524,pxidwooxkjwf.com,dga,3.45282,4,11,16,1,0.36364,0.2158,1,0,0,0,1,0,0,0,0,0
2211,14-courier.push.apple.com,legit,3.86347,8,11,25,0,0.72727,0.15454,9,4,3,2,18,4,0,0,0,4
9852,uivstk.net,dga,3.12193,3,6,10,1,0.5,0.31219,1,0,0,0,1,1,0,0,0,1
7387,yzmpnlmklj.yi.org,dga,3.61687,2,13,17,1,0.15385,0.21276,0,0,0,0,0,0,0,0,0,0
5110,travelsmicrowave.biz,dga,3.82193,7,12,20,1,0.58333,0.1911,5,3,2,1,11,5,1,0,0,6
4708,boxcdn.net,legit,3.12193,2,7,10,0,0.28571,0.31219,2,1,0,0,3,1,0,0,0,1
9567,sufferfurther.net,dga,3.01307,5,11,17,1,0.45455,0.17724,1,0,0,0,1,2,1,1,0,4
5800,lurvgpydmcjbospr.eu,dga,3.93214,4,14,19,1,0.28571,0.20695,1,0,0,0,1,0,0,0,0,0
8954,moickoboofenali.ddns.net,dga,3.72018,9,13,24,1,0.69231,0.15501,7,1,0,0,8,6,4,3,2,15
173,odc.officeapps.live.com,legit,3.55553,8,12,23,0,0.66667,0.15459,8,5,4,3,20,4,0,0,0,4
8003,midihgamsa.com,dga,3.18201,5,8,14,1,0.625,0.22729,2,0,0,0,2,2,0,0,0,2
4261,norton.com,legit,2.64644,3,6,10,0,0.5,0.26464,1,0,0,0,1,2,0,0,0,2
7533,ixbedilauwakur.ddns.net,dga,3.79509,8,13,23,1,0.61538,0.165,3,1,0,0,4,7,3,2,1,13
4279,apidata.googleusercontent.com,legit,3.81437,12,15,29,0,0.8,0.13153,14,9,4,3,30,9,3,0,0,12
1494,prebid.media.net,legit,3.32782,6,8,16,0,0.75,0.20799,5,0,0,0,5,2,0,0,0,2
458,js-agent.newrelic.com,legit,3.88018,6,12,21,0,0.5,0.18477,6,2,0,0,8,6,1,0,0,7
662,cdn.cloudflare.net,legit,3.50326,5,11,18,0,0.45455,0.19463,6,5,4,2,17,4,0,0,0,4
3919,check.analytics.rlcdn.com,legit,3.74928,5,17,25,0,0.29412,0.14997,6,1,0,0,7,5,0,0,0,5
8392,qhy6wvsvsvctivmn5bc.ddns.net,dga,3.89629,2,22,28,1,0.09091,0.13915,3,1,0,0,4,5,3,2,2,12
6421,potbeneficiasinuntvepis.com,dga,3.73601,11,15,27,1,0.73333,0.13837,5,1,0,0,6,9,0,0,0,9
9685,devbbtcqbagl.com,dga,3.57782,3,12,16,1,0.25,0.22361,0,0,0,0,0,1,0,0,0,1
2302,www.storygize.net,legit,3.45482,4,11,17,0,0.36364,0.20322,1,0,0,0,1,2,0,0,0,2
1490,9.tlu.dl.delivery.mp.microsoft.com,legit,3.8588,8,19,34,0,0.42105,0.11349,11,8,7,7,33,7,1,0,0,8
5995,travellinggiving.su,dga,3.43162,6,12,19,1,0.5,0.18061,3,0,0,0,3,4,2,0,0,6
8339,religionscope.biz,dga,3.57247,7,9,17,1,0.77778,0.21015,4,0,0,0,4,5,1,0,0,6
7074,udkqunlcscckwv.in,dga,3.45482,3,13,17,1,0.23077,0.20322,0,0,0,0,0,0,0,0,0,0
4802,e40491.dscd.akamaiedge.net,legit,3.76718,8,10,26,0,0.8,0.14489,9,5,5,3,22,5,0,0,0,5
2560,vas.samsungapps.com,legit,3.26083,5,12,19,0,0.41667,0.17162,4,1,0,0,5,3,0,0,0,3
9006,rkusburuhsl.com,dga,3.32323,4,10,15,1,0.4,0.22155,1,0,0,0,1,0,0,0,0,0
9761,slwxyvufw4sb1dylkxg.ddns.net,dga,4.03915,2,22,28,1,0.09091,0.14426,2,1,0,0,3,4,3,3,2,12
170,gsp-ssl.ls.apple.com,legit,3.20869,3,13,20,0,0.23077,0.16043,6,4,3,2,15,1,0,0,0,1
9666,ganypez.com,dga,3.45943,3,7,11,1,0.42857,0.31449,0,0,0,0,0,1,0,0,0,1
8067,gtwzlr.li,dga,2.9477,1,7,9,1,0.14286,0.32752,0,0,0,0,0,0,0,0,0,0
7374,nqkshgpie.com,dga,3.70044,3,9,13,1,0.33333,0.28465,1,0,0,0,1,0,0,0,0,0
3982,com.bytewlb.akadns.net,legit,3.78875,5,14,22,0,0.35714,0.17222,5,5,5,3,18,5,2,0,0,7
8868,oceckswooomwqmou.org,dga,3.24644,8,11,20,1,0.72727,0.16232,3,0,0,0,3,3,1,0,0,4
3039,igodigital.com,legit,3.18201,6,7,14,0,0.85714,0.22729,1,0,0,0,1,2,1,0,0,3
5266,evangelinagallagher.net,dga,3.20771,9,13,23,1,0.69231,0.13947,4,0,0,0,4,6,1,0,0,7
9520,mfoywxofhorcprq.cc,dga,3.41938,3,14,18,1,0.21429,0.18997,2,0,0,0,2,1,0,0,0,1
6228,rahmdugsbk.com,dga,3.6645,3,10,14,1,0.3,0.26175,1,0,0,0,1,1,0,0,0,1
2422,tvsquared.com,legit,3.70044,4,8,13,0,0.5,0.28465,2,0,0,0,2,3,0,0,0,3
5068,lbfacefabnkbbfkm.com,dga,3.28418,4,15,20,1,0.26667,0.16421,1,0,0,0,1,2,0,0,0,2
3256,classlink.com,legit,3.2389,3,9,13,0,0.33333,0.24915,2,0,0,0,2,3,1,0,0,4
4994,btttag.com,legit,2.84644,2,7,10,0,0.28571,0.28464,1,0,0,0,1,1,0,0,0,1
7318,causamepaveroscil.com,dga,3.55852,9,11,21,1,0.81818,0.16945,4,1,0,0,5,4,1,0,0,5
1078,image4.pubmatic.com,legit,3.57662,7,9,19,0,0.77778,0.18824,5,1,0,0,6,5,1,0,0,6
699,rtb0.doubleverify.com,legit,3.91613,6,12,21,0,0.5,0.18648,4,0,0,0,4,5,2,0,0,7
3623,prod.ring.com,legit,3.2389,3,8,13,0,0.375,0.24915,4,3,2,1,10,2,3,0,0,5
5410,ckthjrlhodruqibv.eu,dga,3.93214,5,13,19,1,0.38462,0.20695,0,0,0,0,0,0,0,0,0,0
9427,qtrnzak.dynserv.com,dga,3.93214,3,14,19,1,0.21429,0.20695,3,1,1,0,5,4,5,5,4,18
6281,mce42wqoq4as.net,dga,3.625,4,8,16,1,0.5,0.22656,1,0,0,0,1,2,0,0,0,2
4648,mediatek.com,legit,3.25163,5,6,12,0,0.83333,0.27097,3,0,0,0,3,3,1,0,0,4
218,web.facebook.com,legit,3.20282,6,8,16,0,0.75,0.20018,2,0,0,0,2,2,0,0,0,2
6799,nightready.net,dga,3.37878,4,9,14,1,0.44444,0.24134,3,0,0,0,3,3,0,0,0,3
1662,bpi.rtactivate.com,legit,3.46132,6,10,18,0,0.6,0.1923,5,0,0,0,5,5,1,0,0,6
5404,caidwqyhym.com,dga,3.37878,3,10,14,1,0.3,0.24134,0,0,0,0,0,1,0,0,0,1
3618,s.cpx.to,legit,2.75,1,5,8,0,0.2,0.34375,2,0,0,0,2,0,0,0,0,0
2939,sync.extend.tv,legit,3.23593,2,10,14,0,0.2,0.23114,2,0,0,0,2,3,0,0,0,3
8910,khxbyrshpwrywkiaq.in,dga,3.72193,3,16,20,1,0.1875,0.1861,0,0,0,0,0,0,0,0,0,0
3796,calendar.yahoo.com,legit,3.41938,7,9,18,0,0.77778,0.18997,3,0,0,1,4,5,0,0,0,5
7919,dbmaobdlafccelke.org,dga,3.62193,6,13,20,1,0.46154,0.1811,2,0,0,0,2,4,0,0,0,4
1604,s-static.innovid.com,legit,3.48418,6,11,20,0,0.54545,0.17421,6,0,0,0,6,6,1,0,0,7
5931,xudukex.info,dga,3.25163,5,6,12,1,0.83333,0.27097,0,0,0,0,0,0,0,0,0,0
6203,kzqyvxawmz.com,dga,3.52164,2,11,14,1,0.18182,0.25155,0,0,0,0,0,0,0,0,0,0
2128,lightning.force.com,legit,3.61635,5,12,19,0,0.41667,0.19033,3,0,0,0,3,4,1,0,0,5
4107,geogslb.com,legit,3.0958,3,7,11,0,0.42857,0.28144,1,0,0,0,1,1,0,0,0,1
1271,unagi.amazon.com,legit,3.20282,7,7,16,0,1.0,0.20018,4,1,3,3,11,3,0,0,0,3
7760,mclrgueoya.net,dga,3.6645,5,8,14,1,0.625,0.26175,0,0,0,0,0,0,0,1,0,1
1769,config.officeapps.live.com,legit,3.63219,9,14,26,0,0.64286,0.1397,10,6,4,3,23,6,1,0,0,7
77,smartscreen.microsoft.com,legit,3.45288,7,16,25,0,0.4375,0.13812,9,8,7,6,30,6,0,0,0,6
7235,cm8icuw2oiou.net,dga,3.5,7,6,16,1,1.16667,0.21875,2,0,0,0,2,1,0,0,0,1
992,apple-cloudkit.com,legit,3.72548,6,10,18,0,0.6,0.20697,6,6,4,2,18,2,0,0,0,2
3058,dls-udc.dqa.samsung.com,legit,3.55553,5,14,23,0,0.35714,0.15459,2,0,0,0,2,3,0,0,0,3
3123,sync-dsp.ad-m.asia,legit,3.30827,4,10,18,0,0.4,0.18379,4,0,0,0,4,0,0,0,0,0
8581,oxvtbkqjemcnjortj.su,dga,3.88418,4,15,20,1,0.26667,0.19421,0,0,0,0,0,2,0,0,0,2
0,google.com,legit,2.64644,4,5,10,0,0.8,0.26464,2,4,3,2,11,1,0,0,0,1
9404,migovilr.ru,dga,3.0958,4,6,11,1,0.66667,0.28144,1,0,0,0,1,1,0,0,0,1
833,tr.snapchat.com,legit,3.37356,3,10,15,0,0.3,0.2249,2,0,0,0,2,1,1,0,0,2
6074,surname-oldest.am,dga,3.61687,6,9,17,1,0.66667,0.21276,3,0,0,0,3,5,1,0,0,6
3601,www.dwin1.com,legit,2.93121,2,8,13,0,0.25,0.22548,2,0,0,0,2,2,0,0,0,2
383,dscx.akamaiedge.net,legit,3.53689,7,10,19,0,0.7,0.18615,6,5,5,3,19,4,0,0,0,4
9068,jbivmyvojqjk.in,dga,3.32323,3,11,15,1,0.27273,0.22155,0,0,0,0,0,0,0,0,0,0
5758,iqecmouuqueucscq.org,dga,3.24644,9,10,20,1,0.9,0.16232,1,0,0,0,1,1,0,0,0,1
8739,koqdacud.ru,dga,3.0958,4,6,11,1,0.66667,0.28144,0,0,0,0,0,1,0,0,0,1
2206,24-courier.push.apple.com,legit,3.86347,8,11,25,0,0.72727,0.15454,9,4,3,2,18,4,0,0,0,4
9288,pdaejuhqzp.com,dga,3.6645,4,9,14,1,0.44444,0.26175,0,0,0,0,0,0,0,0,0,0
567,endpoint.ingress.rapid7.com,legit,3.78212,8,15,27,0,0.53333,0.14008,9,1,0,0,10,6,3,0,0,9
499,contacts.google.com,legit,3.26083,6,11,19,0,0.54545,0.17162,7,6,4,3,20,5,1,0,0,6
7032,ricacruises.com,dga,3.1899,6,8,15,1,0.75,0.21266,4,0,0,0,4,7,0,0,0,7
5643,charsuquambasilicamdari.com,dga,3.57436,11,15,27,1,0.73333,0.13238,3,0,0,0,3,8,1,1,0,10
9770,gaheh.eu,dga,2.5,4,3,8,1,1.33333,0.3125,0,0,0,0,0,0,0,0,0,0
7946,fefeekcaeobfendo.com,dga,3.16596,9,10,20,1,0.9,0.1583,1,0,0,0,1,3,0,0,0,3
9998,syo2wi86kmga.net,dga,4.0,4,8,16,1,0.5,0.25,0,0,0,0,0,0,0,0,0,0
6006,nnecessitatis.com,dga,3.21953,6,10,17,1,0.6,0.18938,5,0,0,0,5,10,3,0,0,13
3788,112.2o7.net,legit,2.91398,2,2,11,0,1.0,0.26491,0,0,0,0,0,0,0,0,0,0
3948,comcast.demdex.net,legit,3.35021,5,11,18,0,0.45455,0.18612,3,2,0,0,5,8,1,0,0,9
3580,normandy.prod.cloudops.mozgcp.net,legit,3.83608,8,21,33,0,0.38095,0.11624,9,7,6,4,26,4,2,0,0,6
286,ping-edge.smartscreen.microsoft.com,legit,3.85702,10,21,35,0,0.47619,0.1102,14,10,8,6,38,9,1,0,0,10
667,services.visualstudio.com,legit,3.65366,10,13,25,0,0.76923,0.14615,7,2,1,1,11,8,2,1,0,11
7160,otanxuontivee.ddns.net,dga,3.39081,8,12,22,1,0.66667,0.15413,7,1,0,0,8,9,4,3,2,18
8562,ballallmemcladdc.cc,dga,2.75506,4,14,19,1,0.28571,0.145,1,0,0,0,1,3,0,0,0,3
2493,classify-client.services.mozilla.com,legit,3.85021,11,21,36,0,0.52381,0.10695,10,3,1,1,15,9,4,1,0,14
6729,uqlqhyvcahuw.com,dga,3.5,4,11,16,1,0.36364,0.21875,0,0,0,0,0,1,0,0,0,1
6353,uguedmtnr.com,dga,3.39275,4,8,13,1,0.5,0.26098,1,0,0,0,1,1,0,0,0,1
9720,iqvwwk.biz,dga,2.92193,2,7,10,1,0.28571,0.29219,0,0,0,0,0,0,0,0,0,0
539,dev.virtualearth.net,legit,3.44644,7,11,20,0,0.63636,0.17232,2,0,0,0,2,4,0,0,0,4
2394,logs.browser-intake-datadoghq.com,legit,4.17303,10,19,33,0,0.52632,0.12646,10,1,0,0,11,5,1,0,0,6
7775,ipsacennonquilibette.com,dga,3.7406,10,13,24,1,0.76923,0.15586,5,0,0,0,5,7,0,0,0,7
1785,whatsapp.com,legit,3.25163,3,8,12,0,0.375,0.27097,3,1,0,0,4,1,0,0,0,1
4195,md.mp.microsoft.com.akadns.net,legit,3.69474,7,18,30,0,0.38889,0.12316,13,14,14,14,55,6,3,1,0,10
9661,jeomodac.ru,dga,3.27761,5,5,11,1,1.0,0.29796,0,0,0,0,0,2,0,0,0,2
3808,amazon.es,legit,2.9477,4,4,9,0,1.0,0.32752,3,1,3,2,9,3,0,0,0,3
2619,iosapps.itunes.apple.com,legit,3.52206,9,12,24,0,0.75,0.14675,7,4,3,2,16,4,0,0,0,4
2174,pull-f5-vr-gcp01.tiktokcdn.com.c.worldfcdn.com,legit,4.14565,6,29,46,0,0.2069,0.09012,6,10,12,10,38,5,2,1,0,8
3163,e6238.x.akamaiedge.net,legit,3.66353,8,7,22,0,1.14286,0.16652,5,5,5,3,18,4,0,0,0,4
902,mesu.g.aaplimg.com,legit,3.41938,6,9,18,0,0.66667,0.18997,5,0,0,0,5,2,0,0,0,2
2426,permutive.app,legit,3.18083,5,7,13,0,0.71429,0.24468,2,0,0,0,2,3,0,0,0,3
4569,consumer-licensing-aks2aks.md.mp.microsoft.com.akadns.net,legit,4.06967,15,33,57,0,0.45455,0.0714,20,16,14,14,64,13,5,1,0,19
5460,guefgwiugkeq.net,dga,3.28064,6,9,16,1,0.66667,0.20504,0,0,0,0,0,0,0,3,2,5
3937,us-west-1.amazonaws.com,legit,3.67531,7,11,23,0,0.63636,0.1598,7,1,3,3,14,5,1,0,0,6
9306,wilhelminaphilomena.net,dga,3.43576,9,13,23,1,0.69231,0.14938,5,0,0,0,5,5,0,0,0,5
9996,sovqwrz7zj77midnov.com,dga,3.75444,4,14,22,1,0.28571,0.17066,2,0,0,0,2,2,0,0,0,2
1818,array616.prod.do.dsp.mp.microsoft.com,legit,3.65853,8,20,37,0,0.4,0.09888,12,12,10,9,43,5,2,0,0,7
9160,vbhqvlt.com,dga,3.27761,1,9,11,1,0.11111,0.29796,0,0,0,0,0,0,0,0,0,0
3176,onevideosync.uplynk.com,legit,3.76227,7,14,23,0,0.5,0.16358,2,0,0,0,2,3,1,0,0,4
7969,kktosenansnan.org,dga,3.14629,5,11,17,1,0.45455,0.18508,2,1,0,0,3,4,2,4,3,13
12,ftl.netflix.com,legit,3.37356,3,10,15,0,0.3,0.2249,1,0,0,0,1,2,0,0,0,2
6012,qkgwaokamysqmwae.org,dga,3.48418,6,13,20,1,0.46154,0.17421,1,0,0,0,1,1,0,0,0,1
4338,graph-next.fp.measure.office.com,legit,3.97641,10,17,32,0,0.58824,0.12426,10,4,4,3,21,8,0,0,0,8
7864,lnrmbppqkelrtlmz.com,dga,3.64644,2,17,20,1,0.11765,0.18232,1,0,0,0,1,1,0,0,0,1
1268,11.tlu.dl.delivery.mp.microsoft.com,legit,3.87858,8,19,35,0,0.42105,0.11082,11,8,7,7,33,7,1,0,0,8
9934,k218q63p7x3v5tex125.ddns.net,dga,4.09307,2,13,28,1,0.15385,0.14618,3,1,0,0,4,5,3,2,2,12
5149,tncjmrrboxohtffrr.tw,dga,3.48418,2,17,20,1,0.11765,0.17421,0,0,0,0,0,0,0,0,0,0
2598,pull-flv-f10-sg01.tiktokcdn.com.rocket-cdn.com,legit,4.17847,7,27,46,0,0.25926,0.09084,7,10,12,10,39,5,2,1,0,8
5957,esseindulgentiarumtales.com,dga,3.76397,11,15,27,1,0.73333,0.13941,9,1,0,0,10,10,2,0,0,12
4263,global.dual.dotomi.weighted.com.akadns.net,legit,3.9215,14,22,42,0,0.63636,0.09337,11,6,7,7,31,8,3,1,0,12
4678,cm.ctnsnet.com,legit,2.89629,2,10,14,0,0.2,0.20688,1,0,0,0,1,3,0,0,0,3
4262,livechatinc.com,legit,3.45656,5,9,15,0,0.55556,0.23044,4,0,0,0,4,5,2,0,0,7
4345,www.yammer.com,legit,2.98523,3,9,14,0,0.33333,0.21323,2,0,0,0,2,2,0,0,0,2
2654,e-planning.net,legit,3.09307,4,8,14,0,0.5,0.22093,2,0,0,0,2,4,1,0,0,5
1916,hblg.media.net,legit,3.52164,4,8,14,0,0.5,0.25155,2,0,0,0,2,1,0,0,0,1
5177,kykgmmyuogaswuuc.org,dga,3.44644,6,13,20,1,0.46154,0.17232,0,0,0,0,0,1,0,0,0,1
2935,extend.tv,legit,2.72548,2,6,9,0,0.33333,0.30283,2,0,0,0,2,3,0,0,0,3
5562,inlqiqiivmpx.com,dga,3.25,5,10,16,1,0.5,0.20312,1,0,0,0,1,1,0,0,0,1
1231,dropbox.com,legit,3.02717,3,7,11,0,0.42857,0.2752,1,0,0,0,1,0,0,0,0,0
9236,catharinephilomena.net,dga,3.53831,9,12,22,1,0.75,0.16083,4,0,0,0,4,8,2,0,0,10
5757,gmkokeuoccywgosy.org,dga,3.38418,6,13,20,1,0.46154,0.16921,0,0,0,0,0,0,0,0,0,0
7362,imevriko.ddns.net,dga,3.49923,5,10,17,1,0.5,0.20584,2,1,0,0,3,5,4,3,2,14
8771,gljsoijwkcutwsqmjddprpyhgi.ru,dga,4.1423,5,23,29,1,0.21739,0.14284,1,0,0,0,1,1,0,0,0,1
3681,dbankcdn.com,legit,3.08496,2,9,12,0,0.22222,0.25708,2,1,1,0,4,2,0,0,0,2
7016,ccaoeboccbfmaecd.info,dga,3.2321,8,12,21,1,0.66667,0.15391,2,0,0,0,2,3,0,0,0,3
6663,vwlfsgrcgqhypcqnbvkhbinfskuw.net,dga,4.22641,3,28,32,1,0.10714,0.13208,1,0,0,0,1,1,0,0,0,1
5416,hnmylhxtwcnw.xyz,dga,3.375,0,15,16,1,0.0,0.21094,0,0,0,0,0,0,0,0,0,0
4718,wsjcm-a-10.prod.infra.webex.com,legit,4.18,7,16,31,0,0.4375,0.13484,5,4,3,2,14,3,2,0,0,5
8098,southcause.net,dga,3.23593,6,7,14,1,0.85714,0.23114,3,0,0,0,3,2,0,0,0,2
2715,onedscolprdeus03.eastus.cloudapp.azure.com,legit,3.89185,15,21,42,0,0.71429,0.09266,17,5,3,4,29,9,1,0,0,10
4304,sentry.insops.net,legit,3.17512,4,11,17,0,0.36364,0.18677,4,1,0,0,5,4,1,0,0,5
6590,sympathydeclaration.co,dga,3.87966,7,14,22,1,0.5,0.17635,4,0,0,0,4,8,3,2,1,14
7796,amountwomen.net,dga,3.05656,6,8,15,1,0.75,0.20377,4,0,0,0,4,3,0,0,0,3
3160,appdynamics.com,legit,3.37356,4,10,15,0,0.4,0.2249,5,2,0,0,7,3,1,0,0,4
2434,cdn.hadronid.net,legit,3.28064,4,10,16,0,0.4,0.20504,5,2,1,0,8,3,0,0,0,3
8711,psanitassedprint.com,dga,3.58418,6,13,20,1,0.46154,0.17921,6,0,0,0,6,9,3,0,0,12
4524,fast.wistia.com,legit,3.24022,5,8,15,0,0.625,0.21601,2,1,0,0,3,4,1,0,0,5
1001,aax-eu.amazon-adsystem.com,legit,3.68642,10,12,26,0,0.83333,0.14179,8,1,3,3,15,6,0,0,0,6
9435,fsxorektnbqjc.co.uk,dga,3.82687,4,13,19,1,0.30769,0.20141,3,1,0,0,4,3,1,0,0,4
1920,amazon.co.uk,legit,3.08496,5,5,12,0,1.0,0.25708,5,2,3,2,12,4,1,0,0,5
5765,equalhome.net,dga,3.33468,6,6,13,1,1.0,0.25651,0,0,0,0,0,1,0,0,0,1
2041,assets.bounceexchange.com,legit,3.62347,9,14,25,0,0.64286,0.14494,5,0,0,0,5,6,3,0,0,9
8156,m69bskxpyispqn10hvkzarivd40cvcqovkq.com,dga,4.40682,5,27,39,1,0.18519,0.113,0,0,0,0,0,3,0,0,0,3
3547,platform.dbankcloud.cn,legit,3.82307,5,15,22,0,0.33333,0.17378,5,3,2,1,11,5,0,0,0,5
4020,j.sni.global.fastly.net,legit,3.62118,5,14,23,0,0.35714,0.15744,2,1,0,0,3,3,0,0,0,3
6656,qnlpmmdooffooixctblcw.cc,dga,3.6683,5,18,24,1,0.27778,0.15285,2,1,0,0,3,0,0,0,0,0
7299,ogahheisu.ddns.net,dga,3.50326,6,10,18,1,0.6,0.19463,2,1,0,0,3,6,3,3,2,14
6796,vscfnykbbbe4h2wx5y.com,dga,4.06148,2,16,22,1,0.125,0.18461,0,0,0,0,0,1,0,0,0,1
4159,tm-prod-wd-csp-edge.trafficmanager.net,legit,3.95794,9,23,38,0,0.3913,0.10416,10,7,3,3,23,7,2,0,0,9
1258,x.akamaiedge.net,legit,3.28064,7,7,16,0,1.0,0.20504,5,5,5,3,18,4,0,0,0,4
9443,iulydooelfno.in,dga,3.1899,7,7,15,1,1.0,0.21266,1,0,0,0,1,1,0,0,0,1
2737,s.joinhoney.com,legit,3.32323,5,8,15,0,0.625,0.22155,3,0,0,0,3,3,1,0,0,4
843,advertising.com,legit,3.77356,5,9,15,0,0.55556,0.25157,4,0,0,0,4,6,2,0,0,8
1869,appsitemsuggest-pa.clients6.google.com,legit,3.85268,12,21,38,0,0.57143,0.10139,12,7,4,3,26,10,2,0,0,12
5586,quamcontimmospirituwitte.com,dga,3.63754,11,16,28,1,0.6875,0.12991,7,1,0,0,8,7,1,0,0,8
6411,puvawuq.info,dga,3.4183,5,6,12,1,0.83333,0.28486,0,0,0,0,0,0,0,0,0,0
9782,uovqagyxgf.com,dga,3.52164,4,9,14,1,0.44444,0.25155,0,0,0,0,0,0,0,0,0,0
1427,vungle.com,legit,3.32193,3,6,10,0,0.5,0.33219,1,1,0,0,2,1,0,0,0,1
1863,inquisition.goguardian.com,legit,3.58046,12,12,26,0,1.0,0.13771,3,1,0,0,4,8,2,1,0,11
8306,ywznusiym.com,dga,3.39275,3,9,13,1,0.33333,0.26098,1,0,0,0,1,1,0,0,0,1
975,www.googleoptimize.com,legit,3.42512,8,12,22,0,0.66667,0.15569,4,5,4,3,16,3,0,0,0,3
7614,commissionemodocertinvel.com,dga,3.4547,11,16,28,1,0.6875,0.12338,7,1,0,0,8,14,3,0,0,17
3493,p16-sign-useast2a.tiktokcdn.com,legit,4.1313,8,16,31,0,0.5,0.13327,8,7,7,6,28,7,0,0,0,7
1433,sync.smartadserver.com,legit,3.57262,5,15,22,0,0.33333,0.16239,6,1,1,0,8,6,3,1,0,10
8478,skwggeicquuacgkw.org,dga,3.52193,6,13,20,1,0.46154,0.1761,2,0,0,0,2,3,0,0,0,3
1442,v.fwmrm.net,legit,3.0958,1,8,11,0,0.125,0.28144,0,0,0,0,0,0,0,0,0,0
9297,gabaporo.ru,dga,2.91398,5,5,11,1,1.0,0.26491,2,0,0,0,2,1,0,0,0,1
3933,app.collegeboard.org,legit,3.38418,7,11,20,0,0.63636,0.16921,7,2,0,0,9,4,1,0,0,5
941,pull-q5-sg01.tiktokcdn.com,legit,4.16198,4,15,26,0,0.26667,0.16008,4,6,9,9,28,2,0,0,0,2
3070,sail-horizon.com,legit,3.57782,6,8,16,0,0.75,0.22361,1,0,0,0,1,3,0,0,0,3
213,asm.skype.com,legit,3.2389,3,8,13,0,0.375,0.24915,0,0,0,0,0,1,0,0,0,1
9446,vdhnaebgmried.org,dga,3.61687,5,11,17,1,0.45455,0.21276,1,0,0,0,1,2,0,0,0,2
3792,www.microsoft.com-c-3.edgekey.net.globalredir.akadns.net,legit,4.19226,15,31,56,0,0.48387,0.07486,15,15,13,9,52,11,3,1,0,15
4859,public.wamsm-a-3.prod.infra.webex.com,legit,4.15217,10,19,37,0,0.52632,0.11222,8,4,3,2,17,5,2,0,0,7
6065,aexebcuuptimjniei.com,dga,3.65376,10,10,21,1,1.0,0.17399,1,0,0,0,1,2,0,0,0,2
6909,quitxtopusquipapa.com,dga,3.46328,9,11,21,1,0.81818,0.16492,2,0,0,0,2,1,0,0,0,1
932,tiqcdn.com,legit,3.12193,2,7,10,0,0.28571,0.31219,3,1,0,0,4,2,0,0,0,2
4465,a.clickcertain.com,legit,3.39215,6,10,18,0,0.6,0.18845,7,0,0,0,7,5,0,0,0,5
2704,onedscolprdwus03.westus.cloudapp.azure.com,legit,3.98709,13,23,42,0,0.56522,0.09493,17,4,3,4,28,7,2,0,0,9
139,delve.office.com,legit,3.20282,6,8,16,0,0.75,0.20018,4,4,4,3,15,5,0,0,0,5
197,msftconnecttest.com,legit,3.0503,4,14,19,0,0.28571,0.16054,5,1,0,0,6,7,2,0,0,9
6978,lamiwguc.com,dga,3.25163,4,7,12,1,0.57143,0.27097,2,0,0,0,2,3,0,0,0,3
1854,edge-chat.facebook.com,legit,3.62922,8,11,22,0,0.72727,0.16496,5,2,1,0,8,5,1,0,0,6
1504,api.amplitude.com,legit,3.49923,7,8,17,0,0.875,0.20584,6,1,1,0,8,3,0,0,0,3
1270,fbsbx.com,legit,2.9477,1,7,9,0,0.14286,0.32752,0,0,0,0,0,0,0,0,0,0
3799,evgnet.com,legit,3.12193,3,6,10,0,0.5,0.31219,0,0,0,0,0,2,0,0,0,2
3429,service.force.com,legit,3.17512,6,9,17,0,0.66667,0.18677,5,2,1,1,9,5,2,1,0,8
4551,amp-api.music.apple.com,legit,3.38162,8,11,23,0,0.72727,0.14703,10,5,4,2,21,4,0,0,0,4
5919,bezzihyzeh.com,dga,3.18201,4,9,14,1,0.44444,0.22729,0,0,0,0,0,1,0,0,0,1
5176,mqbkhlimrgliatbw.eu,dga,3.82687,5,13,19,1,0.38462,0.20141,2,0,0,0,2,1,0,0,0,1
5183,scuba-qualities.sh,dga,3.57243,7,9,18,1,0.77778,0.19847,3,0,0,0,3,3,0,0,0,3
5542,heuwgmppmwanejhdn.la,dga,3.62193,5,14,20,1,0.35714,0.1811,2,0,0,0,2,3,0,0,0,3
6274,qebol.eu,dga,2.75,4,3,8,1,1.33333,0.34375,0,0,0,0,0,0,0,0,0,0
8968,mefsyiffeltl.pw,dga,3.32323,3,11,15,1,0.27273,0.22155,0,0,0,0,0,1,0,0,0,1
1898,tr.blismedia.com,legit,3.625,5,9,16,0,0.55556,0.22656,2,0,0,0,2,2,0,0,0,2
8260,cktklfxyqoodiqveiao.ki,dga,3.72013,8,13,22,1,0.61538,0.1691,1,0,0,0,1,1,0,0,0,1
9089,ghhxnmnansnan.org,dga,3.0516,3,13,17,1,0.23077,0.17951,0,0,0,0,0,2,2,4,3,11
4472,acp-ss-va6c2.adobe.io,legit,3.6897,7,8,21,0,0.875,0.1757,2,0,0,0,2,2,0,0,0,2
5647,qkciemguumuqguaa.org,dga,3.38418,9,10,20,1,0.9,0.16921,0,0,0,0,0,1,0,0,0,1
8267,xeiheabo.ru,dga,3.27761,6,4,11,1,1.5,0.29796,1,0,0,0,1,1,0,0,0,1
3637,msg.csw.lenovo.com,legit,3.30827,4,11,18,0,0.36364,0.18379,3,0,0,0,3,2,0,0,0,2
4235,paloaltonetworks.com,legit,3.62193,7,12,20,0,0.58333,0.1811,2,0,0,0,2,4,1,0,0,5
6651,mmtzhhzs8q4s3od5cm.com,dga,3.64125,2,15,22,1,0.13333,0.16551,0,0,0,0,0,0,0,0,0,0
9258,reliefrentscorereservearm.com,dga,3.36966,11,17,29,1,0.64706,0.1162,9,2,1,0,12,11,5,1,0,17
9759,cmwouaiugkeq.net,dga,3.75,7,8,16,1,0.875,0.23438,1,0,0,0,1,0,0,3,2,5
9630,gmyykgakkciqmcwe.org,dga,3.54644,4,15,20,1,0.26667,0.17732,0,0,0,0,0,0,0,0,0,0
3754,mrpdata.net,legit,3.0958,3,7,11,0,0.42857,0.28144,2,0,0,0,2,2,0,0,0,2
8401,ivvbahawwf.com,dga,3.37878,4,9,14,1,0.44444,0.24134,0,0,0,0,0,0,0,0,0,0
665,ad.360yield.com,legit,3.64022,4,6,15,0,0.66667,0.24268,2,0,0,0,2,1,0,0,0,1
2480,mrtnsvr.com,legit,3.0958,1,9,11,0,0.11111,0.28144,0,0,0,0,0,1,0,0,0,1
3356,wnrtm-a-2.prod.infra.webex.com,legit,4.01506,7,16,30,0,0.4375,0.13384,5,4,3,2,14,3,2,0,0,5
3016,dcat.dsp.trafficmanager.net,legit,3.66193,7,17,27,0,0.41176,0.13563,10,3,1,3,17,9,1,0,0,10
1351,appier.net,legit,2.92193,4,5,10,0,0.8,0.29219,4,1,0,0,5,1,0,0,0,1
8182,gokzrairqlchqmlhny.biz,dga,3.91398,4,17,22,1,0.23529,0.17791,1,0,0,0,1,1,0,0,0,1
3440,widget-pixels.outbrain.com,legit,4.20987,9,14,26,0,0.64286,0.16192,6,1,0,0,7,5,0,0,0,5
7747,wituceij.ru,dga,3.0958,5,5,11,1,1.0,0.28144,1,0,0,0,1,2,0,0,0,2
4597,static.gc.apple.com,legit,3.43162,5,11,19,0,0.45455,0.18061,10,4,3,2,19,6,1,0,0,7
2695,api-2-0.spot.im,legit,3.37356,4,5,15,0,0.8,0.2249,2,1,0,0,3,0,0,0,0,0
5533,vgwjbhmegtihcyjpfyavi.nu,dga,4.08496,5,18,24,1,0.27778,0.17021,1,0,0,0,1,1,0,0,0,1
7191,jobdyldcxbaqyopfiu.com,dga,3.87966,6,15,22,1,0.4,0.17635,0,0,0,0,0,0,0,0,0,0
3382,afd.azureedge.net,legit,3.26393,7,8,17,0,0.875,0.192,5,2,1,2,10,3,0,0,0,3
9199,4p83pf8migzz1o2urx.com,dga,4.00489,4,11,22,1,0.36364,0.18204,1,0,0,0,1,1,0,0,0,1
6967,oslutin.com,dga,3.27761,4,6,11,1,0.66667,0.29796,2,0,0,0,2,2,0,0,0,2
7492,epfcttrirpycoque.eu,dga,3.47135,7,11,19,1,0.63636,0.1827,1,0,0,0,1,2,0,0,0,2
7392,yumct6dysdpkb5dbbi.biz,dga,3.69785,3,16,22,1,0.1875,0.16808,0,0,0,0,0,0,0,0,0,0
2363,content.googleapis.com,legit,3.55034,8,12,22,0,0.66667,0.16138,10,8,4,4,26,7,2,0,0,9
5385,znrmgaikx.vn,dga,3.4183,2,9,12,1,0.22222,0.28486,0,0,0,0,0,0,0,0,0,0
8908,ereloxkfy2ix7vcbqf7p5r5.ddns.net,dga,4.35141,5,20,32,1,0.25,0.13598,5,1,0,0,6,7,4,2,2,15
1687,de.tynt.com,legit,3.0958,2,7,11,0,0.28571,0.28144,3,0,0,0,3,1,0,0,0,1
4707,ui.com,legit,2.58496,3,2,6,0,1.5,0.43083,0,0,0,0,0,0,0,0,0,0
2223,50-courier.push.apple.com,legit,3.86347,8,11,25,0,0.72727,0.15454,9,4,3,2,18,4,0,0,0,4
2738,usw-ca2.adsrvr.org,legit,3.57243,4,10,18,0,0.4,0.19847,4,0,0,0,4,1,0,0,0,1
5610,bikdbjotdpaodul.mu,dga,3.57243,6,11,18,1,0.54545,0.19847,0,0,0,0,0,0,0,0,0,0
5397,xxthnffhjfyqkrmf.eu,dga,3.61635,2,16,19,1,0.125,0.19033,0,0,0,0,0,0,0,0,0,0
8579,ahrywl.tc,dga,3.16993,1,7,9,1,0.14286,0.35221,0,0,0,0,0,0,0,0,0,0
4665,aa-rt.sharepoint.com.dual-spo-0003.spo-msedge.net,legit,4.10707,14,22,49,0,0.63636,0.08382,9,5,3,1,18,9,2,1,0,12
4635,tiktokcdn-us.com.c.footprint.net,legit,3.71502,8,19,32,0,0.42105,0.11609,11,8,8,6,33,6,3,1,0,10
6859,vpyxkpiffxkculht.com,dga,3.82193,3,16,20,1,0.1875,0.1911,1,0,0,0,1,0,0,0,0,0
9115,o61j26asf42k37btbsmyc39g23jsf12g13arfxdw.info,dga,4.48052,5,23,45,1,0.21739,0.09957,0,0,0,0,0,2,0,0,0,2
4693,tiktok.com.bytewlb.akadns.net,legit,3.79747,7,18,29,0,0.38889,0.13095,7,10,9,6,32,6,3,1,0,10
5830,wsikuuiyicmqciku.org,dga,3.48418,8,11,20,1,0.72727,0.17421,1,0,0,0,1,2,0,0,0,2
6722,ogueuosqsseiiumm.org,dga,3.20869,10,9,20,1,1.11111,0.16043,1,0,0,0,1,1,0,0,0,1
4119,aviary.amazon.com,legit,3.26393,7,8,17,0,0.875,0.192,4,1,3,3,11,4,0,0,0,4
2724,vidstat.taboola.com,legit,3.39189,7,10,19,0,0.7,0.17852,6,0,0,0,6,4,0,0,0,4
1659,usc.pptservicescast.officeapps.live.com,legit,3.69632,12,23,39,0,0.52174,0.09478,13,7,5,4,29,10,2,1,0,13
3565,b.6sc.co,legit,2.5,1,4,8,0,0.25,0.3125,0,0,0,0,0,0,0,0,0,0
5346,osxonijybqh.net,dga,3.64022,4,10,15,1,0.4,0.24268,1,0,0,0,1,2,0,0,0,2
5523,bsjbjgphtkmregkpa.com,dga,3.82089,3,17,21,1,0.17647,0.18195,1,0,0,0,1,1,0,0,0,1
3318,settings.crashlytics.com,legit,3.68872,5,17,24,0,0.29412,0.1537,8,0,0,0,8,7,1,0,0,8
2544,img.3lift.com,legit,3.2389,3,7,13,0,0.42857,0.24915,1,0,0,0,1,0,0,0,0,0
4225,registerdisney.go.com,legit,3.59447,7,12,21,0,0.58333,0.17117,4,1,0,0,5,6,2,0,0,8
2345,huawei.com,legit,3.32193,5,4,10,0,1.25,0.33219,0,0,0,0,0,0,0,0,0,0
2554,teams-ring.msedge.net,legit,3.43994,6,12,21,0,0.5,0.16381,8,2,1,0,11,8,2,0,0,10
1750,mobilemaps-pa-gz.googleapis.com,legit,3.6955,11,16,31,0,0.6875,0.11921,6,6,4,4,20,5,0,0,0,5
2780,pxdrop.lijit.com,legit,3.5,4,10,16,0,0.4,0.21875,3,0,0,0,3,1,0,0,0,1
2125,hydra.sophos.com,legit,3.32782,4,10,16,0,0.4,0.20799,1,0,0,0,1,1,0,0,0,1
8489,dirqirpa.ru,dga,2.84535,4,6,11,1,0.66667,0.25867,0,0,0,0,0,0,0,0,0,0
9919,readingpoundcashstudyare.com,dga,3.96772,10,17,28,1,0.58824,0.1417,6,0,0,0,6,8,1,0,0,9
7872,eiyykyggmwukgkug.org,dga,3.16596,5,14,20,1,0.35714,0.1583,0,0,0,0,0,0,0,0,0,0
2986,xmppapi.zoom.us,legit,3.1899,5,8,15,0,0.625,0.21266,4,1,1,0,6,1,0,0,0,1
345,googleads4.g.doubleclick.net,legit,3.81541,9,15,28,0,0.6,0.13626,9,4,3,3,19,5,0,0,0,5
5136,cewoflurn.com,dga,3.39275,4,8,13,1,0.5,0.26098,2,0,0,0,2,1,0,0,0,1
1077,pull-cmaf-f16-gcp01.tiktokcdn.com,legit,4.11243,5,19,33,0,0.26316,0.12462,5,6,9,9,29,3,0,0,0,3
4633,weathermapdata.blob.core.windows.net,legit,3.8848,12,20,36,0,0.6,0.10791,12,1,0,0,13,10,2,1,1,14
2663,ei.rlcdn.com,legit,3.25163,3,7,12,0,0.42857,0.27097,2,1,0,0,3,1,0,0,0,1
7802,ciscesmceiawsysi.org,dga,3.34644,7,12,20,1,0.58333,0.16732,2,0,0,0,2,4,0,0,0,4
6752,aaekosriri.com,dga,3.23593,7,6,14,1,1.16667,0.23114,0,0,0,0,0,1,0,0,0,1
8070,iluhgumd.com,dga,3.25163,4,7,12,1,0.57143,0.27097,0,0,0,0,0,0,0,0,0,0
7375,bivuxhnkpumylk.nu,dga,3.57247,4,12,17,1,0.33333,0.21015,0,0,0,0,0,0,0,0,0,0
1868,static.licdn.com,legit,3.32782,4,10,16,0,0.4,0.20799,8,1,0,0,9,6,1,0,0,7
2347,dcdn.adnxs.com,legit,3.03915,2,10,14,0,0.2,0.21708,4,2,1,0,7,1,0,0,0,1
2182,acp-ss-ue1.adobe.io,legit,3.61635,8,6,19,0,1.33333,0.19033,2,0,0,0,2,2,0,0,0,2
7611,dwnkfqalohwzze.com,dga,3.83659,4,13,18,1,0.30769,0.21314,1,0,0,0,1,0,0,0,0,0
2967,k.sni.global.fastly.net,legit,3.62118,5,14,23,0,0.35714,0.15744,2,1,0,0,3,3,0,0,0,3
4359,lcprd1.samsungcloudsolution.net,legit,3.92921,9,19,31,0,0.47368,0.12675,7,3,2,1,13,4,2,1,0,7
3344,millennialnexageinapp768429046591.s.moatpixel.com,legit,4.30319,14,20,49,0,0.7,0.08782,11,2,0,0,13,9,0,0,0,9
7254,tmsgxbcldqbbovwud.cc,dga,3.74644,2,17,20,1,0.11765,0.18732,0,0,0,0,0,0,0,0,0,0
5771,xksrgkpwtq.com,dga,3.6645,1,12,14,1,0.08333,0.26175,0,0,0,0,0,0,0,0,0,0
8086,yiyinwkqeuxs.eu,dga,3.37356,6,8,15,1,0.75,0.2249,1,0,0,0,1,1,0,0,0,1
5078,sb7fab12y8ox3bo.ddns.net,dga,3.97018,4,13,24,1,0.30769,0.16542,2,1,0,0,3,4,4,3,2,13
8943,usgwicmgwskoqqyu.org,dga,3.58418,5,14,20,1,0.35714,0.17921,2,0,0,0,2,1,0,0,0,1
7840,dfagpxrhhgypuynzi.com,dga,4.01137,4,16,21,1,0.25,0.19102,0,0,0,0,0,0,0,0,0,0
4713,tru.am,legit,2.58496,2,3,6,0,0.66667,0.43083,0,0,0,0,0,0,0,0,0,0
8671,ra8x6zmnptiwb8x71d.com,dga,4.1867,3,13,22,1,0.23077,0.1903,2,0,0,0,2,2,0,0,0,2
6306,kmetrfxeyidwiejc.eu,dga,3.72161,7,11,19,1,0.63636,0.19587,0,0,0,0,0,1,0,0,0,1
4653,js-sec.indexww.com.cdn.cloudflare.net,legit,3.99001,9,22,37,0,0.40909,0.10784,9,8,6,3,26,11,2,1,0,14
2672,onedscolprdeus10.eastus.cloudapp.azure.com,legit,3.89185,15,21,42,0,0.71429,0.09266,17,5,3,4,29,9,1,0,0,10
1639,snapkit.com,legit,3.45943,3,7,11,0,0.42857,0.31449,1,0,0,0,1,1,0,0,0,1
5750,fliercondition.net,dga,3.30827,7,10,18,1,0.7,0.18379,5,1,0,0,6,6,3,1,0,10
1761,prod.dataops.mozgcp.net,legit,3.64249,6,14,23,0,0.42857,0.15837,8,3,2,1,14,3,1,0,0,4
7290,symhjaiq.net,dga,3.58496,3,8,12,1,0.375,0.29875,0,0,0,0,0,0,0,0,0,0
7130,sunbecomeordercommentdemand.com,dga,3.42246,11,19,31,1,0.57895,0.1104,5,2,0,0,7,13,3,0,0,16
6955,qedylyl.com,dga,3.0958,2,8,11,1,0.25,0.28144,1,0,0,0,1,1,0,0,0,1
7585,epc6m0w2aji0e0y.ddns.net,dga,3.93872,5,12,24,1,0.41667,0.16411,2,1,0,0,3,4,3,2,2,11
617,guzzoni-apple-com.v.aaplimg.com,legit,3.80018,10,16,31,0,0.625,0.12259,8,5,3,1,17,5,1,0,0,6
3940,uservoice.com,legit,3.2389,6,6,13,0,1.0,0.24915,5,2,1,0,8,4,2,1,0,7
6622,ul4o1dgckywpv4jcud.net,dga,4.0958,4,14,22,1,0.28571,0.18617,0,0,0,0,0,0,0,0,0,0
6085,1hy63fw8w6wr305.ddns.net,dga,3.97018,1,13,24,1,0.07692,0.16542,2,1,0,0,3,4,3,2,2,11
7271,byzqx.com.hn,dga,3.4183,1,9,12,1,0.11111,0.28486,2,2,1,0,5,2,2,1,0,5
2762,espn.com,legit,3.0,2,5,8,0,0.4,0.375,1,0,0,0,1,1,0,0,0,1
3211,api.iterable.com,legit,3.5,7,7,16,0,1.0,0.21875,6,1,1,0,8,5,1,0,0,6
3012,brandmetrics.com,legit,3.625,4,11,16,0,0.36364,0.22656,2,0,0,0,2,6,1,0,0,7
7882,efzyxadsholapet.org,dga,3.93214,6,12,19,1,0.5,0.20695,3,0,0,0,3,2,0,5,5,12
5283,aemvlwpxxfca5gvl6t.ru,dga,4.01137,4,14,21,1,0.28571,0.19102,0,0,0,0,0,2,0,0,0,2
2430,bluecava.com,legit,3.25163,5,6,12,0,0.83333,0.27097,0,0,0,0,0,2,0,0,0,2
8554,toqwerug.ru,dga,3.0958,4,6,11,1,0.66667,0.28144,1,0,0,0,1,1,0,0,0,1
7367,nxdsguhud30lvltauivjzf52aybscsaxny.com,dga,4.50412,8,25,38,1,0.32,0.11853,2,0,0,0,2,1,0,0,0,1
4567,platform-azur.linkedin.com,legit,4.08506,8,15,26,0,0.53333,0.15712,5,0,0,0,5,5,0,0,0,5
2583,mz.unity3d.com,legit,3.52164,3,8,14,0,0.375,0.25155,0,0,0,0,0,2,0,0,0,2
6013,ebawufkyumoqekgn.eu,dga,3.64215,8,10,19,1,0.8,0.19169,0,0,0,0,0,0,0,0,0,0
492,appcenter.ms,legit,3.25163,3,8,12,0,0.375,0.27097,7,2,0,0,9,4,2,0,0,6
7279,viewswitchthinkpriestshower.com,dga,3.73567,9,21,31,1,0.42857,0.12051,5,0,0,0,5,6,1,0,0,7
9440,ebddfcffaacdbffa.online,dga,3.2575,7,15,23,1,0.46667,0.14163,1,0,0,0,1,2,0,0,0,2
3393,s3.eu-west-1.amazonaws.com,legit,3.76718,8,11,26,0,0.72727,0.14489,6,1,3,3,13,5,1,0,0,6
9248,82ky4e8agyoe.net,dga,3.45282,5,6,16,1,0.83333,0.2158,0,0,0,0,0,0,0,0,0,0
774,star-mini.c10r.facebook.com,legit,3.93027,8,13,27,0,0.61538,0.14557,7,0,0,0,7,8,0,0,0,8
9271,ptfjytevgp.com,dga,3.52164,2,11,14,1,0.18182,0.25155,1,0,0,0,1,1,0,0,0,1
8813,wsumkokwuqkyueuy.org,dga,3.38418,7,12,20,1,0.58333,0.16921,0,0,0,0,0,1,0,0,0,1
7150,xubaxed.info,dga,3.4183,5,6,12,1,0.83333,0.28486,1,0,0,0,1,1,0,0,0,1
5848,redbreakfastparentconsult.com,dga,3.92627,9,19,29,1,0.47368,0.13539,8,3,0,0,11,11,2,0,0,13
2133,a21.z.akamai.net,legit,3.20282,6,5,16,0,1.2,0.20018,3,3,4,3,13,2,0,0,0,2
7826,yunjugtkel.com,dga,3.6645,4,9,14,1,0.44444,0.26175,0,0,0,0,0,1,0,0,0,1
5400,jikfepsuoroajd.co.uk,dga,3.68418,8,10,20,1,0.8,0.18421,4,1,0,0,5,3,1,0,0,4
7325,ehjqliqkkoxayeusaog.de,dga,3.87966,9,12,22,1,0.75,0.17635,2,0,0,0,2,0,0,0,0,0
3065,aws.dev,legit,2.80735,2,4,7,0,0.5,0.40105,0,0,0,0,0,0,0,0,0,0
3836,epdg.epc.att.net,legit,2.98346,4,9,16,0,0.44444,0.18647,2,0,0,0,2,1,0,0,0,1
2729,www.amazon.co.uk,legit,3.15564,5,8,16,0,0.625,0.19723,6,2,3,3,14,4,1,0,0,5
9582,bbmblkbddadbeafa.com,dga,3.16596,5,14,20,1,0.35714,0.1583,2,0,0,0,2,3,0,0,0,3
79,aaplimg.com,legit,3.0958,4,6,11,0,0.66667,0.28144,3,0,0,0,3,0,0,0,0,0
5184,xuqfkcsbccwmflwlqn.com,dga,3.64125,2,19,22,1,0.10526,0.16551,0,0,0,0,0,0,0,0,0,0
6159,facittemporales.com,dga,3.61635,7,11,19,1,0.63636,0.19033,4,0,0,0,4,8,0,0,0,8
6976,axfmlhwdmcbt.net,dga,3.75,2,13,16,1,0.15385,0.23438,0,0,0,0,0,0,0,0,0,0
7030,keyaqgl1xvw1h7gzkv.biz,dga,4.00489,3,15,22,1,0.2,0.18204,0,0,0,0,0,0,0,0,0,0
8231,webmasters-equivalent.ru,dga,3.83496,9,13,24,1,0.69231,0.15979,7,2,0,0,9,7,3,0,0,10
3686,public.wfram-a-2.prod.infra.webex.com,legit,4.09812,10,19,37,0,0.52632,0.11076,8,4,3,2,17,5,2,0,0,7
8881,sisters-meet.tk,dga,2.95591,4,9,15,1,0.44444,0.19706,3,0,0,0,3,6,3,0,0,9
1441,3.tlu.dl.delivery.mp.microsoft.com,legit,3.8588,8,19,34,0,0.42105,0.11349,11,8,7,7,33,7,1,0,0,8
1903,www.adobe.com,legit,3.02699,4,7,13,0,0.57143,0.23285,2,0,0,0,2,1,0,0,0,1
7443,tbiexnfuxvwjut.la,dga,3.73452,5,11,17,1,0.45455,0.21968,0,0,0,0,0,0,0,0,0,0
4108,g.geogslb.com,legit,3.02699,3,8,13,0,0.375,0.23285,1,0,0,0,1,1,0,0,0,1
2067,onaudience.com,legit,3.23593,7,6,14,0,1.16667,0.23114,3,0,0,0,3,3,1,1,0,5
8126,doubleunderstood.net,dga,3.30869,8,11,20,1,0.72727,0.16543,5,0,0,0,5,5,1,0,0,6
5663,dsmvbrhtb18irkra37jqpuhvcvi35gxhxf62.biz,dga,4.62757,5,26,40,1,0.19231,0.11569,2,0,0,0,2,1,0,0,0,1
4537,valid-apple.g.aaplimg.com,legit,3.51327,8,13,25,0,0.61538,0.14053,7,3,2,1,13,1,0,0,0,1
6798,qvfsxdxqz.mooo.com,dga,3.28104,4,12,18,1,0.33333,0.18228,2,0,0,0,2,0,1,2,1,4
3170,dms.licdn.com,legit,3.08506,2,9,13,0,0.22222,0.23731,5,1,0,0,6,2,0,0,0,2
1537,owneriq.net,legit,3.0958,4,6,11,0,0.66667,0.28144,1,0,0,0,1,3,1,0,0,4
9436,xienqaqeaq.ddns.net,dga,3.18137,6,11,19,1,0.54545,0.16744,4,1,0,0,5,6,3,3,2,14
8896,xpgetmtbuekmml.ms,dga,3.38158,3,13,17,1,0.23077,0.19892,1,0,0,0,1,2,0,0,0,2
7466,yfkv.ro,dga,2.80735,1,5,7,1,0.2,0.40105,0,0,0,0,0,0,0,0,0,0
6747,llyjqilwoxur.pw,dga,3.45656,3,11,15,1,0.27273,0.23044,0,0,0,0,0,0,0,0,0,0
6427,sm5khb4cv38ooxmk6r.com,dga,3.84535,3,13,22,1,0.23077,0.17479,1,0,0,0,1,0,0,0,0,0
2446,na.api.amazonvideo.com,legit,3.39081,10,9,22,0,1.11111,0.15413,6,3,4,3,16,4,0,0,0,4
8508,qyorbbjyqn.com,dga,3.23593,2,11,14,1,0.18182,0.23114,0,0,0,0,0,1,0,0,0,1
4740,v4.a.prd.aadg.trafficmanager.net,legit,3.62893,9,17,32,0,0.52941,0.1134,10,4,1,3,18,6,1,0,0,7
4206,ocsp.identrust.com,legit,3.61437,5,11,18,0,0.45455,0.2008,5,1,0,0,6,3,1,0,0,4
219,fe3cr.delivery.mp.microsoft.com,legit,3.80018,8,18,31,0,0.44444,0.12259,10,8,7,7,32,7,1,0,0,8
4109,mdw-efz.ms-acdc.office.com,legit,3.53641,6,15,26,0,0.4,0.13602,5,4,4,3,16,3,0,0,0,3
5206,utxexuagipix.ddns.net,dga,3.49923,7,12,21,1,0.58333,0.16663,3,1,0,0,4,4,3,2,1,10
8751,qebelop.info,dga,3.25163,5,6,12,1,0.83333,0.27097,1,0,0,0,1,2,0,0,0,2
8198,4nktcdbxesr68dnm7f.ru,dga,4.1066,2,14,21,1,0.14286,0.19555,3,0,0,0,3,2,0,0,0,2
9893,eokfaxbl.sk,dga,3.27761,3,7,11,1,0.42857,0.29796,0,0,0,0,0,0,0,0,0,0
1200,monitor.azure.com,legit,3.45482,7,8,17,0,0.875,0.20322,3,0,0,2,5,5,0,0,0,5
1905,pandg.tapad.com,legit,3.1899,4,9,15,0,0.44444,0.21266,4,0,0,0,4,3,1,0,0,4
4892,smp-device-content.lb-apple.com.akadns.net,legit,3.93079,11,24,42,0,0.45833,0.09359,16,12,9,9,46,11,5,1,0,17
4938,ox-rtb-us-east4.openx.net,legit,3.67327,7,12,25,0,0.58333,0.14693,4,1,0,0,5,4,0,0,0,4
6076,agemsehnomd.com,dga,3.32323,5,9,15,1,0.55556,0.22155,2,1,0,0,3,4,0,0,0,4
5059,ruqjueqid.tv,dga,3.25163,4,7,12,1,0.57143,0.27097,0,0,0,0,0,0,0,0,0,0
8374,xelprca.es,dga,3.12193,3,6,10,1,0.5,0.31219,1,0,0,0,1,2,0,0,0,2
5922,kakq0ag20iki.org,dga,3.20282,5,7,16,1,0.71429,0.20018,0,0,0,0,0,0,0,0,0,0
896,elb.us-east-1.amazonaws.com,legit,3.81008,9,12,27,0,0.75,0.14111,7,2,3,3,15,7,0,0,0,7
356,r3.o.lencr.org,legit,2.98523,3,7,14,0,0.42857,0.21323,3,0,0,0,3,2,0,0,0,2
7530,sellspoints.info,dga,3.20282,5,10,16,1,0.5,0.20018,3,0,0,0,3,3,0,0,0,3
541,px.moatads.com,legit,3.23593,4,8,14,0,0.5,0.23114,5,0,0,0,5,2,0,0,0,2
9004,ccncflladeaoaaec.com,dga,3.04145,8,11,20,1,0.72727,0.15207,2,0,0,0,2,4,0,0,0,4
7908,gebytylldhamyxa.info,dga,3.88418,5,14,20,1,0.35714,0.19421,2,0,0,0,2,2,0,0,0,2
7710,haparawa.info,dga,3.08506,6,6,13,1,1.0,0.23731,2,0,0,0,2,2,0,0,0,2
2916,e-msedge.net,legit,2.9183,4,6,12,0,0.66667,0.24319,3,2,1,0,6,3,0,0,0,3
1556,rezync.com,legit,3.12193,2,7,10,0,0.28571,0.31219,1,0,0,0,1,1,0,0,0,1
8604,atdscml.sk,dga,3.12193,1,8,10,1,0.125,0.31219,2,0,0,0,2,1,0,0,0,1
7467,maximiliancristiansen.net,dga,3.34928,10,14,25,1,0.71429,0.13397,8,0,0,0,8,10,4,0,0,14
4849,display.ravm.tv,legit,3.50689,3,10,15,0,0.3,0.23379,2,0,0,0,2,3,0,0,0,3
9874,unaflurnifd.com,dga,3.50689,5,9,15,1,0.55556,0.23379,0,0,0,0,0,1,0,0,0,1
2994,dls.di.atlas.samsung.com,legit,3.47018,6,14,24,0,0.42857,0.14459,5,0,0,0,5,6,0,0,0,6
6279,uxahm2yp7xalk67rqpy.ddns.net,dga,4.23593,4,18,28,1,0.22222,0.15128,2,1,0,0,3,4,3,2,2,11
602,nexus.officeapps.live.com,legit,3.78347,9,13,25,0,0.69231,0.15134,9,5,4,3,21,5,0,0,0,5
6082,asfubiarkuamo.ddns.net,dga,3.78875,8,12,22,1,0.66667,0.17222,3,1,0,0,4,7,4,3,2,16
7381,fihobqpmncdg.com,dga,3.625,3,12,16,1,0.25,0.22656,1,0,0,0,1,0,0,0,0,0
3579,addtoany.com,legit,3.08496,4,7,12,0,0.57143,0.25708,1,0,0,0,1,2,0,0,0,2
4245,pac.zscaler.net,legit,3.37356,4,9,15,0,0.44444,0.2249,2,0,0,0,2,4,0,0,0,4
694,worldaz.relay.teams.microsoft.com,legit,3.82425,10,19,33,0,0.52632,0.11589,12,8,7,6,33,9,0,0,0,9
4531,streamrail.com,legit,3.37878,5,8,14,0,0.625,0.24134,5,0,0,0,5,5,0,0,0,5
2801,gsp85-ssl.ls2-apple.com.akadns.net,legit,3.91469,6,19,34,0,0.31579,0.11514,10,9,9,9,37,5,3,1,0,9
9109,dtvsjetfywuw.org,dga,3.75,3,12,16,1,0.25,0.23438,0,0,0,0,0,1,0,0,0,1
5237,trkbdujrslql.me,dga,3.64022,2,12,15,1,0.16667,0.24268,0,0,0,0,0,0,0,0,0,0
2328,fei.pro-market.net,legit,3.57243,6,9,18,0,0.66667,0.19847,3,2,1,0,6,3,1,0,0,4
8223,gtyhse.ie,dga,2.9477,3,5,9,1,0.6,0.32752,1,0,0,0,1,1,0,0,0,1
5894,wvuflnvomfq.dyndns.org,dga,3.78875,3,17,22,1,0.17647,0.17222,2,1,0,0,3,5,3,4,3,15
7412,jjnuyypocbih.eu,dga,3.50689,5,9,15,1,0.55556,0.23379,0,0,0,0,0,0,0,0,0,0
4014,prd.cdn.globalsign.com,legit,3.69785,4,15,22,0,0.26667,0.16808,6,2,1,0,9,2,0,0,0,2
9016,xslxyfuvjqjpxh.org,dga,3.79465,2,15,18,1,0.13333,0.21081,0,0,0,0,0,0,0,0,0,0
7096,ewgaradlo.com,dga,3.39275,5,7,13,1,0.71429,0.26098,3,0,0,0,3,2,0,0,0,2
8642,uvfjzi.yi.org,dga,3.39275,4,7,13,1,0.57143,0.26098,0,0,0,0,0,0,0,0,0,0
7398,moxokkaf.ru,dga,3.0958,4,6,11,1,0.66667,0.28144,0,0,0,0,0,0,0,0,0,0
8064,qgqacgikmsokmgsq.org,dga,3.28418,4,15,20,1,0.26667,0.16421,0,0,0,0,0,1,0,0,0,1
6694,cy0mwqgawyo6.net,dga,3.75,3,10,16,1,0.3,0.23438,0,0,0,0,0,0,0,0,0,0
5234,idlxfhyif.ps,dga,3.25163,2,9,12,1,0.22222,0.27097,0,0,0,0,0,0,0,0,0,0
6016,pujaxaq.info,dga,3.4183,5,6,12,1,0.83333,0.28486,0,0,0,0,0,0,0,0,0,0
6863,tcsgbxlyobayarwu.com,dga,3.82193,5,14,20,1,0.35714,0.1911,0,0,0,0,0,1,0,0,0,1
5696,ucwukisaa.ddns.net,dga,3.50326,6,10,18,1,0.6,0.19463,2,1,0,0,3,5,4,3,2,14
6808,impxyrifhmld.biz,dga,3.57782,3,12,16,1,0.25,0.22361,0,0,0,0,0,1,0,0,0,1
8853,jnekwgdcbdcu.ru,dga,3.50689,3,11,15,1,0.27273,0.23379,0,0,0,0,0,1,0,0,0,1
3371,notify.trafficmanager.net,legit,3.56307,8,15,25,0,0.53333,0.14252,7,3,1,3,14,7,1,0,0,8
6538,shaftpain.ph,dga,3.08496,3,8,12,1,0.375,0.25708,1,0,0,0,1,1,0,0,0,1
4493,edgesuite.net.globalredir.akadns.net,legit,3.71078,13,19,36,0,0.68421,0.10308,10,5,5,3,23,11,1,0,0,12
5433,azmxbxjlia.com,dga,3.37878,4,9,14,1,0.44444,0.24134,1,0,0,0,1,0,0,0,0,0
2003,s.thebrighttag.com,legit,3.57243,4,12,18,0,0.33333,0.19847,3,0,0,0,3,2,0,0,0,2
4496,api-glb-ause2b.smoot.apple.com,legit,3.87291,10,14,30,0,0.71429,0.1291,9,5,3,2,19,2,0,0,0,2
3281,api-msn-com.a-0003.a-msedge.net,legit,3.80018,8,12,31,0,0.66667,0.12259,7,5,3,1,16,5,1,0,0,6
554,contextweb.com,legit,3.23593,4,9,14,0,0.44444,0.23114,4,1,0,0,5,3,1,0,0,4
7405,cqhyvkqtwauqshhabuuauapv.ru,dga,3.60232,9,17,27,1,0.52941,0.13342,1,0,0,0,1,0,0,0,0,0
9558,qhysbhgjokwhqblf.eu,dga,3.78714,3,15,19,1,0.2,0.19932,0,0,0,0,0,0,0,0,0,0
5374,oggucissote.com,dga,3.1899,6,8,15,1,0.75,0.21266,1,0,0,0,1,2,0,0,0,2
8460,ntirfyitgqkviql18hxmvkwhveqbzm49hu.info,dga,4.4581,7,27,39,1,0.25926,0.11431,2,0,0,0,2,3,0,0,0,3
5248,wqsqsm02w2o2.org,dga,3.20282,2,9,16,1,0.22222,0.20018,0,0,0,0,0,0,0,0,0,0
4421,idsync.live.streamtheworld.com,legit,3.9899,8,19,30,0,0.42105,0.133,7,0,0,0,7,6,0,0,0,6
9119,jmbdkwghi.net,dga,3.70044,2,10,13,1,0.2,0.28465,0,0,0,0,0,0,0,0,0,0
4517,weather-data.apple.com.akamaized.net,legit,3.78059,14,17,36,0,0.82353,0.10502,15,10,10,10,45,10,3,2,1,16
5166,papatemeritatequ.com,dga,3.40869,9,10,20,1,0.9,0.17043,5,0,0,0,5,7,3,0,0,10
7433,qirivuxd.ru,dga,2.91398,4,6,11,1,0.66667,0.26491,0,0,0,0,0,1,0,0,0,1
9025,manmissaccountcontainescape.com,dga,3.40986,12,18,31,1,0.66667,0.11,10,1,0,0,11,12,2,0,0,14
7471,pxkhtpyufnby.com,dga,3.75,2,13,16,1,0.15385,0.23438,0,0,0,0,0,0,0,0,0,0
6295,khviebhnpmepr.com,dga,3.61687,4,12,17,1,0.33333,0.21276,1,0,0,0,1,0,0,0,0,0
6255,gatherrealize.net,dga,3.26393,7,9,17,1,0.77778,0.192,5,0,0,0,5,4,1,1,1,7
5489,aoatch2ziw8pgdx8dj.net,dga,4.0958,5,13,22,1,0.38462,0.18617,1,0,0,0,1,1,0,0,0,1
3867,prod.boltdns.net,legit,3.375,3,11,16,0,0.27273,0.21094,4,4,2,1,11,2,2,0,0,4
9086,6ffbrr8dzrm8feyp51.net,dga,3.84535,2,14,22,1,0.14286,0.17479,0,0,0,0,0,0,0,0,0,0
3785,p77-sign-va.tiktokcdn.com,legit,3.92386,5,14,25,0,0.35714,0.15695,4,6,7,6,23,3,0,0,0,3
5494,nuuauoqyopmsbhep.eu,dga,3.51109,9,9,19,1,1.0,0.18479,0,0,0,0,0,0,0,0,0,0
1793,atomile.com,legit,3.0958,5,5,11,0,1.0,0.28144,3,0,0,0,3,4,0,0,0,4
2408,0-courier.push.apple.com,legit,3.77206,8,11,24,0,0.72727,0.15717,9,4,3,2,18,4,0,0,0,4
9123,twsirqugxixpmveq.com,dga,3.92193,5,14,20,1,0.35714,0.1961,0,0,0,0,0,2,0,0,0,2
7066,njxtpvampbwwlxhgqe.cc,dga,4.01137,2,18,21,1,0.11111,0.19102,1,0,0,0,1,1,0,0,0,1
7134,a8azctyq6clsc6avkp.cn,dga,3.6897,3,14,21,1,0.21429,0.1757,0,0,0,0,0,0,0,0,0,0
4961,match.taboola.com,legit,3.05748,6,9,17,0,0.66667,0.17985,5,0,0,0,5,4,0,0,0,4
8698,xeogisan.ru,dga,3.45943,5,5,11,1,1.0,0.31449,0,0,0,0,0,2,0,0,0,2
7230,fbhrofgmildhtamg.eu,dga,3.82687,5,13,19,1,0.38462,0.20141,5,0,0,0,5,3,0,0,0,3
2010,wt.rqtrk.eu,legit,2.91398,2,7,11,0,0.28571,0.26491,0,0,0,0,0,0,0,0,0,0
8287,qwlubuiewroxctgbv.su,dga,3.88418,6,13,20,1,0.46154,0.19421,1,0,0,0,1,0,0,0,0,0
1904,edge.fullstory.com,legit,3.72548,5,11,18,0,0.45455,0.20697,4,2,1,0,7,4,0,0,0,4
5933,nucallum.com,dga,2.9183,4,7,12,1,0.57143,0.24319,0,0,0,0,0,1,0,0,0,1
2578,placed.com,legit,3.12193,3,6,10,0,0.5,0.31219,3,0,0,0,3,4,0,0,0,4
3264,apptentive.com,legit,3.37878,5,8,14,0,0.625,0.24134,6,2,0,0,8,4,1,0,0,5
7386,tjavranlbsgy.com,dga,3.875,3,12,16,1,0.25,0.24219,1,0,0,0,1,2,0,0,0,2
108,assets.msn.com,legit,2.95021,3,9,14,0,0.33333,0.21073,3,0,0,0,3,3,1,0,0,4
997,pull-o5-sg01.tiktokcdn.com,legit,4.05602,5,14,26,0,0.35714,0.156,4,6,9,9,28,2,0,0,0,2
404,evoke-windowsservices-tas.msedge.net,legit,3.80156,12,20,36,0,0.6,0.1056,11,4,2,1,18,11,2,1,0,14
9538,hskuuqae.dyndns.org,dga,3.72161,5,12,19,1,0.41667,0.19587,3,1,0,0,4,4,4,4,3,15
3131,ka-f.fontawesome.com,legit,3.58418,7,10,20,0,0.7,0.17921,4,0,0,0,4,4,0,0,0,4
9535,giquwevu.com,dga,3.4183,5,6,12,1,0.83333,0.28486,0,0,0,0,0,0,0,0,0,0
4319,emb-api.com,legit,3.27761,4,5,11,0,0.8,0.29796,2,1,0,0,3,1,0,0,0,1
54,fonts.googleapis.com,legit,3.62193,7,11,20,0,0.63636,0.1811,8,6,4,4,22,4,0,0,0,4
1849,imap.mail.yahoo.com,legit,3.14164,8,8,19,0,1.0,0.16535,5,0,0,1,6,1,0,0,0,1
6505,hospitalappreciateapplybake.com,dga,3.72922,12,18,31,1,0.66667,0.1203,10,2,1,0,13,8,2,0,0,10
6167,subcommittee-digest.yt,dga,3.60694,7,13,22,1,0.53846,0.16395,6,1,0,0,7,9,2,0,0,11
8254,doeuq.tc,dga,3.0,3,4,8,1,0.75,0.375,0,0,0,0,0,0,0,0,0,0
1316,usc-collabrtc.officeapps.live.com,legit,3.89669,10,19,33,0,0.52632,0.11808,10,5,4,3,22,6,0,0,0,6
669,ads-twitter.com,legit,3.5899,4,9,15,0,0.44444,0.23933,4,0,0,0,4,3,1,0,0,4
3114,rtbc-uw1.doubleverify.com,legit,4.08386,7,14,25,0,0.5,0.16335,4,0,0,0,4,5,2,0,0,7
2438,e28578.d.akamaiedge.net,legit,3.58835,8,7,23,0,1.14286,0.15602,7,5,5,3,20,5,0,0,0,5
7526,ocofxvjrfv.dynserv.com,dga,3.66353,4,16,22,1,0.25,0.16652,5,1,1,0,7,5,5,5,4,19
5913,bakohuxx.ru,dga,3.0958,4,6,11,1,0.66667,0.28144,0,0,0,0,0,0,0,0,0,0
6045,olqvdtavpmweji.ru,dga,3.96982,5,11,17,1,0.45455,0.23352,1,0,0,0,1,1,0,0,0,1
552,dt.adsafeprotected.com,legit,3.4474,7,13,22,0,0.53846,0.1567,7,1,0,0,8,3,1,0,0,4
8862,lodlvcegrkemv.com,dga,3.38158,4,12,17,1,0.33333,0.19892,2,0,0,0,2,2,0,0,0,2
199,signaler-pa.clients6.google.com,legit,3.8647,10,16,31,0,0.625,0.12467,7,6,4,3,20,4,1,0,0,5
6051,aabbjsfdwjkbo.info,dga,3.46132,5,12,18,1,0.41667,0.1923,0,0,0,0,0,0,0,0,0,0
8304,disputabunturcanonum.com,dga,3.63684,9,14,24,1,0.64286,0.15154,3,0,0,0,3,5,1,0,0,6
1978,flurry.com,legit,3.12193,2,7,10,0,0.28571,0.31219,0,0,0,0,0,0,0,0,0,0
8429,ordinariovenie.com,dga,3.30827,9,8,18,1,1.125,0.18379,2,0,0,0,2,7,1,0,0,8
5221,lnpxtzffvq.com,dga,3.6645,1,12,14,1,0.08333,0.26175,0,0,0,0,0,0,0,0,0,0
7388,sourcehopeadvancedresolve.com,dga,3.673,12,16,29,1,0.75,0.12666,7,0,0,0,7,7,2,1,0,10
5630,sorotkzhbl.dynserv.com,dga,3.97057,4,16,22,1,0.25,0.18048,4,1,1,0,6,5,5,5,4,19
3797,digital-cloud-west.medallia.com,legit,3.78437,11,16,31,0,0.6875,0.12208,8,3,2,1,14,5,2,0,0,7
234,config.office.net,legit,3.10188,6,9,17,0,0.66667,0.18246,5,5,4,3,17,4,1,0,0,5
3732,eu-prod.asyncgw.teams.microsoft.com,legit,4.03601,10,20,35,0,0.5,0.11531,14,11,9,7,41,6,1,0,0,7
2197,chat-e2ee-mini.c10r.facebook.com,legit,3.95282,11,13,32,0,0.84615,0.12353,6,0,0,0,6,6,1,0,0,7
3220,cdn.brandmetrics.com,legit,3.58418,4,14,20,0,0.28571,0.17921,4,2,1,0,7,7,1,0,0,8
8994,ontiqwzhpbkbdiwcpraubensgjzp.org,dga,4.26532,7,24,32,1,0.29167,0.13329,6,0,0,0,6,6,0,0,0,6
2467,us-central1-adaptive-growth.cloudfunctions.net,legit,4.21619,14,26,46,0,0.53846,0.09166,13,4,3,2,22,7,4,1,1,13
8484,eolomdbbquir.com,dga,3.45282,6,9,16,1,0.66667,0.2158,1,0,0,0,1,1,0,0,0,1
3517,dbankcloud.ru,legit,3.39275,4,8,13,0,0.5,0.26098,2,3,2,1,8,1,0,0,0,1
9832,vidonpetridicimusbasi.com,dga,3.77947,10,14,25,1,0.71429,0.15118,3,0,0,0,3,6,0,0,0,6
3685,wfram-a-2.prod.infra.webex.com,legit,3.92323,8,15,30,0,0.53333,0.13077,6,4,3,2,15,4,2,0,0,6
9623,eabxscuiwcymao.info,dga,3.82687,8,10,19,1,0.8,0.20141,2,0,0,0,2,2,0,5,4,11
5795,dshvkjvlbingnefr.eu,dga,3.93214,4,14,19,1,0.28571,0.20695,2,0,0,0,2,2,1,0,0,3
2367,slack-imgs.com,legit,3.37878,3,9,14,0,0.33333,0.24134,0,0,0,0,0,2,0,0,0,2
5809,ogxtwuqfbwvgcyl.biz,dga,3.93214,3,15,19,1,0.2,0.20695,0,0,0,0,0,0,0,0,0,0
7010,8u0mkis6gesa.org,dga,3.75,5,7,16,1,0.71429,0.23438,2,0,0,0,2,3,0,0,0,3
6460,zrwyk.hu,dga,3.0,1,6,8,1,0.16667,0.375,0,0,0,0,0,0,0,0,0,0
1900,hotjar.io,legit,2.9477,4,4,9,0,1.0,0.32752,0,0,0,0,0,1,0,0,0,1
6437,byzsaexsas.com,dga,3.32486,4,9,14,1,0.44444,0.23749,0,0,0,0,0,1,0,0,0,1
3138,aadg.msidentity.com,legit,3.61635,6,11,19,0,0.54545,0.19033,5,1,0,0,6,5,1,0,0,6
1501,oneocsp.microsoft.com,legit,3.32734,7,12,21,0,0.58333,0.15844,8,8,7,7,30,4,1,0,0,5
5642,vnokygycsejyjxiweexoa.ru,dga,3.93872,8,15,24,1,0.53333,0.16411,1,0,0,0,1,1,0,0,0,1
981,pull-a5-gcp01.tiktokcdn.com,legit,4.06026,5,15,27,0,0.33333,0.15038,4,6,9,9,28,2,0,0,0,2
8100,annflebcdancloen.org,dga,3.42193,6,13,20,1,0.46154,0.1711,4,1,0,0,5,3,0,0,0,3
3748,accounts.doubleclick.net,legit,3.6683,8,14,24,0,0.57143,0.15285,8,0,0,0,8,6,0,0,0,6
9767,y4upgt18ilshyxc.ddns.net,dga,4.08496,3,16,24,1,0.1875,0.17021,2,1,0,0,3,4,3,2,2,11
8784,khiffptpxjby.in,dga,3.50689,2,12,15,1,0.16667,0.23379,0,0,0,0,0,0,0,0,0,0
9972,tsfgwqnehlpmqxqb.eu,dga,3.89241,3,15,19,1,0.2,0.20486,0,0,0,0,0,1,0,0,0,1
5434,oubkvwvmas.com,dga,3.37878,4,9,14,1,0.44444,0.24134,2,0,0,0,2,2,0,0,0,2
7704,year-maintain.com,dga,3.45482,7,8,17,1,0.875,0.20322,5,0,0,0,5,5,0,0,0,5
5683,oxluxenansnan.com,dga,3.26393,6,10,17,1,0.6,0.192,1,0,0,0,1,3,2,4,3,12
5072,knowsure.net,dga,3.25163,4,7,12,1,0.57143,0.27097,1,0,0,0,1,2,0,0,0,2
7632,avutiverekunxa.ddns.net,dga,3.58835,8,13,23,1,0.61538,0.15602,5,1,0,0,6,8,6,3,2,19
2191,fa000000043.resources.office.net,legit,3.58871,9,11,32,0,0.81818,0.11215,7,4,4,3,18,4,1,0,0,5
2599,msua02.manage.microsoft.com,legit,3.78212,9,13,27,0,0.69231,0.14008,9,9,7,8,33,6,0,0,0,6
9643,gbwuqshylsahod.com,dga,3.83659,4,13,18,1,0.30769,0.21314,0,0,0,0,0,0,0,0,0,0
2657,cat.va.us.criteo.com,legit,3.38418,7,9,20,0,0.77778,0.16921,6,0,0,0,6,5,0,0,0,5
3664,gateway.zscalerthree.net,legit,3.53832,8,14,24,0,0.57143,0.14743,5,0,0,0,5,6,1,0,0,7
4398,apple.com.v.aaplimg.com,legit,3.29466,7,12,23,0,0.58333,0.14325,9,6,4,3,22,3,2,1,0,6
3351,v4ncsi.msedge.net,legit,3.45482,4,10,17,0,0.4,0.20322,4,2,1,0,7,4,0,0,0,4
8546,vitalministry.org,dga,3.57247,5,11,17,1,0.45455,0.21015,4,0,0,0,4,7,2,0,0,9
4970,clientconfig.akamai.steamstatic.com,legit,3.61159,13,19,35,0,0.68421,0.10319,15,5,4,3,27,12,3,0,0,15
2343,quiddity.goguardian.com,legit,3.67531,9,12,23,0,0.75,0.1598,0,1,0,0,1,4,0,0,0,4
6128,qufacitfalse.com,dga,3.625,6,9,16,1,0.66667,0.22656,1,0,0,0,1,3,0,0,0,3
2386,swallow-apple-com.v.aaplimg.com,legit,3.63099,9,17,31,0,0.52941,0.11713,8,5,3,1,17,3,1,0,0,4
9045,stylusindicated.su,dga,3.46132,6,11,18,1,0.54545,0.1923,7,0,0,0,7,9,1,0,0,10
8785,doedblkfadbnlkdf.online,dga,3.32748,6,16,23,1,0.375,0.14467,2,0,0,0,2,1,0,0,0,1
244,edgedl.me.gvt1.com,legit,3.30827,4,10,18,0,0.4,0.18379,4,2,1,0,7,2,0,0,0,2
6502,gawalafiminefio.ddns.net,dga,3.65727,9,13,24,1,0.69231,0.15239,4,1,0,0,5,8,5,3,2,18
2530,dmp.truoptik.com,legit,3.375,4,10,16,0,0.4,0.21094,3,1,0,0,4,1,0,0,0,1
44,teams.microsoft.com,legit,3.32636,6,11,19,0,0.54545,0.17507,10,8,7,6,31,5,0,0,0,5
2664,onedscolprdwus00.westus.cloudapp.azure.com,legit,3.93947,13,23,42,0,0.56522,0.0938,17,4,3,4,28,7,2,0,0,9
3244,address.yahoo.com,legit,3.33718,6,9,17,0,0.66667,0.1963,5,0,0,1,6,3,2,0,0,5
8214,paestremaneretcausamma.com,dga,3.33084,11,14,26,1,0.78571,0.12811,7,0,0,0,7,11,2,0,0,13
2925,quora.com,legit,2.9477,4,4,9,0,1.0,0.32752,1,0,0,0,1,2,0,0,0,2
905,ttlivecdn.com,legit,3.39275,3,9,13,0,0.33333,0.26098,3,1,0,0,4,3,0,0,0,3
7212,eamamclaindulg.com,dga,3.41938,7,10,18,1,0.7,0.18997,4,1,0,0,5,6,0,0,0,6
2335,www-www.bing.com.trafficmanager.net,legit,3.72872,8,22,35,0,0.36364,0.10653,9,6,3,4,22,9,4,1,0,14
9776,riskmonitorborrowfuelreserve.com,dga,3.71502,12,19,32,1,0.63158,0.11609,6,1,1,0,8,12,4,1,0,17
494,play-lh.googleusercontent.com,legit,3.90937,9,17,29,0,0.52941,0.13481,11,8,4,3,26,8,3,0,0,11
808,linkedin.oribi.io,legit,3.0516,8,7,17,0,1.14286,0.17951,3,0,0,0,3,4,0,0,0,4
4311,wsv3cdn.audioeye.com,legit,3.82193,7,10,20,0,0.7,0.1911,3,2,1,0,6,1,0,0,0,1
9069,dreamname.net,dga,2.87314,5,7,13,1,0.71429,0.22101,3,0,0,0,3,3,0,0,0,3
331,dscw154.akamai.net,legit,3.79465,5,8,18,0,0.625,0.21081,4,3,4,3,14,2,0,0,0,2
1857,iphone.life360.com,legit,3.72548,6,7,18,0,0.85714,0.20697,3,0,0,0,3,2,1,0,0,3
2622,mktoresp.com,legit,3.25163,3,8,12,0,0.375,0.27097,2,1,0,0,3,3,1,0,0,4
8268,wqniwzqsootexq.biz,dga,3.46132,5,12,18,1,0.41667,0.1923,2,0,0,0,2,2,0,0,0,2
5082,rkdnpafhmqtg.com,dga,3.875,2,13,16,1,0.15385,0.24219,1,0,0,0,1,1,0,0,0,1
7268,w2sqcikmcas6.top,dga,3.75,3,10,16,1,0.3,0.23438,0,0,0,0,0,2,0,0,0,2
5228,ikcyqvvkncpclbob.eu,dga,3.68188,4,14,19,1,0.28571,0.19378,0,0,0,0,0,0,0,0,0,0
45,www.google-analytics.com,legit,3.77206,7,14,24,0,0.5,0.15717,4,5,4,3,16,4,0,0,0,4
6965,solving-helpful.tf,dga,3.79465,4,12,18,1,0.33333,0.21081,1,0,0,0,1,2,1,0,0,3
6845,mcusysqscaaqmesy.org,dga,3.42193,5,14,20,1,0.35714,0.1711,2,0,0,0,2,2,0,0,0,2
6172,rjjrmxndjqqkqxwn.eu,dga,3.43162,2,16,19,1,0.125,0.18061,0,0,0,0,0,1,0,0,0,1
726,swallow.apple.com,legit,3.21953,5,10,17,0,0.5,0.18938,6,4,3,2,15,1,0,0,0,1
3446,office-c.events.data.microsoft.com,legit,3.72674,11,18,34,0,0.61111,0.10961,13,13,10,8,44,8,1,0,0,9
5132,cnnmlrgakt.com,dga,3.37878,2,11,14,1,0.18182,0.24134,0,0,0,0,0,0,0,0,0,0
5097,gbqrhzoipb.com,dga,3.52164,3,10,14,1,0.3,0.25155,0,0,0,0,0,0,0,0,0,0
2669,media.grid.bidswitch.net,legit,3.68872,7,14,24,0,0.5,0.1537,3,0,0,0,3,3,0,0,0,3
6206,creditrewardrepairsuffer.com,dga,3.61058,10,17,28,1,0.58824,0.12895,4,0,0,0,4,6,0,0,2,8
9525,xiwnz.com.tt,dga,3.25163,2,8,12,1,0.25,0.27097,2,2,1,0,5,2,2,1,0,5
6931,heardflower.net,dga,3.45656,5,9,15,1,0.55556,0.23044,3,0,0,0,3,3,0,0,0,3
608,www.msn.com,legit,2.66353,1,8,11,0,0.125,0.24214,1,0,0,0,1,0,0,0,0,0
9981,faixetrea.ddns.net,dga,3.35021,6,10,18,1,0.6,0.18612,4,1,0,0,5,7,4,3,2,16
1568,connectivitycheck.platform.hicloud.com,legit,3.99071,11,24,38,0,0.45833,0.10502,8,4,2,1,15,10,1,0,0,11
8552,volyruk.com,dga,3.27761,3,7,11,1,0.42857,0.29796,0,0,0,0,0,0,0,0,0,0
4529,webcast16-normal-c-useast2a.tiktokv.com,legit,4.18234,11,20,39,0,0.55,0.10724,7,6,4,3,20,8,0,0,0,8
606,iris.microsoft.com,legit,3.08605,6,10,18,0,0.6,0.17145,7,8,7,6,28,4,1,0,0,5
1681,footprintdns.com,legit,3.45282,4,11,16,0,0.36364,0.2158,5,1,0,0,6,4,2,0,0,6
5680,dawhpezmqdf.mooo.com,dga,3.48418,6,12,20,1,0.5,0.17421,2,0,0,0,2,0,1,2,1,4
8738,waroddafan.com,dga,3.18201,5,8,14,1,0.625,0.22729,1,1,0,0,2,3,0,0,0,3
9947,wk4c22kruzt7amgq3d.com,dga,4.0958,3,13,22,1,0.23077,0.18617,1,0,0,0,1,1,0,0,0,1
1882,gw.geoedge.be,legit,2.56545,5,6,13,0,0.83333,0.19734,2,2,1,0,5,2,0,0,0,2
116,x1.c.lencr.org,legit,3.18201,2,8,14,0,0.25,0.22729,4,0,0,0,4,2,0,0,0,2
533,msedge.b.tlu.dl.delivery.mp.microsoft.com,legit,3.89618,10,24,41,0,0.41667,0.09503,15,10,8,7,40,10,1,0,0,11
6486,alexandreaunderwood.net,dga,3.38162,10,12,23,1,0.83333,0.14703,5,0,0,0,5,7,1,0,0,8
5978,qsinmeqsobqqxawoi.com,dga,3.49923,7,13,21,1,0.53846,0.16663,1,0,0,0,1,2,0,0,0,2
7936,3fmpidovadqlefw.ddns.net,dga,3.9183,5,16,24,1,0.3125,0.16326,5,1,0,0,6,5,3,3,2,13
1423,pusher.com,legit,3.32193,3,6,10,0,0.5,0.33219,2,0,0,0,2,1,1,0,0,2
353,licensing.mp.microsoft.com,legit,3.63219,7,16,26,0,0.4375,0.1397,11,9,7,7,34,7,1,0,0,8
9814,cpitmmcvmqvpcil.com,dga,3.09003,3,15,19,1,0.2,0.16263,1,0,0,0,1,1,0,0,0,1
2228,7-courier.push.apple.com,legit,3.77206,8,11,24,0,0.72727,0.15717,9,4,3,2,18,4,0,0,0,4
4883,www.ebay.com,legit,3.02206,3,7,12,0,0.42857,0.25184,0,0,0,0,0,0,0,0,0,0
4052,relay.teams.trafficmanager.net,legit,3.57775,10,17,30,0,0.58824,0.11926,11,3,1,3,18,12,1,0,0,13
7058,acmemcdkdaflcbnf.com,dga,3.38418,4,15,20,1,0.26667,0.16921,1,0,0,0,1,2,0,0,0,2
3054,t.ssl.ak.dynamic.tiles.virtualearth.net,legit,3.79466,11,22,39,0,0.5,0.0973,11,3,0,0,14,9,2,1,0,12
2,microsoft.com,legit,3.02699,4,8,13,0,0.5,0.23285,5,7,6,5,23,2,0,0,0,2
3290,preview.redd.it,legit,3.05656,5,8,15,0,0.625,0.20377,3,0,0,0,3,3,0,0,0,3
8700,udvskbohq.com,dga,3.54659,3,9,13,1,0.33333,0.27281,0,0,0,0,0,0,0,0,0,0
4438,query.ess-apple.com.akadns.net,legit,3.92323,9,16,30,0,0.5625,0.13077,12,9,9,9,39,7,4,1,0,12
6500,yvkutsuoqosqsrcydfwofurdu.org,dga,3.70247,8,20,29,1,0.4,0.12767,1,0,0,0,1,1,0,0,0,1
6824,eplnn.ie,dga,2.5,3,4,8,1,0.75,0.3125,1,0,0,0,1,0,0,0,0,0
8289,richardinejessamyn.net,dga,3.66353,7,14,22,1,0.5,0.16652,4,0,0,0,4,7,3,1,0,11
5574,ssequifraudemveecclesie.com,dga,3.60602,12,14,27,1,0.85714,0.13356,4,0,0,0,4,9,0,0,0,9
5424,awfcwag.tv,dga,2.92193,2,7,10,1,0.28571,0.29219,0,0,0,0,0,0,0,0,0,0
7708,ilsucoegapudcew.ddns.net,dga,3.77206,8,14,24,1,0.57143,0.15717,5,1,0,0,6,7,3,3,2,15
1884,v10.vortex-win.data.microsoft.com,legit,4.05182,9,17,33,0,0.52941,0.12278,11,8,7,6,32,8,0,0,0,8
6816,uslumawwoci.com,dga,3.24022,6,8,15,1,0.75,0.21601,2,0,0,0,2,1,0,0,0,1
1227,dscq.akamai.net,legit,3.45656,5,8,15,0,0.625,0.23044,4,3,4,3,14,2,0,0,0,2
498,tps.doubleverify.com,legit,4.02193,6,12,20,0,0.5,0.2011,5,0,0,0,5,5,2,0,0,7
3887,cks.connatix.com,legit,3.32782,4,10,16,0,0.4,0.20799,6,2,0,0,8,4,3,0,0,7
8964,vhxtpvqesqhjppda.eu,dga,3.57662,4,14,19,1,0.28571,0.18824,2,0,0,0,2,1,0,0,0,1
3987,static.dataservices.hp.com,legit,3.63219,8,15,26,0,0.53333,0.1397,11,2,1,1,15,11,3,1,0,15
5286,qgaoawu4a4mo.top,dga,3.28064,7,6,16,1,1.16667,0.20504,0,0,0,0,0,0,0,0,0,0
575,a2z.com,legit,2.80735,2,3,7,0,0.66667,0.40105,0,0,0,0,0,0,0,0,0,0
661,id.rlcdn.com,legit,3.08496,2,8,12,0,0.25,0.25708,3,1,0,0,4,1,0,0,0,1
7208,bernadetteanjelica.net,dga,3.28333,9,12,22,1,0.75,0.14924,6,0,0,0,6,10,0,0,0,10
9765,iralohduicico.ddns.net,dga,3.66353,8,12,22,1,0.66667,0.16652,6,1,0,0,7,7,4,3,2,16
2315,word-telemetry.officeapps.live.com,legit,3.99572,11,19,34,0,0.57895,0.11752,10,5,4,3,22,10,0,0,0,10
1796,pull-f5-tt02.tiktokcdn.com.c.bytefcdn-oversea.com,legit,4.30168,10,28,49,0,0.35714,0.08779,10,10,12,8,40,9,5,1,0,15
5640,uxkpnaydizjfdyeupaqfyamug.org,dga,4.09023,9,19,29,1,0.47368,0.14104,1,0,0,0,1,1,0,0,0,1
773,z-p42-chat-e2ee-ig.facebook.com,legit,3.93775,10,12,31,0,0.83333,0.12702,3,0,0,0,3,3,1,0,0,4
138,graph.facebook.com,legit,3.57243,6,10,18,0,0.6,0.19847,4,0,0,0,4,3,0,0,0,3
2481,col.eum-appdynamics.com,legit,3.76227,7,13,23,0,0.53846,0.16358,6,2,0,0,8,4,1,0,0,5
7832,kycoeimcsmwkoqoy.org,dga,3.52193,6,13,20,1,0.46154,0.1761,1,0,0,0,1,1,0,0,0,1
9409,kefalid.info,dga,3.25163,5,6,12,1,0.83333,0.27097,1,0,0,0,1,0,0,0,0,0
6015,g4xdw7r6p3gb2il1v1.net,dga,4.27761,2,12,22,1,0.16667,0.19444,0,0,0,0,0,0,0,0,0,0
3081,sync.springserve.com,legit,3.58418,4,14,20,0,0.28571,0.17921,4,1,1,0,6,5,4,1,0,10
5210,fvsmqbkq.jp,dga,3.27761,0,10,11,1,0.0,0.29796,0,0,0,0,0,0,0,0,0,0
9262,bajwrcn.cc,dga,2.84644,1,8,10,1,0.125,0.28464,0,0,0,0,0,0,0,0,0,0
5813,beauregardsharlene.net,dga,3.40855,9,12,22,1,0.75,0.15493,5,0,0,0,5,7,0,0,0,7
8196,pqiyhyitivgsdtgzp32h44i55d50avm49ovps.ru,dga,4.34644,7,22,40,1,0.31818,0.10866,1,0,0,0,1,2,0,0,0,2
9573,gwendolinewilkerson.net,dga,3.48008,8,14,23,1,0.57143,0.15131,5,0,0,0,5,6,2,0,0,8
4405,globalsigncdn.com.cdn.cloudflare.net,legit,3.85021,9,23,36,0,0.3913,0.10695,7,8,6,3,24,7,2,1,0,10
8163,gqmkwiaoecgioees.org,dga,3.50869,9,10,20,1,0.9,0.17543,1,0,0,0,1,2,0,0,0,2
9747,linkculturepagefatherpen.com,dga,3.95021,10,17,28,1,0.58824,0.14108,7,1,0,0,8,6,2,1,1,10
3099,onedscolprdaus02.australiasoutheast.cloudapp.azure.com,legit,3.98147,21,27,54,0,0.77778,0.07373,18,5,3,4,30,9,2,0,0,11
6444,hangcompe.net,dga,3.39275,4,8,13,1,0.5,0.26098,1,1,0,0,2,3,1,0,0,4
4642,b.stats.paypal.com,legit,3.30827,4,11,18,0,0.36364,0.18379,4,0,0,0,4,3,0,0,0,3
3433,ntv.io,legit,2.58496,2,3,6,0,0.66667,0.43083,1,0,0,0,1,0,0,0,0,0
9831,jvbbunqhnj.com,dga,3.37878,2,11,14,1,0.18182,0.24134,0,0,0,0,0,0,0,0,0,0
6414,ekcaeaiugkeq.info,dga,3.45482,9,7,17,1,1.28571,0.20322,1,0,0,0,1,2,0,3,2,7
2232,4-courier.push.apple.com,legit,3.77206,8,11,24,0,0.72727,0.15717,9,4,3,2,18,4,0,0,0,4
6319,iqubpaeplaotta.ddns.net,dga,3.67531,8,13,23,1,0.61538,0.1598,4,1,0,0,5,6,4,3,2,15
4003,cpmstar.com,legit,3.0958,2,8,11,0,0.25,0.28144,2,0,0,0,2,3,0,0,0,3
2945,device-provisioning.googleapis.com,legit,3.7719,14,17,34,0,0.82353,0.11094,11,8,4,4,27,10,3,0,0,13
690,identrust.com,legit,3.54659,4,8,13,0,0.5,0.27281,4,1,0,0,5,3,1,0,0,4
4275,gslb-2.demdex.net,legit,3.57247,3,10,17,0,0.3,0.21015,1,0,0,0,1,3,0,0,0,3
5457,skgguskwugcacaay.org,dga,3.28418,6,13,20,1,0.46154,0.16421,1,0,0,0,1,2,0,0,0,2
3486,e6603.g.akamaiedge.net,legit,3.48171,8,7,22,0,1.14286,0.15826,5,5,5,3,18,4,0,0,0,4
7649,govoqidil.ddns.net,dga,3.46132,5,11,18,1,0.45455,0.1923,2,1,0,0,3,4,3,2,1,10
2883,ap-gue1.spotify.com,legit,3.93214,6,9,19,0,0.66667,0.20695,2,0,0,0,2,1,0,0,0,1
3970,wlhrm-a-3.prod.infra.webex.com,legit,4.08173,7,16,30,0,0.4375,0.13606,5,4,3,2,14,3,2,0,0,5
3419,choices-or.trustarc.com,legit,3.5014,7,13,23,0,0.53846,0.15223,7,1,0,0,8,7,0,0,0,7
5942,gegixiexa.ddns.net,dga,3.2391,6,10,18,1,0.6,0.17995,3,1,0,0,4,5,4,3,2,14
1772,fcdn.us.gts.ttoverseaus.net,legit,3.54174,7,16,27,0,0.4375,0.13118,8,2,1,0,11,5,3,0,0,8
8538,nwyaclykibdgtdjgff.ir,dga,3.91613,3,17,21,1,0.17647,0.18648,0,0,0,0,0,1,0,0,0,1
3910,webcontentassessor.com,legit,3.39081,7,14,22,0,0.5,0.15413,8,2,0,0,10,9,4,0,0,13
2559,pull-cmaf-l10-sg01.tiktokcdn.com.rocket-cdn.com,legit,4.13907,8,27,47,0,0.2963,0.08807,8,10,12,10,40,6,2,1,0,9
8892,mmfbademebodmeff.com,dga,2.96596,6,13,20,1,0.46154,0.1483,1,0,0,0,1,2,0,0,0,2
1446,alb.reddit.com,legit,3.52164,4,8,14,0,0.5,0.25155,2,0,0,0,2,4,0,0,0,4
7848,seofozmu.ru,dga,3.0958,5,5,11,1,1.0,0.28144,2,0,0,0,2,1,0,0,0,1
8675,bhlvbmfsbu.com,dga,3.32486,2,11,14,1,0.18182,0.23749,0,0,0,0,0,0,0,0,0,0
3882,alcdn.msauth.net,legit,3.5,4,10,16,0,0.4,0.21875,3,2,1,0,6,1,0,0,0,1
2819,config2.mparticle.com,legit,3.78494,6,12,21,0,0.5,0.18024,6,1,0,0,7,6,1,0,0,7
5493,gpanyz.mooo.com,dga,3.10689,5,8,15,1,0.625,0.20713,2,0,0,0,2,1,1,2,1,5
6324,ndqypplxxtts.ru,dga,3.50689,1,13,15,1,0.07692,0.23379,2,1,0,0,3,1,0,0,0,1
486,omtrdc.net,legit,3.12193,2,7,10,0,0.28571,0.31219,0,0,0,0,0,1,0,0,0,1
7823,kcrdehjgqr.com,dga,3.52164,2,11,14,1,0.18182,0.25155,1,0,0,0,1,1,0,0,0,1
33,google-analytics.com,legit,3.68418,7,11,20,0,0.63636,0.18421,4,4,3,2,13,4,0,0,0,4
7378,pyptgxurgxoyy.net,dga,3.33718,3,13,17,1,0.23077,0.1963,0,0,0,0,0,0,0,0,0,0
1562,is3-ssl.mzstatic.com,legit,3.42193,4,12,20,0,0.33333,0.1711,6,0,0,0,6,6,1,0,0,7
7705,pujawog.info,dga,3.4183,5,6,12,1,0.83333,0.28486,0,0,0,0,0,0,0,0,0,0
2907,ws.rqtrk.eu,legit,3.0958,2,7,11,0,0.28571,0.28144,1,0,0,0,1,0,0,0,0,0
3747,post.update.rubiconproject.com,legit,3.80624,10,17,30,0,0.58824,0.12687,9,2,0,0,11,7,3,0,0,10
4450,e6115.g.akamaiedge.net,legit,3.48171,8,7,22,0,1.14286,0.15826,5,5,5,3,18,4,0,0,0,4
888,company-target.com,legit,3.61437,5,11,18,0,0.45455,0.2008,3,1,0,0,4,7,1,0,0,8
2966,prod.configsvc1.live.com.akadns.net,legit,4.04716,9,20,35,0,0.45,0.11563,11,10,9,9,39,6,5,1,0,12
7310,coquividruh.ddns.net,dga,3.68418,6,12,20,1,0.5,0.18421,3,1,0,0,4,5,3,2,2,12
4482,presentation-atl1.turn.com,legit,3.82525,8,14,26,0,0.57143,0.14712,11,1,0,0,12,8,6,2,1,17
6544,giwswhmkcidskyhf.eu,dga,3.72161,4,14,19,1,0.28571,0.19587,1,0,0,0,1,0,0,0,0,0
9574,somowwi.com,dga,2.66353,4,6,11,1,0.66667,0.24214,0,0,0,0,0,1,0,0,0,1
6661,flafodmacbbbmbfd.com,dga,3.04644,4,15,20,1,0.26667,0.15232,1,0,0,0,1,3,0,0,0,3
2541,array501.prod.do.dsp.mp.microsoft.com,legit,3.71259,8,20,37,0,0.4,0.10034,12,12,10,9,43,5,2,0,0,7
4682,acctcdnvzeuno.azureedge.net,legit,3.52824,10,15,27,0,0.66667,0.13068,6,3,1,2,12,5,0,0,0,5
6109,jiidkqyavwg.mooo.com,dga,3.62193,7,11,20,1,0.63636,0.1811,2,0,0,0,2,0,1,2,1,4
8153,sxijyxpgghtb.com,dga,3.75,2,13,16,1,0.15385,0.23438,0,0,0,0,0,0,0,0,0,0
3243,attentivemobile.com,legit,3.43162,8,10,19,0,0.8,0.18061,6,1,0,0,7,7,1,0,0,8
2049,discord.com,legit,2.91398,3,7,11,0,0.42857,0.26491,1,0,0,0,1,3,0,0,0,3
8327,gjsmmqujbskjnu.co.uk,dga,3.44644,4,14,20,1,0.28571,0.17232,2,1,0,0,3,1,1,0,0,2
8894,uwtfavwlkilbbmug.com,dga,3.82193,5,14,20,1,0.35714,0.1911,0,0,0,0,0,0,0,0,0,0
4498,clients5.google.com,legit,3.47135,6,10,19,0,0.6,0.1827,5,6,4,3,18,2,1,0,0,3
6096,remained-overview.vn,dga,3.38418,8,10,20,1,0.8,0.16921,5,0,0,0,5,8,4,0,0,12
8062,essenegociin.com,dga,3.07782,7,8,16,1,0.875,0.19236,4,0,0,0,4,5,1,0,0,6
7423,qv7pqrgbsh7xu47ho0ir1ni.ddns.net,dga,4.26532,5,19,32,1,0.26316,0.13329,2,1,0,0,3,5,4,3,2,14
6575,cnlbimpmsxyklpgs.eu,dga,3.82687,3,15,19,1,0.2,0.20141,0,0,0,0,0,0,0,0,0,0
1771,tiktokcdn.com.rocket-cdn.com,legit,3.38327,6,18,28,0,0.33333,0.12083,6,9,9,6,30,5,2,1,0,8
7831,sizegardensolveslightreward.com,dga,4.00227,10,20,31,1,0.5,0.12911,4,0,0,0,4,8,0,0,0,8
1970,easylist-downloads.adblockplus.org,legit,4.04306,10,21,34,0,0.47619,0.11891,10,0,0,0,10,4,1,0,0,5
4683,26.ras.yahoo.com,legit,3.28064,5,6,16,0,0.83333,0.20504,3,0,0,1,4,2,0,0,0,2
2095,tag.researchnow.com,legit,3.61635,6,11,19,0,0.54545,0.19033,5,0,0,0,5,6,1,0,0,7
7344,ztbknpechy.com,dga,3.6645,2,11,14,1,0.18182,0.26175,0,0,0,0,0,1,0,0,0,1
9840,dekkbzdlu5fzxjouwd.net,dga,3.87966,5,15,22,1,0.33333,0.17635,1,0,0,0,1,1,0,0,0,1
2326,www.walmart.com,legit,2.97356,3,10,15,0,0.3,0.19824,1,0,0,0,1,2,0,0,0,2
5567,3nopmd1pwji2spwtc0q2m0s.ddns.net,dga,4.03064,3,21,32,1,0.14286,0.12596,3,1,0,0,4,4,3,3,2,12
4033,cdn-ima.33across.com,legit,3.48418,5,10,20,0,0.5,0.17421,5,3,1,0,9,3,0,0,0,3
4088,prod.us-east-1.sonar.prime-video.amazon.dev,legit,3.92326,15,19,43,0,0.78947,0.09124,10,6,5,4,25,9,1,0,0,10
4895,www138.civicscience.com,legit,3.43141,6,12,23,0,0.5,0.14919,4,0,0,0,4,3,1,1,0,5
2309,c21lg-d.media.net,legit,3.73452,4,8,17,0,0.5,0.21968,3,0,0,0,3,1,0,0,0,1
5850,nightletter.net,dga,2.92323,4,10,15,1,0.4,0.19488,3,0,0,0,3,5,1,0,0,6
7242,eksfnshqfgorapedu.com,dga,4.01137,6,14,21,1,0.42857,0.19102,3,0,0,0,3,4,0,0,0,4
810,cdn.linkedin.oribi.io,legit,3.19615,8,10,21,0,0.8,0.1522,5,2,1,0,8,5,0,0,0,5
9578,owfutuffnjjy.ru,dga,3.13957,4,10,15,1,0.4,0.2093,0,0,0,0,0,0,0,0,0,0
8999,abeefkecdbbeffdb.com,dga,3.08418,6,13,20,1,0.46154,0.15421,1,0,0,0,1,2,0,0,0,2
2298,cdn-settings.appsflyersdk.com,legit,4.09936,5,21,29,0,0.2381,0.14136,10,3,1,0,14,6,2,0,0,8
3771,video-api.yql.yahoo.com,legit,3.70813,9,10,23,0,0.9,0.16122,3,1,1,1,6,1,0,0,0,1
4224,narrative.io,legit,3.08496,6,5,12,0,1.2,0.25708,3,0,0,0,3,5,1,0,0,6
4424,dt.dbankcloud.cn,legit,3.32782,3,11,16,0,0.27273,0.20799,3,3,2,1,9,2,0,0,0,2
2673,onedscolprdwus01.westus.cloudapp.azure.com,legit,3.98709,13,23,42,0,0.56522,0.09493,17,4,3,4,28,7,2,0,0,9
225,cm.g.doubleclick.net,legit,3.64644,5,12,20,0,0.41667,0.18232,5,0,0,0,5,4,0,0,0,4
9183,zyhxorci.com,dga,3.25163,3,8,12,1,0.375,0.27097,0,0,0,0,0,1,0,0,0,1
2677,time.nist.gov,legit,3.2389,4,7,13,0,0.57143,0.24915,3,0,0,0,3,4,1,0,0,5
8714,ysskcwiugkeq.info,dga,3.73452,5,11,17,1,0.45455,0.21968,0,0,0,0,0,0,0,3,2,5
649,p.typekit.net,legit,2.87314,3,8,13,0,0.375,0.22101,2,0,0,0,2,1,0,0,0,1
2465,network-auth.com,legit,3.75,5,9,16,0,0.55556,0.23438,0,0,0,0,0,3,0,0,0,3
9997,epyjcxudpvj.com,dga,3.50689,3,11,15,1,0.27273,0.23379,0,0,0,0,0,0,0,0,0,0
487,mesu-cdn.origin-apple.com.akadns.net,legit,4.01688,11,19,36,0,0.57895,0.11158,13,11,10,9,43,10,3,1,0,14
2970,jwpltx.com,legit,3.32193,1,8,10,0,0.125,0.33219,1,0,0,0,1,0,0,0,0,0
4580,adobesearch-sec-uss.adobe.io,legit,3.53915,12,12,28,0,1.0,0.1264,7,0,0,0,7,6,0,0,0,6
8329,qgakaswkiukqkycu.org,dga,3.52193,6,13,20,1,0.46154,0.1761,0,1,0,0,1,1,0,0,0,1
8136,spendtear.net,dga,3.02699,4,8,13,1,0.5,0.23285,3,0,0,0,3,5,0,0,0,5
1731,pull-f5-tt02-infra.fcdn.us.tiktokv.com,legit,4.2082,7,21,38,0,0.33333,0.11074,8,7,7,4,26,4,0,0,0,4
7319,moriturissuefficaces.com,dga,3.4906,10,13,24,1,0.76923,0.14544,3,2,1,0,6,10,2,0,0,12
4485,ecp.yusercontent.com,legit,3.44644,6,12,20,0,0.5,0.17232,9,3,0,0,12,7,3,0,0,10
8296,avaxotka.ddns.net,dga,3.33718,5,10,17,1,0.5,0.1963,2,1,0,0,3,4,4,3,2,13
7402,efomfanbafaadble.com,dga,3.28418,8,11,20,1,0.72727,0.16421,2,0,0,0,2,3,0,0,0,3
2615,sync.spotim.market,legit,3.72548,4,12,18,0,0.33333,0.20697,1,0,0,0,1,1,0,0,0,1
6644,lbbwmmcmtuktcttnu.com,dga,3.21351,3,17,21,1,0.17647,0.15302,0,0,0,0,0,0,0,0,0,0
4029,sojern.com,legit,3.12193,3,6,10,0,0.5,0.31219,1,0,0,0,1,1,0,0,0,1
3164,csync.smartadserver.com,legit,3.55553,5,16,23,0,0.3125,0.15459,6,1,1,0,8,6,3,1,0,10
5315,o51ftp62gro61bugvh34nrgtcxawgtexfvd50.net,dga,4.4795,6,24,41,1,0.25,0.10926,2,0,0,0,2,1,0,0,0,1
8294,akocordepthbkbmyt.tw,dga,3.78418,4,15,20,1,0.26667,0.18921,1,0,0,0,1,3,0,0,0,3
8951,yndvkuu.tv,dga,2.92193,2,7,10,1,0.28571,0.29219,0,0,0,0,0,1,0,0,0,1
3828,api-apac.flightproxy.teams.microsoft.com,legit,3.97757,12,23,40,0,0.52174,0.09944,15,10,7,6,38,6,1,0,0,7
8989,qmeppmttsxyv.biz,dga,3.625,2,13,16,1,0.15385,0.22656,1,0,0,0,1,0,0,0,0,0
2215,46-courier.push.apple.com,legit,3.86347,8,11,25,0,0.72727,0.15454,9,4,3,2,18,4,0,0,0,4
7062,bckbleaaalnfedac.info,dga,3.43994,8,12,21,1,0.66667,0.16381,3,0,0,0,3,4,0,0,0,4
5098,ocykiaammsweeisa.org,dga,3.58418,9,10,20,1,0.9,0.17921,1,0,0,0,1,2,0,0,0,2
4254,ip-api.com,legit,2.92193,4,4,10,0,1.0,0.29219,2,1,0,0,3,0,0,0,0,0
9877,gurgpbaegnwyseqm.eu,dga,3.64215,6,12,19,1,0.5,0.19169,1,0,0,0,1,1,0,0,0,1
6855,studyzoneprovestagedesire.com,dga,3.92283,11,17,29,1,0.64706,0.13527,9,2,0,0,11,11,4,0,0,15
6617,oncp7jcnmtmnutorw6g.ddns.net,dga,3.86576,4,20,28,1,0.2,0.13806,3,1,0,0,4,6,3,3,2,14
6844,xicvjmlhoxnzixjs.biz,dga,3.64644,4,15,20,1,0.26667,0.18232,1,0,0,0,1,1,0,0,0,1
4441,adx.adform.net,legit,3.37878,4,8,14,0,0.5,0.24134,2,0,0,0,2,1,0,0,0,1
135,flightproxy.teams.microsoft.com,legit,3.9134,8,20,31,0,0.4,0.12624,13,9,7,6,35,5,1,0,0,6
4527,chocolateplatform.com,legit,3.40399,7,13,21,0,0.53846,0.16209,4,0,0,0,4,5,1,0,0,6
7445,mqtoqyfqbex.com,dga,3.32323,3,11,15,1,0.27273,0.22155,0,0,0,0,0,1,3,2,1,7
6174,6c4i37rz5b7uaitea8.biz,dga,3.87966,7,7,22,1,1.0,0.17635,2,0,0,0,2,3,0,0,0,3
7778,feabilxu.ru,dga,3.27761,5,5,11,1,1.0,0.29796,1,0,0,0,1,1,0,0,0,1
6616,rcqkszxaj.cc,dga,3.18872,1,10,12,1,0.1,0.26573,0,0,0,0,0,0,0,0,0,0
4732,e10370.d.akamaiedge.net,legit,3.58835,8,7,23,0,1.14286,0.15602,7,5,5,3,20,5,0,0,0,5
5307,wittenbergcharitas.com,dga,3.78875,7,14,22,1,0.5,0.17222,4,0,0,0,4,9,2,1,0,12
5902,gytmailfxs.com,dga,3.6645,3,10,14,1,0.3,0.26175,1,0,0,0,1,1,0,0,0,1
3524,cdn-f.adsmoloco.com,legit,3.26083,5,11,19,0,0.45455,0.17162,7,1,0,0,8,2,0,0,0,2
1498,c.clarity.ms,legit,3.25163,2,8,12,0,0.25,0.27097,1,0,0,0,1,4,0,0,0,4
9377,penxhru.mooo.com,dga,3.25,6,8,16,1,0.75,0.20312,3,0,0,0,3,1,1,2,1,5
8608,mg5ajr8ppeo8ri7h21.biz,dga,4.0958,5,10,22,1,0.5,0.18617,1,0,0,0,1,1,0,0,0,1
3478,launchpad.privacymanager.io,legit,3.88046,10,15,27,0,0.66667,0.14372,6,2,0,3,11,7,0,1,0,8
5835,zehhgtbekneuygidyk.com,dga,3.87966,6,15,22,1,0.4,0.17635,0,0,0,0,0,2,0,0,0,2
7345,weatherneither.net,dga,2.92745,7,10,18,1,0.7,0.16264,3,0,0,0,3,5,1,1,1,8
5745,etqja.hn,dga,3.0,2,5,8,1,0.4,0.375,0,0,0,0,0,1,0,0,0,1
6248,7gjq1uoldwry7f5gw2.biz,dga,4.1867,3,13,22,1,0.23077,0.1903,0,0,0,0,0,0,0,0,0,0
2218,18-courier.push.apple.com,legit,3.86347,8,11,25,0,0.72727,0.15454,9,4,3,2,18,4,0,0,0,4
8797,zlifhhranz.cc,dga,3.2389,2,10,13,1,0.2,0.24915,2,0,0,0,2,2,0,0,0,2
6392,gygkxtvp.com,dga,3.4183,1,10,12,1,0.1,0.28486,0,0,0,0,0,0,0,0,0,0
2202,calliope-anycast.prod.infra.webex.com,legit,4.12122,12,20,37,0,0.6,0.11138,7,5,3,2,17,7,2,0,0,9
6168,blccnaalefanddbk.org,dga,3.58418,5,14,20,1,0.35714,0.17921,1,0,0,0,1,4,1,0,0,5
8788,dhegtifox.cc,dga,3.4183,3,8,12,1,0.375,0.28486,1,0,0,0,1,1,0,0,0,1
2130,prod.hydra.sophos.com,legit,3.30875,5,13,21,0,0.38462,0.15756,4,3,2,1,10,1,1,0,0,2
3844,sync-eu.connectad.io,legit,3.54644,7,10,20,0,0.7,0.17732,5,2,0,0,7,5,2,0,0,7
4643,us06web.zoom.us,legit,3.37356,5,6,15,0,0.83333,0.2249,2,0,0,0,2,1,0,0,0,1
6406,pvipotestproptersiveni.com,dga,3.43046,9,16,26,1,0.5625,0.13194,7,1,0,0,8,8,4,0,0,12
2979,t.mookie1.com,legit,3.02699,5,5,13,0,1.0,0.23285,2,0,0,0,2,0,0,1,0,1
4178,pollserver.lastpass.com,legit,3.44726,6,15,23,0,0.4,0.14988,3,2,1,0,6,6,4,1,0,11
9457,nqpeqtkbfhwomadab.me,dga,3.82193,5,14,20,1,0.35714,0.1911,2,0,0,0,2,2,0,0,0,2
3930,content.jwplatform.com,legit,3.66353,5,15,22,0,0.33333,0.16652,7,2,0,0,9,7,2,0,0,9
329,x.bidswitch.net,legit,3.50689,3,10,15,0,0.3,0.23379,1,0,0,0,1,1,0,0,0,1
3009,www.reddit.com,legit,3.18201,3,9,14,0,0.33333,0.22729,2,0,0,0,2,4,0,0,0,4
4952,beacon.walmart.com,legit,3.46132,6,10,18,0,0.6,0.1923,4,1,0,0,5,7,1,0,0,8
7925,ebtkudmwbphlhyowabjem.bz,dga,3.9183,5,18,24,1,0.27778,0.16326,0,0,0,0,0,1,0,0,0,1
9110,oekhjwihesi.yi.org,dga,3.46132,7,9,18,1,0.77778,0.1923,1,0,0,0,1,2,0,0,0,2
3128,sentry-cdn.com,legit,3.52164,2,10,14,0,0.2,0.25155,5,2,0,0,7,3,1,0,0,4
5790,kajwyvopaanwnuopbj.com,dga,3.66353,7,14,22,1,0.5,0.16652,0,0,0,0,0,1,0,0,0,1
4954,c1.rfihub.net,legit,3.54659,3,7,13,0,0.42857,0.27281,0,0,0,0,0,0,0,0,0,0
5359,kgmeibnmqb.com,dga,3.32486,3,10,14,1,0.3,0.23749,0,0,0,0,0,0,0,0,0,0
7855,wglnwxssfssh.com,dga,3.375,1,14,16,1,0.07143,0.21094,0,0,0,0,0,0,0,0,0,0
9604,weed-newark.yt,dga,3.32486,4,8,14,1,0.5,0.23749,1,0,0,0,1,3,0,0,0,3
9914,irxmmyrjiuqexj.info,dga,3.57662,6,12,19,1,0.5,0.18824,0,0,0,0,0,0,0,0,0,0
2116,a116.us.akamai.net,legit,3.35021,7,5,18,0,1.4,0.18612,5,3,4,3,15,2,0,0,0,2
1065,secure-assets.rubiconproject.com,legit,3.76532,11,18,32,0,0.61111,0.11767,8,2,0,0,10,8,3,0,0,11
5657,xxaskwdoi.net,dga,3.54659,4,8,13,1,0.5,0.27281,0,0,0,0,0,1,0,0,0,1
4036,audioeye.com,legit,3.25163,7,4,12,0,1.75,0.27097,0,0,0,0,0,0,0,0,0,0
3947,prreqcroab.icu,legit,3.32486,5,8,14,0,0.625,0.23749,4,1,0,0,5,1,0,0,0,1
9741,vmtnogrowbqgwwfgehgpw.ug,dga,3.68456,4,19,24,1,0.21053,0.15352,2,0,0,0,2,1,0,0,0,1
7950,kiygcguiwcymao.info,dga,3.57662,7,11,19,1,0.63636,0.18824,1,0,0,0,1,1,0,5,4,10
2081,mtunnel.meraki.com,legit,3.57243,6,10,18,0,0.6,0.19847,3,0,0,0,3,4,0,0,0,4
2896,perf.linkedin.com,legit,3.61687,5,10,17,0,0.5,0.21276,4,0,0,0,4,3,0,0,0,3
7270,puxneixe.ru,dga,2.91398,5,5,11,1,1.0,0.26491,0,0,0,0,0,1,0,0,0,1
7544,op1tw6yhm27vw83.ddns.net,dga,4.1683,2,14,24,1,0.14286,0.17368,2,1,0,0,3,4,3,2,2,11
6960,edhbukupsa.com,dga,3.6645,5,8,14,1,0.625,0.26175,1,0,0,0,1,1,0,0,0,1
2356,inv-nets.admixer.net,legit,3.54644,6,11,20,0,0.54545,0.17732,6,0,0,0,6,5,0,0,0,5
1389,tapestry.tapad.com,legit,3.41938,5,11,18,0,0.45455,0.18997,6,0,0,0,6,3,1,0,0,4
8925,paunisdandisauribuspie.com,dga,3.61334,12,13,26,1,0.92308,0.13897,2,0,0,0,2,5,1,0,0,6
4646,us.pool.ntp.org,legit,3.13957,4,8,15,0,0.5,0.2093,4,0,0,0,4,0,0,0,0,0
8889,ugwiceslofe.com,dga,3.50689,6,8,15,1,0.75,0.23379,5,1,0,0,6,3,0,0,0,3
3465,feelinsonice.l.google.com,legit,3.30347,10,12,25,0,0.83333,0.13214,8,6,4,3,21,8,0,0,0,8
8742,glgijml.net,dga,3.0958,2,8,11,1,0.25,0.28144,0,0,0,0,0,0,0,0,0,0
1661,clients2.googleusercontent.com,legit,3.6314,10,17,30,0,0.58824,0.12105,11,8,4,3,26,7,3,0,0,10
2601,appswaldo-pa.clients6.google.com,legit,3.90564,10,17,32,0,0.58824,0.12205,8,7,4,3,22,2,1,0,0,3
9354,ttsnfckhrohq.biz,dga,3.75,2,13,16,1,0.15385,0.23438,1,0,0,0,1,0,0,0,0,0
1159,storeedgefd.dsx.mp.microsoft.com,legit,3.65564,8,20,32,0,0.4,0.11424,14,10,8,7,39,8,0,0,0,8
2053,array513.prod.do.dsp.mp.microsoft.com,legit,3.71259,8,20,37,0,0.4,0.10034,12,12,10,9,43,5,2,0,0,7
5935,piubzndgmebu.dyndns.org,dga,3.76227,5,16,23,1,0.3125,0.16358,3,1,0,0,4,4,3,4,3,14
512,cdn.whatsapp.net,legit,3.375,3,11,16,0,0.27273,0.21094,5,3,1,0,9,2,0,0,0,2
1011,tg.socdm.com,legit,2.9183,2,8,12,0,0.25,0.24319,1,0,0,0,1,0,0,0,0,0
3784,manage.agent-cluster1.prod.us001-prod.arcticwolf.net,legit,4.24132,14,27,52,0,0.51852,0.08156,15,6,3,4,28,10,3,0,0,13
8376,sosiiymisiyuqees.org,dga,3.22193,9,10,20,1,0.9,0.1611,2,0,0,0,2,4,0,0,0,4
8119,cgbezjewpo.com,dga,3.37878,4,9,14,1,0.44444,0.24134,0,0,0,0,0,1,0,0,0,1
1469,rtr.innovid.com,legit,3.24022,4,9,15,0,0.44444,0.21601,1,0,0,0,1,1,0,0,0,1
8257,ewiwuvem.be,dga,2.84535,5,5,11,1,1.0,0.25867,0,0,0,0,0,2,0,0,0,2
8821,doadipdtvsukwquyb.su,dga,3.74644,6,13,20,1,0.46154,0.18732,1,0,0,0,1,1,0,0,0,1
1502,cdn.adnxs.com,legit,3.08506,2,9,13,0,0.22222,0.23731,4,2,1,0,7,1,0,0,0,1
396,adsafeprotected.com,legit,3.47135,7,11,19,0,0.63636,0.1827,6,1,0,0,7,3,1,0,0,4
5289,rupcesn.cc,dga,2.84644,2,7,10,1,0.28571,0.28464,2,0,0,0,2,2,0,0,0,2
6261,hwavoqjqjreug53dzhwo51nqh44kti45e31b48.net,dga,4.41566,8,21,42,1,0.38095,0.10513,2,0,0,0,2,2,0,0,0,2
1229,amp-api-edge-lb.itunes-apple.com.akadns.net,legit,3.93849,14,21,43,0,0.66667,0.09159,15,12,10,9,46,11,3,1,0,15
9689,bksqvfglnc.com,dga,3.6645,1,12,14,1,0.08333,0.26175,0,0,0,0,0,0,0,0,0,0
4187,mp.microsoft.com.akadns.net,legit,3.73601,7,16,27,0,0.4375,0.13837,12,14,14,14,54,6,3,1,0,10
3077,block.opendns.com,legit,3.45482,4,11,17,0,0.36364,0.20322,3,1,0,0,4,4,1,1,0,6
5735,hxjezssbbv.com,dga,3.52164,2,11,14,1,0.18182,0.25155,0,0,0,0,0,0,0,0,0,0
4155,t.pswec.com,legit,3.0958,2,7,11,0,0.28571,0.28144,0,0,0,0,0,1,0,0,0,1
6698,ebitobqilam.ddns.net,dga,3.62193,6,12,20,1,0.5,0.1811,3,1,0,0,4,7,3,2,2,14
8068,gaphnvynviyd.ru,dga,3.50689,3,11,15,1,0.27273,0.23379,1,0,0,0,1,0,0,0,0,0
9346,triedcloth.net,dga,3.32486,4,9,14,1,0.44444,0.23749,2,1,0,0,3,2,0,0,0,2
7307,szludyfqbex.cc,dga,3.6645,2,11,14,1,0.18182,0.26175,0,0,0,0,0,1,3,2,1,7
1486,www.instagram.com,legit,3.45482,4,11,17,0,0.36364,0.20322,5,0,0,0,5,6,0,0,0,6
4156,akaquill.net,legit,3.25163,5,6,12,0,0.83333,0.27097,0,1,0,0,1,0,0,0,0,0
8282,afvoliovaks.ddns.net,dga,3.62193,6,12,20,1,0.5,0.1811,4,1,0,0,5,4,3,3,2,12
5592,aaciuyimyesougck.org,dga,3.62193,9,10,20,1,0.9,0.1811,2,0,0,0,2,2,0,0,0,2
4675,c1-shared-15.cdn.office.net,legit,3.8562,6,13,27,0,0.46154,0.14282,8,6,5,3,22,6,0,0,0,6
456,ssum-sec.casalemedia.com,legit,3.37581,9,12,24,0,0.75,0.14066,4,0,0,0,4,8,0,0,0,8
8081,4esm0i8ukqsu.org,dga,3.75,5,7,16,1,0.71429,0.23438,1,0,0,0,1,2,0,0,0,2
2575,applicationinsights.azure.com,legit,3.9354,11,16,29,0,0.6875,0.1357,12,2,1,2,17,10,3,2,1,16
9419,visitheld.net,dga,3.2389,4,8,13,1,0.5,0.24915,0,0,0,0,0,4,0,0,0,4
9392,avwlgepxuhvx.org,dga,3.625,4,11,16,1,0.36364,0.22656,1,0,0,0,1,1,0,0,0,1
9810,wtodkpspwxsdk8uhcnevmrc.ddns.net,dga,4.01532,4,25,32,1,0.16,0.12548,2,1,0,0,3,5,3,2,2,12
9851,volymif.com,dga,3.0958,3,7,11,1,0.42857,0.28144,1,0,0,0,1,1,0,0,0,1
2187,excel.officeapps.live.com,legit,3.54347,9,13,25,0,0.69231,0.14174,8,5,4,3,20,5,0,0,0,5
7758,qecdxbpmy.net,dga,3.54659,2,10,13,1,0.2,0.27281,1,0,0,0,1,1,0,0,0,1
9376,twnhoxjafq.com,dga,3.6645,3,10,14,1,0.3,0.26175,0,0,0,0,0,0,0,0,0,0
5,live.com,legit,3.0,3,4,8,0,0.75,0.375,1,0,0,0,1,1,0,0,0,1
6982,gnpvtsxwfedm.biz,dga,4.0,2,13,16,1,0.15385,0.25,1,0,0,0,1,1,0,0,0,1
3876,dl-edge.smartscreen.microsoft.com,legit,3.81623,9,20,33,0,0.45,0.11564,12,10,8,6,36,8,0,0,0,8
7516,rtzuqotz.dyndns.org,dga,3.51109,3,14,19,1,0.21429,0.18479,2,1,0,0,3,4,3,4,3,14
6831,cvgls2a0ojqj14gx1h3.ddns.net,dga,4.30735,3,17,28,1,0.17647,0.15383,2,1,0,0,3,4,3,2,2,11
1086,hicloud.com,legit,3.0958,4,6,11,0,0.66667,0.28144,3,3,2,1,9,1,0,0,0,1
2472,strln.net,legit,2.72548,1,7,9,0,0.14286,0.30283,1,0,0,0,1,1,0,0,0,1
4091,mediaservices.cdn-apple.com,legit,3.76397,9,15,27,0,0.6,0.13941,14,6,3,2,25,9,2,1,0,12
3939,applications.apis.classlink.com,legit,3.43744,10,18,31,0,0.55556,0.11089,13,4,1,0,18,10,4,2,1,17
7488,semvwhrevrrdcgay.eu,dga,3.64215,5,13,19,1,0.38462,0.19169,2,0,0,0,2,3,0,0,0,3
9636,socvwfkou.kz,dga,3.25163,3,8,12,1,0.375,0.27097,1,0,0,0,1,0,0,0,0,0
7157,ocegewaumcuquyyw.org,dga,3.48418,8,11,20,1,0.72727,0.17421,2,0,0,0,2,2,0,0,0,2
6221,goyrtveopwmxpmeia.tw,dga,3.72193,6,13,20,1,0.46154,0.1861,0,0,0,0,0,1,0,0,0,1
9038,lygyxor.com,dga,3.0958,2,8,11,1,0.25,0.28144,0,0,0,0,0,1,0,0,0,1
6797,rxvvtijraebbk.com,dga,3.73452,4,12,17,1,0.33333,0.21968,2,0,0,0,2,2,0,0,0,2
4596,telephony.goog,legit,3.18201,5,8,14,0,0.625,0.22729,3,0,0,0,3,4,0,0,0,4
9094,necesso.com,dga,2.73216,4,6,11,1,0.66667,0.24838,2,0,0,0,2,4,1,0,0,5
9522,zrysutkidq.com,dga,3.80735,3,10,14,1,0.3,0.27195,0,0,0,0,0,1,0,0,0,1
5271,ccfupgfxjvbi.com,dga,3.57782,3,12,16,1,0.25,0.22361,0,0,0,0,0,0,0,0,0,0
4167,eu-api.asm.skype.com,legit,3.58418,7,9,20,0,0.77778,0.17921,3,1,1,0,5,1,0,0,0,1
4122,media.amazon.map.fastly.net,legit,3.63028,9,14,27,0,0.64286,0.13445,9,2,3,3,17,6,0,0,0,6
2586,udc.yahoo.com,legit,3.02699,5,6,13,0,0.83333,0.23285,1,0,0,1,2,0,0,0,0,0
3662,pull-flv-f1-va01.tiktokcdn.com,legit,4.05656,5,17,30,0,0.29412,0.13522,4,6,9,9,28,2,0,0,0,2
7861,dvglmnmntmtdsdved.com,dga,3.3447,2,18,21,1,0.11111,0.15927,3,0,0,0,3,2,0,0,0,2
5873,letuwwi.com,dga,3.27761,4,6,11,1,0.66667,0.29796,1,0,0,0,1,2,0,0,0,2
3027,js.hsadspixel.net,legit,3.57247,4,11,17,0,0.36364,0.21015,4,0,0,0,4,1,0,0,0,1
9948,madeleineanthonyson.net,dga,3.4101,9,13,23,1,0.69231,0.14827,7,0,0,0,7,9,1,0,0,10
3863,boltdns.net,legit,3.0958,2,8,11,0,0.25,0.28144,1,1,0,0,2,2,1,0,0,3
5568,blnfnclbkbdbdemc.com,dga,3.28418,2,17,20,1,0.11765,0.16421,0,0,0,0,0,2,0,0,0,2
6865,juaexiggbxpphxryt.su,dga,3.78418,5,14,20,1,0.35714,0.18921,1,0,0,0,1,0,0,0,0,0
4283,p001.1drv.com,legit,3.2389,1,6,13,0,0.16667,0.24915,0,0,0,0,0,0,0,0,0,0
4148,tagged-by.rubiconproject.net.akadns.net,legit,4.03528,11,23,39,0,0.47826,0.10347,11,5,4,3,23,11,3,0,0,14
8477,contractquamqudocetene.com,dga,3.45949,10,15,26,1,0.66667,0.13306,8,1,0,0,9,10,2,0,1,13
3048,net.cdn.cloudflare.net,legit,3.4474,6,13,22,0,0.46154,0.1567,6,5,4,2,17,6,0,0,0,6
8613,asvcqpuror.com,dga,3.37878,4,9,14,1,0.44444,0.24134,1,0,0,0,1,2,0,0,0,2
6325,fpepnfficxbymgpbf.tj,dga,3.58418,2,17,20,1,0.11765,0.17921,1,2,1,0,4,1,0,0,0,1
1953,tnc16-platform-useast5.us.tiktokv.com,legit,4.18582,9,20,37,0,0.45,0.11313,9,6,4,3,22,8,0,0,0,8
6706,eylwwtczny.com,dga,3.37878,2,11,14,1,0.18182,0.24134,0,0,0,0,0,0,0,0,0,0
8565,zwdcqgn.org,dga,3.27761,1,9,11,1,0.11111,0.29796,0,0,0,0,0,0,0,0,0,0
6677,meiqipxaba.ddns.net,dga,3.61635,6,11,19,1,0.54545,0.19033,2,1,0,0,3,4,4,3,2,13
7156,wanananapgaubtjtc.net,dga,3.2321,7,13,21,1,0.53846,0.15391,1,0,0,0,1,1,1,0,0,2
5303,nmclffoeckadoaca.de,dga,3.32636,7,11,19,1,0.63636,0.17507,1,0,0,0,1,3,0,0,0,3
5831,garedda.com,dga,3.0958,4,6,11,1,0.66667,0.28144,2,0,0,0,2,4,0,0,0,4
2463,a2047.w185.akamai.net,legit,3.78494,6,5,21,0,1.2,0.18024,3,3,4,3,13,2,0,0,0,2
5948,lnficcoovi.com,dga,2.98523,5,8,14,1,0.625,0.21323,3,1,0,0,4,2,0,0,0,2
3177,f.vimeocdn.com,legit,3.23593,4,8,14,0,0.5,0.23114,2,1,0,0,3,1,0,0,0,1
5125,cquwwovktd.com,dga,3.37878,3,10,14,1,0.3,0.24134,0,0,0,0,0,0,0,0,0,0
2929,eastus1-mediap.svc.ms,legit,3.63041,6,11,21,0,0.54545,0.17288,6,1,0,0,7,4,0,0,0,4
2300,stx-match.dotomi.com,legit,3.40869,5,12,20,0,0.41667,0.17043,5,0,0,0,5,6,0,0,0,6
600,static.adsafeprotected.com,legit,3.53641,9,15,26,0,0.6,0.13602,12,1,0,0,13,8,2,0,0,10
7275,rckuxcgoqgsbsr.com,dga,3.46132,3,14,18,1,0.21429,0.1923,0,0,0,0,0,0,0,0,0,0
7816,planestretchreplywerecash.com,dga,3.71593,8,20,29,1,0.4,0.12814,5,0,0,0,5,11,2,0,0,13
7195,xfhuzwcdoy.com,dga,3.52164,3,10,14,1,0.3,0.25155,1,0,0,0,1,0,0,0,0,0
1733,my.salesforce.com,legit,3.38158,5,10,17,0,0.5,0.19892,3,0,0,0,3,4,0,0,0,4
8870,lfofkjedenvw.biz,dga,3.75,4,11,16,1,0.36364,0.23438,3,0,0,0,3,3,0,0,0,3
2716,hbrcv.adobe.com,legit,3.37356,4,9,15,0,0.44444,0.2249,2,0,0,0,2,1,0,0,0,1
247,jnn-pa.googleapis.com,legit,3.6897,7,11,21,0,0.63636,0.1757,5,6,4,4,19,3,0,0,0,3
5343,abpkagexehslrcq.com,dga,3.93214,5,13,19,1,0.38462,0.20695,1,1,0,0,2,1,0,0,0,1
6100,pujodug.info,dga,3.25163,5,6,12,1,0.83333,0.27097,0,0,0,0,0,0,0,0,0,0
8942,kirsicma.ru,dga,3.0958,4,6,11,1,0.66667,0.28144,2,0,0,0,2,3,0,0,0,3
4792,weather-analytics-events.apple.com,legit,3.95909,11,19,34,0,0.57895,0.11644,13,5,3,2,23,9,2,1,1,13
793,dsca.akamaiedge.net,legit,3.36609,8,9,19,0,0.88889,0.17716,6,5,5,3,19,5,0,0,0,5
6589,bfobcbblkdfnbkak.org,dga,3.3037,3,16,20,1,0.1875,0.16518,0,0,0,0,0,0,0,0,0,0
2730,onedscolprdwus05.westus.cloudapp.azure.com,legit,3.98709,13,23,42,0,0.56522,0.09493,17,4,3,4,28,7,2,0,0,9
9093,eowvuuqs.mn,dga,3.27761,4,6,11,1,0.66667,0.29796,0,0,0,0,0,0,0,0,0,0
9096,yaaiyacsqyumkuqk.org,dga,3.54644,7,12,20,1,0.58333,0.17732,0,0,0,0,0,1,0,0,0,1
7359,inncihhmjcdu.biz,dga,3.32782,4,11,16,1,0.36364,0.20799,2,0,0,0,2,1,0,0,0,1
6129,villapoz.ru,dga,3.27761,4,6,11,1,0.66667,0.29796,1,0,0,0,1,1,0,0,0,1
7225,axhvxcfnsehfutlw.eu,dga,3.72161,5,13,19,1,0.38462,0.19587,1,0,0,0,1,2,1,0,0,3
2857,array512.prod.do.dsp.mp.microsoft.com,legit,3.71259,8,20,37,0,0.4,0.10034,12,12,10,9,43,5,2,0,0,7
299,star.c10r.facebook.com,legit,3.62922,6,11,22,0,0.54545,0.16496,5,0,0,0,5,5,0,0,0,5
7106,e07l3l7t7x58kfc.ddns.net,dga,3.88684,2,13,24,1,0.15385,0.16195,2,1,0,0,3,4,3,2,2,11
395,cdn.ampproject.org,legit,3.61437,4,12,18,0,0.33333,0.2008,7,3,1,0,11,3,1,0,0,4
2064,plus.l.google.com,legit,3.13072,5,9,17,0,0.55556,0.18416,5,5,4,3,17,1,0,0,0,1
7403,sheffield-found.tel,dga,3.53689,6,11,19,1,0.54545,0.18615,1,1,0,0,2,2,0,0,0,2
9014,vaawloekakocemf.ddns.net,dga,3.77206,8,14,24,1,0.57143,0.15717,4,1,0,0,5,6,3,2,1,12
5608,statusreasonsockdealwarm.com,dga,3.70897,10,17,28,1,0.58824,0.13246,7,0,0,0,7,10,0,0,0,10
8630,oqoneikkpkcknubp.eu,dga,3.30056,7,11,19,1,0.63636,0.17371,1,0,0,0,1,2,1,0,0,3
1734,yellowblue.io,legit,3.02699,6,6,13,0,1.0,0.23285,1,0,0,0,1,1,0,0,0,1
4600,fontawesome.com.cdn.cloudflare.net,legit,3.74894,11,19,34,0,0.57895,0.11026,12,8,6,4,30,9,2,1,0,12
4185,c1-word-view-15.cdn.office.net,legit,3.80624,7,14,30,0,0.5,0.12687,6,6,5,3,20,4,0,0,0,4
4651,track.adformnet.akadns.net,legit,3.53641,7,16,26,0,0.4375,0.13602,4,3,4,3,14,7,2,0,0,9
5377,etufjyyetlib.com,dga,3.625,5,10,16,1,0.5,0.22656,1,0,0,0,1,1,0,0,0,1
9735,chairrepairarestorelandprogram.com,dga,3.65302,13,20,34,1,0.65,0.10744,7,1,0,0,8,11,5,0,2,18
4296,chrome.google.com,legit,3.02864,6,9,17,0,0.66667,0.17816,4,5,4,3,16,2,0,0,0,2
3369,hsforms.com,legit,2.91398,2,8,11,0,0.25,0.26491,0,0,0,0,0,1,0,0,0,1
2181,a239.gi3.akamai.net,legit,3.36609,7,5,19,0,1.4,0.17716,3,3,4,3,13,2,0,0,0,2
9127,epxylvumlrfe.ru,dga,3.37356,4,10,15,1,0.4,0.2249,0,0,0,0,0,0,0,0,0,0
4166,privacy-mgmt.com,legit,3.57782,3,11,16,0,0.27273,0.22361,1,0,0,0,1,2,0,0,0,2
738,bidder.criteo.com,legit,3.26393,6,9,17,0,0.66667,0.192,4,0,0,0,4,6,0,0,0,6
5540,invfuwxragrj.biz,dga,3.75,4,11,16,1,0.36364,0.23438,2,0,0,0,2,2,0,0,0,2
5492,fsaawmjwywujakfw.eu,dga,3.26083,6,12,19,1,0.5,0.17162,0,0,0,0,0,0,0,0,0,0
4811,nflxext.com,legit,3.27761,2,8,11,0,0.25,0.29796,0,0,0,0,0,0,0,0,0,0
7499,chzbdtmh.com.bo,dga,3.10689,2,11,15,1,0.18182,0.20713,2,2,1,0,5,2,2,1,0,5
5321,egnaresdefi.com,dga,3.5899,6,8,15,1,0.75,0.23933,2,0,0,0,2,4,1,0,0,5
3605,us-api.mimecast.com,legit,3.47135,7,9,19,0,0.77778,0.1827,6,3,1,0,10,5,0,0,0,5
5120,granvillechamberlain.net,dga,3.62581,8,15,24,1,0.53333,0.15108,5,0,0,0,5,9,1,0,0,10
1930,ghent-gce-sc.bidswitch.net,legit,3.61334,5,17,26,0,0.29412,0.13897,4,1,0,0,5,3,1,0,0,4
8866,peaqwivtxgpjgmaehipdlbjrpbeu.net,dga,4.125,9,22,32,1,0.40909,0.12891,2,0,0,0,2,3,0,0,0,3
2322,www.tm.ak.prd.aadg.akadns.net,legit,3.38801,6,17,29,0,0.35294,0.11683,6,4,4,3,17,2,1,0,0,3
4504,sharepointonline.com.akadns.net,legit,3.77261,11,17,31,0,0.64706,0.1217,11,6,7,8,32,9,4,1,0,14
3973,public.wlhrm-a-3.prod.infra.webex.com,legit,4.17257,9,20,37,0,0.45,0.11277,7,4,3,2,16,4,2,0,0,6
57,config.teams.microsoft.com,legit,3.53641,8,15,26,0,0.53333,0.13602,13,9,7,6,35,7,1,0,0,8
5214,wunjtplvxqqeppsf.eu,dga,3.68188,4,14,19,1,0.28571,0.19378,2,0,0,0,2,0,0,0,0,0
6315,frujhlizlk.com,dga,3.6645,3,10,14,1,0.3,0.26175,1,0,0,0,1,0,0,0,0,0
3865,ipcdn-lb.apple.com.akadns.net,legit,3.81437,7,17,29,0,0.41176,0.13153,11,11,10,10,42,5,3,1,0,9
7569,uuksyqeoya.net,dga,3.37878,6,7,14,1,0.85714,0.24134,0,0,0,0,0,0,0,1,0,1
6546,dnqovkhmau.com,dga,3.52164,4,9,14,1,0.44444,0.25155,2,0,0,0,2,2,0,0,0,2
8426,yloyeoptayptvvtgi.bit,dga,3.40399,6,14,21,1,0.42857,0.16209,2,0,0,0,2,1,0,0,0,1
8641,ssecuruspapa.com,dga,3.20282,6,9,16,1,0.66667,0.20018,3,0,0,0,3,2,0,0,0,2
6035,mbcaldflbdmckffa.org,dga,3.48418,3,16,20,1,0.1875,0.17421,0,0,0,0,0,1,0,0,0,1
9587,azpmlrxgoe.com,dga,3.52164,4,9,14,1,0.44444,0.25155,0,0,0,0,0,0,0,0,0,0
2639,consent.trustarc.com,legit,3.34644,5,13,20,0,0.38462,0.16732,9,2,0,0,11,8,3,0,0,11
549,relay.teams.microsoft.com,legit,3.59327,8,14,25,0,0.57143,0.14373,12,8,7,6,33,8,0,0,0,8
7146,villageemptylistencancel.com,dga,3.70897,9,18,28,1,0.5,0.13246,6,1,0,0,7,11,2,1,0,14
6623,rescue-davis.cm,dga,3.50689,5,8,15,1,0.625,0.23379,2,0,0,0,2,3,1,0,0,4
6091,otilginua.ddns.net,dga,3.46132,6,10,18,1,0.6,0.1923,4,1,0,0,5,6,4,3,2,15
8157,jifpldgjrwvu.com,dga,3.875,3,12,16,1,0.25,0.24219,1,0,0,0,1,0,0,0,0,0
6423,fcwjcfpmigqtwqyo.eu,dga,3.82687,4,14,19,1,0.28571,0.20141,1,0,0,0,1,1,0,0,0,1
3475,nextdoor.com,legit,3.18872,4,7,12,0,0.57143,0.26573,1,0,0,0,1,2,0,0,0,2
677,m.google.com,legit,2.68872,4,6,12,0,0.66667,0.22406,2,5,4,3,14,1,0,0,0,1
5138,gqkkesyigguweass.org,dga,3.48418,6,13,20,1,0.46154,0.17421,2,0,0,0,2,3,1,0,0,4
7297,pujadug.info,dga,3.4183,5,6,12,1,0.83333,0.28486,1,0,0,0,1,0,0,0,0,0
4439,trackjs.com,legit,3.27761,2,8,11,0,0.25,0.29796,1,0,0,0,1,2,1,0,0,3
3106,prd.ags.trafficmanager.net,legit,3.64237,7,16,26,0,0.4375,0.14009,10,3,1,3,17,6,1,0,0,7
5521,uusmleltxiook.biz,dga,3.61687,7,9,17,1,0.77778,0.21276,3,0,0,0,3,2,0,0,0,2
9021,remaining-paths.kz,dga,3.83659,5,11,18,1,0.45455,0.21314,4,0,0,0,4,6,1,0,0,7
2787,ibyteimg.com,legit,3.25163,4,7,12,0,0.57143,0.27097,1,0,0,0,1,1,0,0,0,1
5325,n1baj4dd3e3gc4ul8v.ru,dga,4.01137,4,10,21,1,0.4,0.19102,0,0,0,0,0,1,0,0,0,1
3057,cdn.amplitude.com,legit,3.61687,5,10,17,0,0.5,0.21276,6,2,1,0,9,4,0,0,0,4
942,templates.cdn.office.net,legit,3.60539,7,14,24,0,0.5,0.15022,11,6,5,3,25,8,1,0,0,9
1542,iqzone.com,legit,3.12193,4,5,10,0,0.8,0.31219,1,0,0,0,1,2,1,0,0,3
1465,autologon.microsoftazuread-sso.com,legit,3.87684,14,17,34,0,0.82353,0.11402,12,8,7,7,34,6,0,0,0,6
9215,gmuseausukwkscqc.org,dga,3.54644,6,13,20,1,0.46154,0.17732,3,0,0,0,3,3,0,0,0,3
6647,aismqsuiwcymao.biz,dga,3.57243,7,10,18,1,0.7,0.19847,1,0,0,0,1,3,0,5,4,12
564,ocsp2.g.aaplimg.com,legit,3.36609,5,10,19,0,0.5,0.17716,4,0,0,0,4,0,0,0,0,0
1010,slack.com,legit,2.9477,2,6,9,0,0.33333,0.32752,0,0,0,0,0,2,0,0,0,2
4042,ha.1drv.com,legit,3.27761,2,6,11,0,0.33333,0.29796,0,0,0,0,0,0,0,0,0,0
968,mfadsrvr.com,legit,3.25163,2,9,12,0,0.22222,0.27097,2,0,0,0,2,0,0,0,0,0
4930,realestate.com.au,legit,3.29277,8,7,17,0,1.14286,0.19369,11,2,1,1,15,10,4,1,0,15
8356,wvc6at7pcxcxctu.ddns.net,dga,3.72018,3,17,24,1,0.17647,0.15501,3,1,0,0,4,5,3,3,2,13
5388,jihkfowhhgczudsks.net,dga,3.97542,4,16,21,1,0.25,0.18931,1,0,0,0,1,0,0,0,0,0
9718,knowslept.net,dga,3.2389,3,9,13,1,0.33333,0.24915,1,0,0,0,1,1,0,0,0,1
2279,default.na.gateway.devices.a2z.com,legit,3.99278,12,16,34,0,0.75,0.11743,8,1,0,0,9,7,1,0,0,8
6348,aagcdmivsnvrpormb.in,dga,3.72193,5,14,20,1,0.35714,0.1861,2,0,0,0,2,2,0,0,0,2
3945,webrootcloudav.com,legit,3.61437,7,10,18,0,0.7,0.2008,4,3,2,1,10,0,0,0,0,0
3872,idx.liadm.com,legit,3.08506,4,7,13,0,0.57143,0.23731,2,0,0,0,2,0,0,0,0,0
6576,spraykilladdresspreferharm.com,dga,3.77775,8,21,30,1,0.38095,0.12593,6,0,0,0,6,7,2,0,0,9
6199,dishtowergrasssavematemarch.com,dga,3.71985,10,20,31,1,0.5,0.12,5,0,0,0,5,10,2,0,0,12
3971,adobesearch.adobe.io,legit,3.30869,10,8,20,0,1.25,0.16543,5,0,0,0,5,5,0,0,0,5
8858,spyware-covered.pl,dga,3.68354,5,11,18,1,0.45455,0.20464,4,0,0,0,4,6,3,0,0,9
9235,unitsacni.com,dga,3.2389,5,7,13,1,0.71429,0.24915,0,0,0,0,0,3,0,0,0,3
5223,qbhawadsholapet.com,dga,3.78714,6,12,19,1,0.5,0.19932,3,0,0,0,3,2,0,5,5,12
955,pull-f5-gcp01.tiktokcdn.com,legit,4.06026,4,16,27,0,0.25,0.15038,4,6,9,9,28,2,0,0,0,2
5338,ygxzdvcnpxn.yi.org,dga,3.61437,2,14,18,1,0.14286,0.2008,0,0,0,0,0,0,0,0,0,0
3824,resources.digital-cloud-west.medallia.com,legit,3.9116,15,21,41,0,0.71429,0.0954,12,3,2,1,18,8,3,0,0,11
2866,us.creativecdn.com,legit,3.68354,6,10,18,0,0.6,0.20464,10,1,0,0,11,7,1,0,0,8
5862,bholuvghqjyvlgjk.com,dga,3.72193,3,16,20,1,0.1875,0.1861,0,0,0,0,0,0,0,0,0,0
2983,yandex.net,legit,2.92193,3,6,10,0,0.5,0.29219,0,0,0,0,0,3,1,0,0,4
6468,oapikwdyqgajbmmy.com,dga,3.78418,5,14,20,1,0.35714,0.18921,2,1,0,0,3,0,0,0,0,0
3394,content.fe.apple-dns.net,legit,3.43872,6,14,24,0,0.42857,0.14328,12,7,3,2,24,7,3,0,0,10
7548,akyuqkuiwcymao.biz,dga,3.61437,7,10,18,1,0.7,0.2008,1,0,0,0,1,1,0,5,4,10
6809,cda8w03hehwxadw.ddns.net,dga,3.63684,4,15,24,1,0.26667,0.15154,4,1,0,0,5,4,3,3,2,12
4479,report2.hb.brainlyads.com,legit,4.02347,6,15,25,0,0.4,0.16094,5,0,0,0,5,4,0,0,0,4
587,mask.apple-dns.net,legit,3.50326,4,11,18,0,0.36364,0.19463,7,5,3,2,17,5,1,0,0,6
4722,ably.io,legit,2.80735,3,3,7,0,1.0,0.40105,0,0,0,0,0,0,0,0,0,0
8201,bgmtjldsebhhvtxs.eu,dga,3.72161,3,15,19,1,0.2,0.19587,2,0,0,0,2,1,0,0,0,1
3171,eu-v10c.events.data.microsoft.com,legit,3.9832,10,16,33,0,0.625,0.1207,12,9,7,6,34,7,1,0,0,8
6570,sefegnacad.com,dga,3.37878,5,8,14,1,0.625,0.24134,2,0,0,0,2,3,0,0,0,3
2273,a-ring.msedge.net,legit,3.45482,5,9,17,0,0.55556,0.20322,5,2,1,0,8,5,2,0,0,7
1039,pull-flv-l16-sg01.tiktokcdn.com,legit,4.15565,4,18,31,0,0.22222,0.13405,4,6,9,9,28,2,0,0,0,2
4915,rpc.tapjoy.com,legit,3.23593,3,9,14,0,0.33333,0.23114,3,0,0,0,3,1,0,0,0,1
4568,push-rtmp-l16-va01.tiktokcdn.com,legit,4.26532,5,18,32,0,0.27778,0.13329,5,6,7,8,26,2,0,0,0,2
2751,tr.outbrain.com,legit,3.37356,5,8,15,0,0.625,0.2249,3,0,0,0,3,2,0,0,0,2
4898,pmp.mxptint.net,legit,2.87291,2,11,15,0,0.18182,0.19153,5,0,0,0,5,2,0,0,0,2
1933,updates.cdn-apple.com,legit,3.6897,6,12,21,0,0.5,0.1757,11,4,2,1,18,5,1,0,0,6
149,sb.scorecardresearch.com,legit,3.27206,7,15,24,0,0.46667,0.13634,5,0,0,0,5,9,1,0,0,10
4721,auth.adobe.com,legit,3.37878,6,6,14,0,1.0,0.24134,2,0,0,0,2,1,0,0,0,1
1941,tr.teams.microsoft.com,legit,3.32218,6,13,22,0,0.46154,0.15101,11,8,7,6,32,5,0,0,0,5
2265,mm2.akamai.net,legit,2.98523,5,6,14,0,0.83333,0.21323,3,3,4,3,13,2,0,0,0,2
1809,pull-f5-sg01.tiktokcdn.com.c.bytefcdn-oversea.com,legit,4.40075,10,28,49,0,0.35714,0.08981,10,10,12,10,42,9,5,1,0,15
1739,darnuid.imrworldwide.com,legit,3.52206,8,14,24,0,0.57143,0.14675,1,0,0,0,1,3,0,0,0,3
4274,prod.appnexus.map.fastly.net,legit,3.78039,7,17,28,0,0.41176,0.13501,12,6,3,1,22,4,1,0,0,5
2162,pull-a5-gcp01.tiktokcdn.com.c.bytefcdn-oversea.com,legit,4.37617,11,28,50,0,0.39286,0.08752,10,10,12,10,42,9,5,1,0,15
9120,ckeacfdklenndlld.de,dga,3.01057,4,14,19,1,0.28571,0.15845,3,0,0,0,3,5,0,0,0,5
7849,vpxdhbbxevm.su,dga,3.37878,2,11,14,1,0.18182,0.24134,0,0,0,0,0,0,0,0,0,0
2894,itunes.g.aaplimg.com,legit,3.68418,7,10,20,0,0.7,0.18421,6,0,0,0,6,3,0,0,0,3
5802,rylegel.info,dga,3.25163,4,7,12,1,0.57143,0.27097,2,0,0,0,2,3,0,0,0,3
6531,qga86cqsuke4.net,dga,3.75,4,8,16,1,0.5,0.23438,0,0,0,0,0,1,0,0,0,1
4476,tags.bkrtx.com,legit,3.52164,2,10,14,0,0.2,0.25155,2,0,0,0,2,1,0,0,0,1
1101,spo.nel.measure.office.net,legit,3.63853,10,12,26,0,0.83333,0.13994,7,4,4,3,18,8,0,0,0,8
3181,api.accuweather.com,legit,3.53689,8,9,19,0,0.88889,0.18615,6,1,1,0,8,4,1,1,1,7
9876,qvw0e0m0gp1vghors87.ddns.net,dga,4.13754,3,17,28,1,0.17647,0.14777,2,1,0,0,3,5,3,3,2,13
4615,steampowered.com,legit,3.45282,6,9,16,0,0.66667,0.2158,7,0,0,0,7,7,1,0,0,8
73,config.edge.skype.com,legit,3.65376,6,12,21,0,0.5,0.17399,5,3,1,0,9,4,1,0,0,5
2051,stocks-edge.apple.com,legit,3.6897,6,12,21,0,0.5,0.1757,9,6,4,2,21,4,0,0,0,4
2340,assets.a-mo.net,legit,3.05656,5,7,15,0,0.71429,0.20377,3,0,0,0,3,3,1,0,0,4
7237,sistershelterguideseekresort.com,dga,3.4995,12,19,32,1,0.63158,0.10936,6,0,0,0,6,11,4,0,0,15
8950,vovpfijeg.com,dga,3.39275,4,8,13,1,0.5,0.26098,0,0,0,0,0,0,0,0,0,0
2915,rtd-tm.everesttech.net,legit,3.22219,5,14,22,0,0.35714,0.14646,5,0,0,0,5,7,4,0,0,11
7162,wqmjqwzowihskvt.com,dga,3.68188,3,15,19,1,0.2,0.19378,0,0,0,0,0,0,0,0,0,0
7037,professiontakeflowscalemiss.com,dga,3.78115,11,19,31,1,0.57895,0.12197,10,1,0,0,11,9,3,0,0,12
6941,mjsejmvlpqcxtvup.eu,dga,3.61635,4,14,19,1,0.28571,0.19033,1,0,0,0,1,1,0,0,0,1
1931,partner.mediawallahscript.com,legit,3.86643,9,18,29,0,0.5,0.13333,4,0,0,0,4,6,0,0,0,6
5380,grbyanygmz.com,dga,3.37878,2,11,14,1,0.18182,0.24134,0,0,0,0,0,1,0,0,0,1
9615,8gwsjwbk67miscxbt5.com,dga,4.00489,2,15,22,1,0.13333,0.18204,1,0,0,0,1,2,0,0,0,2
660,cloudflare.net,legit,3.52164,5,8,14,0,0.625,0.25155,3,3,2,1,9,3,0,0,0,3
5817,vkzxldaknhkffuibmruphikreusg.net,dga,4.22641,8,23,32,1,0.34783,0.13208,2,0,0,0,2,1,0,0,0,1
5724,flierproblem.net,dga,3.45282,5,10,16,1,0.5,0.2158,5,1,0,0,6,3,1,0,0,4
6501,fgopcffrghhq.com,dga,3.20282,2,13,16,1,0.15385,0.20018,0,0,0,0,0,0,0,0,0,0
6804,bjfmit.sh,dga,3.16993,1,7,9,1,0.14286,0.35221,1,0,0,0,1,2,0,0,0,2
6205,suppliers-gale.lk,dga,3.45482,5,10,17,1,0.5,0.20322,5,1,0,0,6,3,1,0,0,4
9686,mvgjmpkparc0et5xsdwturs.ddns.net,dga,4.17923,4,24,32,1,0.16667,0.1306,3,1,0,0,4,6,4,3,2,15
548,insight.adsrvr.org,legit,3.46132,4,12,18,0,0.33333,0.1923,4,0,0,0,4,3,0,0,0,3
517,liadm.com,legit,2.9477,3,5,9,0,0.6,0.32752,2,0,0,0,2,0,0,0,0,0
6332,hilgeaki.ru,dga,3.27761,5,5,11,1,1.0,0.29796,2,0,0,0,2,2,0,0,0,2
2045,adlightning.com,legit,3.50689,4,10,15,0,0.4,0.23379,3,0,0,0,3,2,1,0,0,3
3907,calendarsync-pa.googleapis.com,legit,3.85656,10,17,30,0,0.58824,0.12855,6,6,4,4,20,7,0,0,0,7
5816,uca86wigqoa4.org,dga,3.625,6,6,16,1,1.0,0.22656,0,0,0,0,0,1,0,0,0,1
8110,aaabcnddbdcbmnme.net,dga,3.07095,5,14,20,1,0.35714,0.15355,0,0,0,0,0,2,0,0,0,2
1189,samsung.com,legit,3.0958,3,7,11,0,0.42857,0.28144,1,0,0,0,1,2,0,0,0,2
8407,cldckaabnnofdkdb.co.uk,dga,3.35649,5,15,22,1,0.33333,0.15257,3,1,0,0,4,1,1,0,0,2
1714,gts.ttoverseaus.net,legit,3.2211,6,11,19,0,0.54545,0.16953,6,0,0,0,6,4,3,0,0,7
7514,oluperoqecwaa.ddns.net,dga,3.78875,8,12,22,1,0.66667,0.17222,4,1,0,0,5,6,4,3,2,15
1510,ag.innovid.com,legit,3.23593,5,7,14,0,0.71429,0.23114,1,0,0,0,1,1,0,0,0,1
2845,shredder-us.osi.office.net,legit,3.64237,9,13,26,0,0.69231,0.14009,8,4,4,3,19,8,0,0,0,8
2027,api.amazonalexa.com,legit,3.3211,9,8,19,0,1.125,0.17479,7,2,4,3,16,4,0,0,0,4
6832,wrongoctover.net,dga,3.20282,5,10,16,1,0.5,0.20018,3,0,0,0,3,3,2,0,0,5
7029,cemiesuwcumkywqa.org,dga,3.82193,7,12,20,1,0.58333,0.1911,3,0,0,0,3,5,0,0,0,5
1467,m.adnxs.com,legit,3.0958,2,7,11,0,0.28571,0.28144,3,0,0,0,3,1,0,0,0,1
4113,gsp57-ssl-revgeo.ls.apple.com,legit,3.71938,6,16,29,0,0.375,0.12825,8,4,3,2,17,3,0,0,0,3
3518,board-a.wbx2.com,legit,3.5,4,8,16,0,0.5,0.21875,0,0,0,0,0,1,0,0,0,1
7027,ihteniegs.ddns.net,dga,3.08605,5,11,18,1,0.45455,0.17145,5,1,0,0,6,7,3,3,2,15
3329,cs-server-s2s.yellowblue.io,legit,3.68989,8,14,27,0,0.57143,0.13666,4,1,1,0,6,4,3,1,0,8
3191,cd.connatix.com,legit,3.1899,4,9,15,0,0.44444,0.21266,7,2,0,0,9,4,3,0,0,7
1205,drive-thirdparty.googleusercontent.com,legit,4.09003,12,23,38,0,0.52174,0.10763,10,8,4,3,25,10,3,0,0,13
7047,dwkgjfvscvshrqjy.eu,dga,3.93214,2,16,19,1,0.125,0.20695,0,0,0,0,0,0,0,0,0,0
8944,vegas-meta.com,dga,3.37878,5,7,14,1,0.71429,0.24134,1,0,0,0,1,4,0,0,0,4
402,criteo.net,legit,2.92193,4,5,10,0,0.8,0.29219,2,0,0,0,2,3,0,0,0,3
3245,s-usweb.dotomi.com,legit,3.57243,6,9,18,0,0.66667,0.19847,3,0,0,0,3,3,0,0,0,3
1088,client-api.itunes.apple.com,legit,3.68009,10,13,27,0,0.76923,0.1363,11,6,4,2,23,5,1,0,0,6
4366,brainlyads.com,legit,3.6645,4,9,14,0,0.44444,0.26175,4,0,0,0,4,2,0,0,0,2
8639,jwpmulnfymrfl.biz,dga,3.73452,2,14,17,1,0.14286,0.21968,0,0,0,0,0,0,0,0,0,0
1457,usermatch.krxd.net,legit,3.72548,4,12,18,0,0.33333,0.20697,5,1,0,0,6,4,1,0,0,5
6110,nbxtdnnslenvfoeb.eu,dga,3.47135,5,13,19,1,0.38462,0.1827,3,0,0,0,3,4,0,0,0,4
4410,condenast.map.fastly.net,legit,3.62581,6,15,24,0,0.4,0.15108,8,2,0,0,10,8,1,0,0,9
6596,sbvreb.mooo.com,dga,2.97356,5,8,15,1,0.625,0.19824,3,0,0,0,3,1,1,2,1,5
850,valid.apple.com,legit,3.37356,5,8,15,0,0.625,0.2249,7,4,3,2,16,1,0,0,0,1
5055,vsldpayqbtixlclfp.com,dga,3.97542,3,17,21,1,0.17647,0.18931,1,0,0,0,1,1,0,0,0,1
222,umbrella.com,legit,3.25163,4,7,12,0,0.57143,0.27097,1,0,0,0,1,3,0,0,0,3
3457,speechs3proto2-pa.googleapis.com,legit,3.84002,11,16,32,0,0.6875,0.12,7,7,4,4,22,4,1,0,0,5
4393,alt7-mtalk.google.com,legit,3.46328,6,11,21,0,0.54545,0.16492,3,5,4,3,15,2,0,0,0,2
3464,load77.exelator.com,legit,3.47135,7,8,19,0,0.875,0.1827,3,0,0,0,3,4,0,0,0,4
2815,mwbsys.com,legit,2.92193,1,8,10,0,0.125,0.29219,0,0,0,0,0,0,0,0,0,0
4982,ieonline.microsoft.com,legit,3.42512,9,11,22,0,0.81818,0.15569,10,8,7,6,31,5,1,0,0,6
1261,usersub-a.wbx2.com,legit,3.72548,5,9,18,0,0.55556,0.20697,3,1,0,0,4,3,2,0,0,5
8027,sicveata.ru,dga,3.27761,5,5,11,1,1.0,0.29796,4,0,0,0,4,6,0,0,0,6
3922,dotomi.weighted.com.akadns.net,legit,3.73957,10,16,30,0,0.625,0.12465,9,6,7,7,29,7,3,1,0,11
8621,txknhmmerp.com,dga,3.46772,2,11,14,1,0.18182,0.24769,1,0,0,0,1,1,0,0,0,1
2625,ads.us.criteo.com,legit,3.45482,6,8,17,0,0.75,0.20322,7,0,0,0,7,3,0,0,0,3
8219,upsgkrhgobfsrila.eu,dga,3.82687,6,12,19,1,0.5,0.20141,0,0,0,0,0,2,0,0,0,2
4799,relay-iad.sentry.insops.net,legit,3.68009,8,15,27,0,0.53333,0.1363,7,1,0,0,8,7,1,0,0,8
363,nrdp52-appboot.netflix.com,legit,4.10391,6,15,26,0,0.4,0.15784,4,1,0,0,5,2,0,0,0,2
7958,rkucpnkfargwclfafulfpnrlf.biz,dga,3.71593,5,23,29,1,0.21739,0.12814,0,0,0,0,0,1,0,0,0,1
9984,myntwujsyn.com,dga,3.37878,2,11,14,1,0.18182,0.24134,1,0,0,0,1,0,0,0,0,0
1193,europe.cp.wd.microsoft.com,legit,3.59448,8,14,26,0,0.57143,0.13825,10,8,7,6,31,2,0,0,0,2
2414,epc.mnc260.mcc310.pub.3gppnetwork.org,legit,4.03081,5,20,37,0,0.25,0.10894,2,0,0,0,2,3,0,0,0,3
6124,odletuwga.com,dga,3.54659,5,7,13,1,0.71429,0.27281,1,0,0,0,1,2,0,0,0,2
6912,mvkkrefawfkuj.com,dga,3.57247,4,12,17,1,0.33333,0.21015,1,0,0,0,1,1,0,0,0,1
4804,dcs-edge-usw2-620097651.us-west-2.elb.amazonaws.com,legit,4.34921,11,20,51,0,0.55,0.08528,9,3,4,3,19,8,1,0,0,9
7757,kimberleighatterberry.net,dga,3.50928,8,16,25,1,0.5,0.14037,4,0,0,0,4,5,1,0,0,6
9234,edyxi03j7ry4k27.ddns.net,dga,3.97018,3,13,24,1,0.23077,0.16542,3,1,0,0,4,5,3,3,2,13
8609,zhapletf.com,dga,3.58496,3,8,12,1,0.375,0.29875,3,1,0,0,4,2,0,0,0,2
9218,kyoqc59hsjrgrd40p22m29jzbqo51bwo51kxn50.biz,dga,4.53639,4,24,43,1,0.16667,0.1055,0,0,0,0,0,0,0,0,0,0
6347,64ycygi8uwa0.net,dga,3.875,4,7,16,1,0.57143,0.24219,0,0,0,0,0,0,0,0,0,0
1217,api.mixpanel.com,legit,3.375,6,8,16,0,0.75,0.21094,4,2,1,0,7,4,0,0,0,4
3117,spo-msedge.net,legit,3.32486,4,8,14,0,0.5,0.23749,3,2,1,0,6,3,0,0,0,3
1361,ieonlinews.microsoft.com,legit,3.55351,9,13,24,0,0.69231,0.14806,10,8,7,6,31,5,1,0,0,6
8384,jfuwxdionytnmvworaybawkqgi.org,dga,4.1899,8,21,30,1,0.38095,0.13966,2,0,0,0,2,3,1,0,0,4
4641,adobeid-na1.services.adobe.com,legit,3.73957,12,13,30,0,0.92308,0.12465,8,2,1,1,12,6,2,1,0,9
6849,takenguide.net,dga,3.18201,6,7,14,1,0.85714,0.22729,2,0,0,0,2,3,0,0,0,3
6942,cbjpxananjeeswivsy.com,dga,3.91398,6,15,22,1,0.4,0.17791,1,0,0,0,1,2,1,0,0,3
571,launches.appsflyer.com,legit,3.82307,6,14,22,0,0.42857,0.17378,6,2,1,0,9,3,0,0,0,3
9362,digeanat.ru,dga,3.27761,5,5,11,1,1.0,0.29796,3,0,0,0,3,4,0,0,0,4
3652,fa000000051.resources.office.net,legit,3.58871,9,11,32,0,0.81818,0.11215,7,4,4,3,18,4,1,0,0,5
3355,dscj.akamaiedge.net,legit,3.53689,7,10,19,0,0.7,0.18615,6,5,5,3,19,4,0,0,0,4
6646,7k8yl35n8ijix1x6xy.com,dga,3.97057,3,11,22,1,0.27273,0.18048,0,0,0,0,0,0,0,0,0,0
5560,uszovk.net,dga,3.32193,3,6,10,1,0.5,0.33219,1,0,0,0,1,0,0,0,0,0
4822,lgincdnmsftuswe2.azureedge.net,legit,3.96141,9,18,30,0,0.5,0.13205,8,3,1,2,14,5,0,0,0,5
6467,dafegnicosd.com,dga,3.50689,5,9,15,1,0.55556,0.23379,2,0,0,0,2,3,0,0,0,3
5713,aosmeasdjrwu.com,dga,3.5,6,9,16,1,0.66667,0.21875,1,0,0,0,1,2,0,0,0,2
5634,projectdrygatherbodydisappointed.com,dga,3.97494,11,24,36,1,0.45833,0.11042,10,2,0,0,12,7,2,2,1,12
7107,ashseuc19d30dspukte41iqdwbzlzi15g43jx.ru,dga,4.59644,8,21,40,1,0.38095,0.11491,3,0,0,0,3,3,0,0,0,3
9307,mukosasi.ru,dga,3.0958,5,5,11,1,1.0,0.28144,0,0,0,0,0,2,0,0,0,2
894,gumgum.com,legit,2.44644,3,6,10,0,0.5,0.24464,0,0,0,0,0,0,0,0,0,0
5043,6l6zw6bcpt6yjdlsix.ru,dga,3.91613,2,14,21,1,0.14286,0.18648,0,0,0,0,0,1,0,0,0,1
1172,adentifi.com,legit,3.4183,5,6,12,0,0.83333,0.28486,4,1,0,0,5,3,1,0,0,4
4918,chimpstatic.com,legit,3.1899,4,10,15,0,0.4,0.21266,5,0,0,0,5,5,1,0,0,6
5299,iv4re2oklh1wp7ukn7.ru,dga,4.01137,5,10,21,1,0.5,0.19102,1,0,0,0,1,1,0,0,0,1
5161,effkceokdneabeff.eu,dga,3.11058,8,10,19,1,0.8,0.16371,3,0,0,0,3,5,0,0,0,5
3348,d.impactradius-event.com,legit,3.9183,8,13,24,0,0.61538,0.16326,6,1,0,0,7,4,2,0,0,6
8049,wvmghanansnan.cc,dga,3.07782,3,12,16,1,0.25,0.19236,0,0,0,0,0,2,2,4,3,11
9640,bwntrywhlugvjqpv.eu,dga,3.93214,3,15,19,1,0.2,0.20695,1,0,0,0,1,0,0,0,0,0
8272,bokwanri.ru,dga,3.27761,4,6,11,1,0.66667,0.29796,0,0,0,0,0,2,0,0,0,2
9923,solaris-exceptions.sg,dga,3.72565,7,12,21,1,0.58333,0.17741,3,0,0,0,3,8,3,1,0,12
9100,ewsqkaiq.biz,dga,3.25163,4,7,12,1,0.57143,0.27097,0,0,0,0,0,0,0,0,0,0
1840,prod.roaming1.live.com.akadns.net,legit,3.95729,10,17,33,0,0.58824,0.11992,13,9,9,9,40,8,5,1,0,14
2771,cdn2.inner-active.mobi,legit,3.75444,7,11,22,0,0.63636,0.17066,5,1,0,0,6,7,0,0,0,7
9528,jetypcogxnwmb.co.uk,dga,3.93214,4,13,19,1,0.30769,0.20695,2,1,0,0,3,2,1,0,0,3
2636,tiles.virtualearth.net,legit,3.42512,8,12,22,0,0.66667,0.15569,5,0,0,0,5,5,0,0,0,5
5116,shjuovpp.com,dga,3.25163,3,8,12,1,0.375,0.27097,1,0,0,0,1,0,0,0,0,0
4077,ipv6.cws.conviva.com,legit,3.40869,5,11,20,0,0.45455,0.17043,4,2,0,0,6,2,2,0,0,4
245,analytics.yahoo.com,legit,3.43162,7,10,19,0,0.7,0.18061,4,0,0,1,5,3,0,0,0,3
705,xp.itunes-apple.com.akadns.net,legit,3.87291,9,16,30,0,0.5625,0.1291,12,9,9,9,39,8,3,1,0,12
4403,sync.bumlam.com,legit,3.32323,3,10,15,0,0.3,0.22155,1,0,0,0,1,2,0,0,0,2
570,smp-device-content.apple.com,legit,3.75343,8,16,28,0,0.5,0.13405,12,7,3,2,24,8,2,0,0,10
5001,cvyh1po636avyrsxebwbkn7.ddns.net,dga,4.35141,4,21,32,1,0.19048,0.13598,2,1,0,0,3,4,3,3,2,12
3557,b-0016.b-msedge.net,legit,3.57662,3,8,19,0,0.375,0.18824,3,2,1,0,6,3,0,0,0,3
9499,alpwyzdjbike.dynserv.com,dga,4.25163,5,17,24,1,0.29412,0.17715,4,1,1,0,6,4,6,5,4,19
3659,music.apple.com,legit,3.37356,5,8,15,0,0.625,0.2249,7,4,3,2,16,3,0,0,0,3
8783,salwiaankjo.dynserv.com,dga,3.969,7,14,23,1,0.5,0.17257,3,1,1,0,5,5,6,5,4,20
7540,nerassotag.com,dga,3.37878,5,8,14,1,0.625,0.24134,3,0,0,0,3,5,1,0,0,6
9287,sikaceoksequuq.ddns.net,dga,3.58835,8,13,23,1,0.61538,0.15602,4,1,0,0,5,8,3,3,2,16
4170,liftoff-creatives.io,legit,3.54644,8,10,20,0,0.8,0.17732,8,1,0,0,9,6,1,0,0,7
9336,yhhmfiosgfi6ew27z4.com,dga,4.00489,5,12,22,1,0.41667,0.18204,0,0,0,0,0,0,0,0,0,0
1500,probe.icloud.com,legit,3.45282,6,8,16,0,0.75,0.2158,6,4,2,1,13,2,1,0,0,3
1059,pull-flv-f10-va01.tiktokcdn.com,legit,4.06678,5,17,31,0,0.29412,0.13119,4,6,9,9,28,2,0,0,0,2
7892,dueftlklqr.dyndns.org,dga,3.78494,3,16,21,1,0.1875,0.18024,2,1,0,0,3,4,3,4,3,14
9009,lshjfaehgdppkb.biz,dga,3.83659,3,14,18,1,0.21429,0.21314,1,0,0,0,1,0,0,0,0,0
7399,yomaalvov.fr,dga,3.08496,4,7,12,1,0.57143,0.25708,1,0,0,0,1,2,0,0,0,2
547,b1sync.zemanta.com,legit,3.61437,4,11,18,0,0.36364,0.2008,3,0,0,0,3,4,0,0,0,4
9489,omnibusclavisfreely.com,dga,3.91487,8,14,23,1,0.57143,0.17021,2,0,0,0,2,6,0,0,0,6
8342,rouhfoteupoxu.ddns.net,dga,3.57262,8,12,22,1,0.66667,0.16239,5,1,0,0,6,5,3,3,2,13
4878,mon.tiktokv.com,legit,3.05656,4,9,15,0,0.44444,0.20377,3,5,4,3,15,2,0,0,0,2
4841,oobesaas.adobe.com,legit,3.01688,9,7,18,0,1.28571,0.1676,5,0,0,0,5,3,0,0,0,3
3135,dscapi7.akamaiedge.net,legit,3.60694,9,10,22,0,0.9,0.16395,8,6,5,3,22,5,0,0,0,5
8402,gqeqcicoomsguysu.org,dga,3.44644,7,12,20,1,0.58333,0.17232,3,0,0,0,3,4,0,0,0,4
1196,s.go-mpulse.net,legit,3.50689,4,8,15,0,0.5,0.23379,2,1,0,0,3,1,0,0,0,1
2285,b-ring.msedge.net,legit,3.45482,4,10,17,0,0.4,0.20322,5,2,1,0,8,5,2,0,0,7
8311,zxfrqyfavp.com,dga,3.6645,2,11,14,1,0.18182,0.26175,0,0,0,0,0,0,0,0,0,0
9624,charitatispenit.com,dga,3.53689,7,11,19,1,0.63636,0.18615,4,0,0,0,4,9,3,1,0,13
4712,update.eset.com,legit,3.32323,6,7,15,0,0.85714,0.22155,5,0,0,0,5,5,1,0,0,6
796,csp.withgoogle.com,legit,3.57243,5,11,18,0,0.45455,0.19847,3,4,3,2,12,2,0,0,0,2
6176,endblackbodyinfluenceslice.com,dga,3.7899,10,19,30,1,0.52632,0.12633,6,1,0,0,7,8,1,1,0,10
397,ingest.sentry.io,legit,3.25,5,9,16,0,0.55556,0.20312,7,1,0,0,8,6,3,0,0,9
3864,sombrero.yahoo.net,legit,3.39215,7,9,18,0,0.77778,0.18845,4,0,0,1,5,3,0,0,0,3
2364,pus8-collabhubrtc.officeapps.live.com,legit,4.10082,11,21,37,0,0.52381,0.11083,10,5,4,3,22,6,0,0,0,6
7666,j66eynzesozbwfuf22hsa57g43n60fxcvetgv.com,dga,4.61939,7,23,41,1,0.30435,0.11267,1,0,0,0,1,3,0,0,0,3
1620,adotmob.com,legit,2.84535,4,6,11,0,0.66667,0.25867,1,0,0,0,1,0,0,0,0,0
1597,unityads.unity3d.com,legit,3.62193,6,11,20,0,0.54545,0.1811,3,0,0,0,3,2,0,0,0,2
2587,e13136.g.akamaiedge.net,legit,3.5014,8,7,23,0,1.14286,0.15223,5,5,5,3,18,4,0,0,0,4
3779,cdn.content.prod.cms.msn.com,legit,3.26738,4,19,28,0,0.21053,0.11669,13,9,4,2,28,5,4,0,0,9
6473,roknokso.ru,dga,2.66353,4,6,11,1,0.66667,0.24214,1,0,0,0,1,0,0,0,0,0
2570,ced-ns.sascdn.com,legit,3.17512,3,11,17,0,0.27273,0.18677,5,1,0,0,6,5,0,0,0,5
3105,prd.jwpltx.com,legit,3.52164,1,11,14,0,0.09091,0.25155,3,0,0,0,3,0,0,0,0,0
7357,dokaxasu.info,dga,3.39275,6,6,13,1,1.0,0.26098,0,0,0,0,0,2,0,0,0,2
8085,wicalsofigg.com,dga,3.37356,5,9,15,1,0.55556,0.2249,2,1,0,0,3,2,0,0,0,2
2833,prod.balrog.prod.cloudops.mozgcp.net,legit,3.76356,9,22,36,0,0.40909,0.10454,8,7,6,4,25,0,1,0,0,1
4532,watson.telemetry.microsoft.com,legit,3.69807,9,18,30,0,0.5,0.12327,11,8,7,6,32,9,0,0,0,9
9532,sjercx3x5jijunwpaba.ddns.net,dga,4.03915,6,18,28,1,0.33333,0.14426,3,1,0,0,4,5,4,3,2,14
6725,isfvedfckhrsdb5unf.net,dga,3.87966,4,16,22,1,0.25,0.17635,1,0,0,0,1,3,0,0,0,3
6456,woculsema.com,dga,3.2389,5,7,13,1,0.71429,0.24915,2,0,0,0,2,3,0,0,0,3
3337,dspw65.akamai.net,legit,3.69012,5,8,17,0,0.625,0.21707,4,3,4,3,14,2,0,0,0,2
4,events.data.microsoft.com,legit,3.67327,8,14,25,0,0.57143,0.14693,12,9,7,6,34,7,1,0,0,8
6196,kxhfewtqopulgrey.com,dga,4.12193,5,14,20,1,0.35714,0.2061,1,0,0,0,1,1,0,0,0,1
3405,clickserve.dartsearch.net,legit,3.62347,7,16,25,0,0.4375,0.14494,7,1,1,0,9,7,3,1,0,11
1440,ec.walkme.com,legit,3.08506,4,7,13,0,0.57143,0.23731,0,0,0,0,0,1,0,0,0,1
5956,dspoyrhfbxbb.info,dga,3.57247,3,13,17,1,0.23077,0.21015,1,0,0,0,1,0,0,0,0,0
4717,npr.org,legit,2.52164,1,5,7,0,0.2,0.36023,1,0,0,0,1,0,0,0,0,0
8465,domitemesset.com,dga,3.03064,6,9,16,1,0.66667,0.18942,4,0,0,0,4,8,1,0,0,9
8375,pxmaainspnohtgyk.eu,dga,3.93214,6,12,19,1,0.5,0.20695,2,0,0,0,2,3,0,0,0,3
9552,vopykam.com,dga,3.0958,3,7,11,1,0.42857,0.28144,1,0,0,0,1,1,0,0,0,1
6057,jeannettewilliamson.net,dga,3.36031,9,13,23,1,0.69231,0.1461,5,0,0,0,5,7,0,0,0,7
3466,qagpublic.qg3.apps.qualys.com,legit,3.74541,7,17,29,0,0.41176,0.12915,6,2,1,0,9,1,0,0,0,1
2291,usr.undertone.com,legit,3.38158,6,9,17,0,0.66667,0.19892,3,0,0,0,3,5,1,0,0,6
3917,csdm-a.wbx2.com,legit,3.50689,2,9,15,0,0.22222,0.23379,0,0,0,0,0,0,0,0,0,0
2346,win10-trt.msedge.net,legit,3.64644,4,11,20,0,0.36364,0.18232,5,2,1,0,8,4,0,0,0,4
3087,store.core.windows.net,legit,3.35649,7,12,22,0,0.58333,0.15257,6,1,0,0,7,6,1,0,0,7
1881,aus5.mozilla.org,legit,3.5,6,7,16,0,0.85714,0.21875,2,0,0,0,2,1,0,0,0,1
6632,ybhiodxwwmoymuv.com,dga,3.53689,5,13,19,1,0.38462,0.18615,0,0,0,0,0,0,0,0,0,0
9031,songtuesday.net,dga,3.37356,5,9,15,1,0.55556,0.2249,2,0,0,0,2,2,0,0,0,2
5921,mobemwbtehjqaeqiq.me,dga,3.34644,7,12,20,1,0.58333,0.16732,1,0,0,0,1,3,0,0,0,3
3562,fef.msua05.manage.microsoft.com,legit,3.78437,10,15,31,0,0.66667,0.12208,9,9,7,8,33,6,0,0,0,6
7759,shgrgksgxuvhilt.org,dga,3.51109,3,15,19,1,0.2,0.18479,0,0,0,0,0,0,0,0,0,0
2114,nflxvideo.net,legit,3.39275,4,8,13,0,0.5,0.26098,0,0,0,0,0,1,0,0,0,1
1099,pixel-us-east.rubiconproject.com,legit,4.05423,11,17,32,0,0.64706,0.12669,9,3,0,0,12,8,2,0,0,10
3636,q.quora.com,legit,2.91398,4,5,11,0,0.8,0.26491,1,0,0,0,1,2,0,0,0,2
4242,articles.smartasset.com,legit,3.32748,7,14,23,0,0.5,0.14467,8,0,0,0,8,10,1,0,0,11
3208,mediaplex.com,legit,3.39275,5,7,13,0,0.71429,0.26098,4,1,0,0,5,2,0,0,0,2
4920,adtdp.com,legit,2.9477,2,6,9,0,0.33333,0.32752,1,0,0,0,1,0,0,0,0,0
4324,mzstorekit.itunes.apple.com,legit,3.8562,9,15,27,0,0.6,0.14282,9,4,3,2,18,7,0,0,0,7
7141,ruhiweis.ru,dga,2.91398,5,5,11,1,1.0,0.26491,0,0,0,0,0,1,0,0,0,1
6459,cwpsnvcjos.com,dga,3.18201,2,11,14,1,0.18182,0.22729,0,0,0,0,0,0,0,0,0,0
1716,sslwidget.criteo.com,legit,3.62193,6,12,20,0,0.5,0.1811,4,1,0,0,5,5,0,0,0,5
2185,health.apple.com,legit,3.25,5,9,16,0,0.55556,0.20312,6,4,3,2,15,2,0,0,0,2
923,peoplestack-pa.googleapis.com,legit,3.63351,11,15,29,0,0.73333,0.12529,9,7,4,4,24,7,1,0,0,8
21,doubleclick.net,legit,3.50689,5,9,15,0,0.55556,0.23379,4,0,0,0,4,3,0,0,0,3
9701,traineddestinations.biz,dga,3.41444,9,13,23,1,0.69231,0.14845,8,0,0,0,8,12,6,2,1,21
3383,region1.analytics.google.com,legit,3.75343,10,14,28,0,0.71429,0.13405,8,5,4,3,20,6,1,0,0,7
4856,t13.io,legit,2.58496,2,1,6,0,2.0,0.43083,0,0,0,0,0,0,0,0,0,0
5075,mkkfctdrecvnmdqm.eu,dga,3.57662,3,15,19,1,0.2,0.18824,1,0,0,0,1,2,0,0,0,2
3377,instana.io,legit,2.72193,5,4,10,0,1.25,0.27219,3,0,0,0,3,5,0,0,0,5
1390,betrad.com,legit,3.32193,3,6,10,0,0.5,0.33219,2,0,0,0,2,3,1,0,0,4
8494,yrdbjufqbex.org,dga,3.64022,3,11,15,1,0.27273,0.24268,0,0,0,0,0,1,3,2,2,8
777,crl3.digicert.com,legit,3.45482,4,10,17,0,0.4,0.20322,5,1,0,0,6,4,0,0,0,4
3047,fef.msua06.manage.microsoft.com,legit,3.78437,10,15,31,0,0.66667,0.12208,9,9,7,8,33,6,0,0,0,6
6188,cxkseyqyhwdo.com,dga,3.625,3,12,16,1,0.25,0.22656,1,0,0,0,1,1,0,0,0,1
4121,wistia.com,legit,3.12193,4,5,10,0,0.8,0.31219,2,0,0,0,2,3,1,0,0,4
884,tags.crwdcntrl.net,legit,3.46132,2,14,18,0,0.14286,0.1923,5,0,0,0,5,1,0,0,0,1
4382,braintreegateway.com,legit,3.64644,8,11,20,0,0.72727,0.18232,6,0,0,0,6,5,1,0,0,6
274,id.google.com,legit,3.02699,5,6,13,0,0.83333,0.23285,3,5,4,3,15,1,0,0,0,1
9000,uwgacaslimo.com,dga,3.37356,6,8,15,1,0.75,0.2249,1,0,0,0,1,3,0,0,0,3
4115,e4805.dsca.akamaiedge.net,legit,3.73366,9,9,25,0,1.0,0.14935,7,5,5,3,20,6,0,0,0,6
9695,hvlxw.ly,dga,2.75,0,7,8,1,0.0,0.34375,0,0,0,0,0,0,0,0,0,0
9029,6sr8qlxtnde6klh6jv.ru,dga,3.97542,2,14,21,1,0.14286,0.18931,0,0,0,0,0,2,0,0,0,2
4284,api.p001.1drv.com,legit,3.45482,3,7,17,0,0.42857,0.20322,2,1,1,0,4,0,0,0,0,0
9454,autanidebitamcannulmer.com,dga,3.64237,11,14,26,1,0.78571,0.14009,3,0,0,0,3,8,1,0,0,9
4759,www.nytimes.com,legit,3.32323,3,10,15,0,0.3,0.22155,2,0,0,0,2,2,0,0,0,2
5783,mcsskkuuwikksaki.org,dga,3.3037,6,13,20,1,0.46154,0.16518,0,0,0,0,0,0,0,0,0,0
3530,samsungdm.com,legit,3.18083,3,9,13,0,0.33333,0.24468,1,0,0,0,1,2,0,0,0,2
4152,meethue.com,legit,2.84535,5,5,11,0,1.0,0.25867,0,0,0,0,0,1,0,0,0,1
7837,niqodoks.ru,dga,3.27761,4,6,11,1,0.66667,0.29796,0,0,0,0,0,1,0,0,0,1
8809,akqgxnwauacfypmqwm.me,dga,3.74899,5,15,21,1,0.33333,0.17852,0,0,0,0,0,1,0,0,0,1
6290,fdadlbmbafacedka.online,dga,3.53422,8,14,23,1,0.57143,0.15366,3,0,0,0,3,3,0,0,0,3
3063,pangle.io,legit,3.16993,4,4,9,0,1.0,0.35221,1,1,0,0,2,2,0,0,0,2
1505,colossusssp.com,legit,2.68259,4,10,15,0,0.4,0.17884,3,0,0,0,3,2,0,0,0,2
7015,mvcmnruwkofkrctgpbnvtodojwsqo.ru,dga,4.10141,6,25,32,1,0.24,0.12817,1,0,0,0,1,0,0,0,0,0
624,sitescout.com,legit,3.08506,5,7,13,0,0.71429,0.23731,4,0,0,0,4,5,0,0,0,5
3404,dartsearch.net,legit,3.23593,4,9,14,0,0.44444,0.23114,2,0,0,0,2,3,0,0,0,3
1230,notify.bugsnag.com,legit,3.72548,5,11,18,0,0.45455,0.20697,1,0,0,0,1,1,0,0,0,1
5556,samongihu.com,dga,3.39275,5,7,13,1,0.71429,0.26098,2,0,0,0,2,2,0,0,0,2
3752,indeed.com,legit,2.92193,4,5,10,0,0.8,0.29219,2,0,0,0,2,4,0,0,0,4
3886,trk.pinterest.com,legit,3.45482,4,11,17,0,0.36364,0.20322,8,0,0,0,8,6,4,1,0,11
6877,ojdelhyovtuohuoqizgdybq.ru,dga,3.90217,9,16,26,1,0.5625,0.15008,0,0,0,0,0,2,0,0,0,2
5281,clickownaccountshowwellfloor.com,dga,3.69143,10,21,32,1,0.47619,0.11536,7,0,0,0,7,5,0,0,0,5
8349,dyfqbacgsd.com,dga,3.52164,2,11,14,1,0.18182,0.25155,0,0,0,0,0,1,1,0,0,2
5291,hfenqknfb.tv,dga,3.25163,1,10,12,1,0.1,0.27097,1,0,0,0,1,1,0,0,0,1
7522,cassandrabertrand.net,dga,3.17757,6,14,21,1,0.42857,0.15131,2,0,0,0,2,7,3,0,0,10
4309,alt1-mtalk.google.com,legit,3.46328,6,11,21,0,0.54545,0.16492,3,5,4,3,15,2,0,0,0,2
1007,pull-a5-va01.tiktokcdn.com,legit,4.08506,6,13,26,0,0.46154,0.15712,4,6,9,9,28,2,0,0,0,2
8744,achopusoebc.ddns.net,dga,3.62193,6,12,20,1,0.5,0.1811,3,1,0,0,4,5,3,2,2,12
6409,ruqyapvmx.net,dga,3.70044,3,9,13,1,0.33333,0.28465,1,0,0,0,1,0,0,0,0,0
962,location.live.net,legit,3.26393,7,8,17,0,0.875,0.192,5,0,0,0,5,5,3,2,1,11
4419,api.login.yahoo.com,legit,3.36609,8,8,19,0,1.0,0.17716,5,1,1,1,8,1,0,0,0,1
2084,fna.whatsapp.net,legit,3.20282,4,10,16,0,0.4,0.20018,3,1,0,0,4,1,0,0,0,1
6767,rlbucbxqwh.com,dga,3.52164,2,11,14,1,0.18182,0.25155,0,0,0,0,0,0,0,0,0,0
9982,oryj5078gx3j3v7.ddns.net,dga,4.08496,2,13,24,1,0.15385,0.17021,2,1,0,0,3,5,3,3,2,13
8877,ivpunyfqbex.org,dga,3.90689,4,10,15,1,0.4,0.26046,0,0,0,0,0,1,3,2,1,7
8852,mmtxeubvokmq.biz,dga,3.57782,4,11,16,1,0.36364,0.22361,0,0,0,0,0,0,0,0,0,0
5775,wwgmueieycgyyyge.org,dga,3.18418,6,13,20,1,0.46154,0.15921,1,0,0,0,1,1,0,0,0,1
8035,mwyuuqeoya.biz,dga,3.52164,6,7,14,1,0.85714,0.25155,0,0,0,0,0,0,0,1,0,1
5426,egwaloegdaeh.ddns.net,dga,3.40399,7,12,21,1,0.58333,0.16209,3,1,0,0,4,4,3,2,2,11
2884,pocket.prod.cloudops.mozgcp.net,legit,3.71663,8,19,31,0,0.42105,0.11989,8,7,6,4,25,1,1,0,0,2
9910,analysistreeslipbottletravel.com,dga,3.76532,11,20,32,1,0.55,0.11767,6,0,0,0,6,11,2,0,0,13
2184,ff.avast.com,legit,3.08496,3,7,12,0,0.42857,0.25708,2,1,0,0,3,2,0,0,0,2
8612,qlepjuhncxldssrw.eu,dga,3.82687,4,14,19,1,0.28571,0.20141,2,0,0,0,2,1,0,0,0,1
6170,awjz.com.pt,dga,3.27761,2,7,11,1,0.28571,0.29796,2,2,1,0,5,2,2,1,0,5
2167,pull-flv-l10-sg01.tiktokcdn.com.rocket-cdn.com,legit,4.1514,7,27,46,0,0.25926,0.09025,7,10,12,10,39,5,2,1,0,8
7525,tecnoqfntb.com,dga,3.23593,3,10,14,1,0.3,0.23114,2,0,0,0,2,2,0,0,0,2
9959,washdesire.mx,dga,3.39275,4,8,13,1,0.5,0.26098,2,0,0,0,2,5,0,0,0,5
6618,ylahbiemvcypqlim.eu,dga,3.72161,6,12,19,1,0.5,0.19587,1,0,0,0,1,2,0,0,0,2
7153,pickfell.net,dga,3.25163,3,8,12,1,0.375,0.27097,2,0,0,0,2,2,0,0,0,2
5787,yvmulonlmsiv.biz,dga,3.5,4,11,16,1,0.36364,0.21875,2,0,0,0,2,2,0,0,0,2
9490,arwjwlwpkn.yi.org,dga,3.57247,3,12,17,1,0.25,0.21015,0,0,0,0,0,1,0,0,0,1
7166,yd1jyhu85l5be8k.ddns.net,dga,3.88684,3,14,24,1,0.21429,0.16195,2,1,0,0,3,5,3,2,2,12
1107,dscgi3.akamai.net,legit,3.57247,6,8,17,0,0.75,0.21015,4,3,4,3,14,2,0,0,0,2
6055,qwkocnrmg.net,dga,3.54659,2,10,13,1,0.2,0.27281,0,0,0,0,0,0,0,0,0,0
3453,zscalerthree.net,legit,3.25,5,10,16,0,0.5,0.20312,3,0,0,0,3,4,0,0,0,4
4238,gecko31-normal-useast1a.tiktokv.com,legit,4.09315,11,17,35,0,0.64706,0.11695,8,6,4,3,21,9,0,0,0,9
3175,1x1.a-mo.net,legit,3.25163,3,4,12,0,0.75,0.27097,1,0,0,0,1,0,0,0,0,0
6539,bcfhedkphymg.biz,dga,3.75,2,13,16,1,0.15385,0.23438,1,0,0,0,1,1,0,0,0,1
8520,elwmqfl.ag,dga,3.12193,2,7,10,1,0.28571,0.31219,0,0,0,0,0,1,0,0,0,1
3676,api.box.com,legit,3.0958,4,5,11,0,0.8,0.28144,2,1,1,0,4,0,0,0,0,0
9024,egenumverbumcarniscontra.com,dga,3.74398,10,17,28,1,0.58824,0.13371,7,1,0,0,8,11,3,0,1,15
216,nr-data.net,legit,2.91398,3,6,11,0,0.5,0.26491,2,0,0,0,2,2,0,0,0,2
4189,go.microsoft.com.edgekey.net,legit,3.6645,9,15,28,0,0.6,0.13088,10,13,10,7,40,6,2,1,0,9
2031,dual-gslb.spotify.com,legit,4.01137,5,13,21,0,0.38462,0.19102,1,0,0,0,1,1,0,0,0,1
9421,patternseparatetellrushslice.com,dga,3.66784,11,20,32,1,0.55,0.11462,9,1,0,0,10,11,3,0,0,14
5656,qpfqpqqpnwjk.cc,dga,2.92323,0,14,15,1,0.0,0.19488,0,0,0,0,0,0,0,0,0,0
2022,dual-a-0001.a-msedge.net,legit,3.62581,7,8,24,0,0.875,0.15108,4,2,1,0,7,3,0,0,0,3
9907,gmhqxlfmvcxw.com,dga,3.45282,1,14,16,1,0.07143,0.2158,0,0,0,0,0,0,0,0,0,0
5601,qdyraobapd.com,dga,3.37878,4,9,14,1,0.44444,0.24134,2,0,0,0,2,1,0,0,0,1
6250,rollfinal.cx,dga,3.18872,3,8,12,1,0.375,0.26573,2,0,0,0,2,1,0,0,0,1
8184,2vis2dkby1f8qgoi2h.ru,dga,4.07066,4,11,21,1,0.36364,0.19384,0,0,0,0,0,1,0,0,0,1
7590,dooaiqbbkg.com,dga,3.32486,5,8,14,1,0.625,0.23749,1,0,0,0,1,0,0,0,0,0
126,nel.measure.office.net,legit,3.53377,9,10,22,0,0.9,0.16063,7,4,4,3,18,8,0,0,0,8
557,stags.bluekai.com,legit,3.73452,6,9,17,0,0.66667,0.21968,3,0,0,0,3,2,0,0,0,2
2318,microsoft.com.edgekey.net,legit,3.70347,8,14,25,0,0.57143,0.14814,9,12,9,6,36,6,2,1,0,9
875,a1806.dscw154.akamai.net,legit,3.97018,6,8,24,0,0.75,0.16542,5,3,4,3,15,3,0,0,0,3
6794,hgubujdad.com,dga,3.39275,4,8,13,1,0.5,0.26098,1,0,0,0,1,0,0,0,0,0
9896,yrwchmekwixogic.biz,dga,3.78714,5,13,19,1,0.38462,0.19932,1,0,0,0,1,1,0,0,0,1
8155,xalsxwegptvlfgnnq.com,dga,4.01137,3,17,21,1,0.17647,0.19102,0,0,0,0,0,0,0,0,0,0
6337,pqdmldyiiwuvxlftg.net,dga,4.01137,4,16,21,1,0.25,0.19102,0,0,0,0,0,0,0,0,0,0
7337,bbmmdloldefeaffc.eu,dga,3.32636,6,12,19,1,0.5,0.17507,2,0,0,0,2,2,0,0,0,2
4327,crl.usertrust.com,legit,3.21953,4,11,17,0,0.36364,0.18938,5,1,0,0,6,3,1,0,0,4
6383,qiwfjllunhco.com,dga,3.625,4,11,16,1,0.36364,0.22656,1,0,0,0,1,1,0,0,0,1
6936,chancefixedcakenumberapologize.com,dga,4.05454,14,19,34,1,0.73684,0.11925,7,0,0,0,7,8,2,1,0,11
2731,search.yahoo.com,legit,3.20282,6,8,16,0,0.75,0.20018,3,0,0,1,4,3,0,0,0,3
8355,vmrbrvdrxwfst.ug,dga,3.57782,1,14,16,1,0.07143,0.22361,1,0,0,0,1,1,0,0,0,1
5488,xtmadmcnuveeuq.com,dga,3.57243,6,11,18,1,0.54545,0.19847,2,0,0,0,2,2,0,0,0,2
3398,p-th.bing.com.trafficmanager.net,legit,3.86673,8,19,32,0,0.42105,0.12084,9,6,3,4,22,9,4,1,0,14
4404,cdn.globalsigncdn.com.cdn.cloudflare.net,legit,3.78233,9,26,40,0,0.34615,0.09456,7,8,6,3,24,7,2,1,0,10
4521,live.chartboost.com,legit,3.68188,6,11,19,0,0.54545,0.19378,5,0,0,0,5,3,1,1,0,5
3599,svc.ha-teams.office.com,legit,3.58835,7,12,23,0,0.58333,0.15602,7,4,4,3,18,5,0,0,0,5
8857,ogciuuosceioiows.org,dga,3.1037,11,8,20,1,1.375,0.15518,1,0,0,0,1,1,0,0,0,1
6780,i0ekqcawi8mk.top,dga,3.75,5,8,16,1,0.625,0.23438,0,0,0,0,0,1,0,0,0,1
4313,status.geotrust.com,legit,3.26083,6,11,19,0,0.54545,0.17162,6,0,0,0,6,4,0,0,0,4
2537,lpsnmedia.net,legit,3.39275,4,8,13,0,0.5,0.26098,1,0,0,0,1,1,0,0,0,1
1359,playatoms-pa.googleapis.com,legit,3.61582,10,14,27,0,0.71429,0.13392,7,6,4,4,21,6,0,0,0,6
8802,gezvrcn.ir,dga,3.12193,2,7,10,1,0.28571,0.31219,1,0,0,0,1,1,0,0,0,1
4258,scontent-dfw5-1.xx.fbcdn.net,legit,3.75343,3,18,28,0,0.16667,0.13405,7,3,0,0,10,5,2,0,0,7
8192,jfwsmuuhhfxses.biz,dga,3.57243,4,13,18,1,0.30769,0.19847,2,0,0,0,2,2,0,0,0,2
1108,duplex.snapchat.com,legit,3.82687,5,12,19,0,0.41667,0.20141,4,1,0,0,5,2,1,0,0,3
4102,lf16-effectcdn-va.tiktokcdn.com,legit,3.93775,6,19,31,0,0.31579,0.12702,4,6,7,6,23,3,0,0,0,3
9226,kokjnsabxbfoxnlo.com,dga,3.52193,5,14,20,1,0.35714,0.1761,1,0,0,0,1,1,0,0,0,1
5174,lyrovudi.info,dga,3.39275,5,7,13,1,0.71429,0.26098,1,0,0,0,1,0,0,0,0,0
9653,4a0a8mkewuc6.org,dga,3.875,5,6,16,1,0.83333,0.24219,0,0,0,0,0,0,0,0,0,0
5589,vancouver-minds.hn,dga,3.79465,5,11,18,1,0.45455,0.21081,6,0,0,0,6,7,1,0,0,8
1236,applovin.com,legit,3.25163,4,7,12,0,0.57143,0.27097,5,2,1,0,8,1,0,0,0,1
6559,4a8tgzyrymg8gpong6.cn,dga,3.72565,2,14,21,1,0.14286,0.17741,1,0,0,0,1,1,0,0,0,1
1211,shared.global.fastly.net,legit,3.7406,6,15,24,0,0.4,0.15586,5,1,0,0,6,5,0,0,0,5
31,amazonaws.com,legit,3.02699,5,7,13,0,0.71429,0.23285,3,1,3,2,9,3,0,0,0,3
8152,ttmaipbprh.com,dga,3.37878,3,10,14,1,0.3,0.24134,2,0,0,0,2,1,0,0,0,1
4685,code42.com,legit,2.92193,3,4,10,0,0.75,0.29219,1,0,0,0,1,2,0,0,0,2
2630,discordapp.com,legit,3.23593,4,9,14,0,0.44444,0.23114,3,1,0,0,4,3,0,0,0,3
8526,ugduwvpyacdaufkm.eu,dga,3.61635,7,11,19,1,0.63636,0.19033,1,0,0,0,1,1,0,0,0,1
330,us-v10c.events.data.microsoft.com,legit,3.9832,9,17,33,0,0.52941,0.1207,13,9,7,6,35,7,1,0,0,8
4256,dual.dotomi.weighted.com.akadns.net,legit,3.85416,12,18,35,0,0.66667,0.11012,10,6,7,7,30,8,3,1,0,12
2142,d.dropbox.com,legit,3.02699,3,8,13,0,0.375,0.23285,3,0,0,0,3,1,0,0,0,1
3111,windowsupdatebg.s.llnwi.net,legit,3.78212,7,17,27,0,0.41176,0.14008,4,0,0,0,4,5,1,0,0,6
6191,todicwifsa.com,dga,3.37878,5,8,14,1,0.625,0.24134,1,0,0,0,1,1,0,0,0,1
9746,byjtngkssgraapsei.com,dga,3.97542,5,15,21,1,0.33333,0.18931,3,0,0,0,3,2,0,0,0,2
9253,srrpkdxxamnjpmqdat.com,dga,3.78875,3,18,22,1,0.16667,0.17222,2,0,0,0,2,2,0,0,0,2
1876,opera.com,legit,2.9477,4,4,9,0,1.0,0.32752,2,0,0,0,2,2,0,0,0,2
5362,onondftrbaiucfye.eu,dga,3.72161,8,10,19,1,0.8,0.19587,1,0,0,0,1,2,0,0,0,2
5263,venuedoctor.hn,dga,3.37878,5,8,14,1,0.625,0.24134,2,0,0,0,2,4,0,0,0,4
2377,api.dropboxapi.com,legit,3.30827,7,9,18,0,0.77778,0.18379,4,1,1,0,6,1,1,0,0,2
5846,juobrwed7q6hkdypvy.cn,dga,4.20184,3,15,21,1,0.2,0.20009,1,0,0,0,1,1,0,0,0,1
2241,13-courier.push.apple.com,legit,3.86347,8,11,25,0,0.72727,0.15454,9,4,3,2,18,4,0,0,0,4
7021,knejbligvrfgscif.com,dga,3.92193,4,15,20,1,0.26667,0.1961,1,0,0,0,1,1,0,0,0,1
95,presence.teams.microsoft.com,legit,3.5297,9,16,28,0,0.5625,0.12606,18,8,7,6,39,10,2,1,0,13
3696,scontent-ord5-2.xx.fbcdn.net,legit,3.75343,4,17,28,0,0.23529,0.13405,7,3,0,0,10,6,2,0,0,8
4768,us-east-1.event.prod.bidr.io,legit,3.85182,9,12,28,0,0.75,0.13756,8,6,3,2,19,5,2,0,0,7
2443,fallback.c10r.facebook.com,legit,3.53641,7,14,26,0,0.5,0.13602,3,0,0,0,3,2,0,0,0,2
7859,w6ylcb38kp3xufslm4u.ddns.net,dga,4.30735,3,18,28,1,0.16667,0.15383,2,1,0,0,3,4,3,3,2,12
6031,wkceegeoya.net,dga,3.23593,6,7,14,1,0.85714,0.23114,2,0,0,0,2,2,0,1,0,3
1367,net.akadns.net,legit,2.89629,4,8,14,0,0.5,0.20688,3,3,4,3,13,4,1,0,0,5
5458,6geo28asigu4.org,dga,3.57782,6,5,16,1,1.2,0.22361,1,0,0,0,1,3,0,0,0,3
9125,languagelunchtoecatchpressure.com,dga,3.78652,12,20,33,1,0.6,0.11474,5,1,0,0,6,10,2,0,0,12
6914,gottt.com.jm,dga,2.68872,2,8,12,1,0.25,0.22406,2,2,1,0,5,2,2,1,0,5
2512,techlab-cdn.com,legit,3.5899,3,10,15,0,0.3,0.23933,3,1,0,0,4,4,0,0,0,4
1317,onesignal.com,legit,3.39275,5,7,13,0,0.71429,0.26098,2,0,0,0,2,4,1,0,0,5
6343,ciayekqusueagyku.org,dga,3.58418,9,10,20,1,0.9,0.17921,2,0,0,0,2,2,0,0,0,2
4605,oracle.com,legit,2.92193,4,5,10,0,0.8,0.29219,2,0,0,0,2,4,0,0,0,4
786,go.sonobi.com,legit,2.93121,5,6,13,0,0.83333,0.22548,1,0,0,0,1,1,0,0,0,1
5716,ccpodo.biz,dga,2.92193,3,6,10,1,0.5,0.29219,0,0,0,0,0,0,0,0,0,0
4380,log22-normal-useast1a.tiktokv.com,legit,4.08955,10,16,33,0,0.625,0.12393,8,6,4,3,21,7,0,0,0,7
8131,nolkjjrutyxp.com,dga,3.75,3,12,16,1,0.25,0.23438,0,0,0,0,0,0,0,0,0,0
878,contacts.fe.apple-dns.net,legit,3.56307,6,15,25,0,0.4,0.14252,12,6,3,2,23,7,2,0,0,9
501,wg.spotify.com,legit,3.52164,3,9,14,0,0.33333,0.25155,1,0,0,0,1,1,0,0,0,1
3269,hb.ad.cpe.dotomi.com,legit,3.38418,6,10,20,0,0.6,0.16921,7,0,0,0,7,3,1,0,0,4
6291,edfuvobeqemn.com,dga,3.45282,6,9,16,1,0.66667,0.2158,1,0,0,0,1,3,0,0,0,3
1325,insightexpressai.com,legit,3.74644,7,12,20,0,0.58333,0.18732,5,0,0,0,5,6,2,0,0,8
7975,kyyqqcicieeaeiac.org,dga,3.30869,9,10,20,1,0.9,0.16543,2,0,0,0,2,3,0,0,0,3
631,tsfe.trafficshaping.dsp.mp.microsoft.com,legit,3.81845,9,26,40,0,0.34615,0.09546,15,11,8,7,41,5,2,0,0,7
3316,acsbapp.com,legit,2.91398,3,7,11,0,0.42857,0.26491,2,1,0,0,3,1,0,0,0,1
1918,onedrive.com,legit,3.25163,5,6,12,0,0.83333,0.27097,2,0,0,0,2,5,1,0,0,6
2153,files.acrobat.com,legit,3.61687,6,9,17,0,0.66667,0.21276,7,1,0,0,8,4,0,0,0,4
9413,nolierivi.ddns.net,dga,3.30827,6,10,18,1,0.6,0.18379,4,1,0,0,5,6,5,3,2,16
6441,ewagdwiugkeq.info,dga,3.61687,7,9,17,1,0.77778,0.21276,0,0,0,0,0,0,0,3,2,5
2136,vad-bid.adsrvr.org,legit,3.30827,4,11,18,0,0.36364,0.18379,4,0,0,0,4,0,0,0,0,0
5448,io6kigygy4ys.org,dga,3.15564,4,9,16,1,0.44444,0.19723,0,0,0,0,0,0,0,0,0,0
6888,tpuftuykpqvejqwjp.mn,dga,3.68418,3,16,20,1,0.1875,0.18421,0,0,0,0,0,1,0,0,0,1
7550,tevcogdxpdoh.pw,dga,3.50689,3,11,15,1,0.27273,0.23379,2,0,0,0,2,2,0,0,0,2
7833,dsescikgyixvycfibrg.com,dga,3.84922,5,17,23,1,0.29412,0.16736,3,0,0,0,3,2,0,0,0,2
7495,mefkmokxd6zbc8rxsb.net,dga,4.00489,3,16,22,1,0.1875,0.18204,0,0,0,0,0,0,0,0,0,0
3776,gsp10-ssl.ls-apple.com.akadns.net,legit,3.83608,6,19,33,0,0.31579,0.11624,10,9,9,9,37,5,3,1,0,9
1679,dbankcloud.cn,legit,3.2389,3,9,13,0,0.33333,0.24915,2,3,2,1,8,1,0,0,0,1
5539,gsrz.com.co,dga,2.91398,2,7,11,1,0.28571,0.26491,2,2,1,0,5,2,2,1,0,5
4292,www.amazon.it,legit,3.02699,4,7,13,0,0.57143,0.23285,4,1,3,3,11,3,0,0,0,3
1567,outlookmobile-office365-tas.msedge.net,legit,4.14334,14,17,38,0,0.82353,0.10904,13,6,4,2,25,8,0,0,0,8
5500,ymirohscgjxm.ru,dga,3.64022,3,11,15,1,0.27273,0.24268,2,0,0,0,2,1,0,0,0,1
9588,forgetletter.net,dga,2.875,5,10,16,1,0.5,0.17969,4,0,0,0,4,6,1,0,0,7
8571,y23ljnkz3uzcgqchrw.net,dga,4.0958,2,16,22,1,0.125,0.18617,0,0,0,0,0,0,0,0,0,0
5840,severinopeiismaestremi.com,dga,3.42662,12,13,26,1,0.92308,0.13179,8,0,0,0,8,12,4,0,0,16
3107,tm.prd.ags.trafficmanager.net,legit,3.63351,7,18,29,0,0.38889,0.12529,10,4,1,3,18,6,1,0,0,7
5875,influencepulleasebottlemail.com,dga,3.68906,13,17,31,1,0.76471,0.119,7,0,1,0,8,9,1,1,0,11
872,events.launchdarkly.com,legit,4.00182,6,15,23,0,0.4,0.17399,3,1,0,0,4,4,1,0,0,5
3575,zoominfo.com,legit,2.75163,5,6,12,0,0.83333,0.2293,3,0,0,0,3,3,0,0,0,3
6197,machinanturpropter.com,dga,3.60694,7,14,22,1,0.5,0.16395,7,1,0,0,8,6,4,0,0,10
5761,theologicalcelcasuum.com,dga,3.52206,10,13,24,1,0.76923,0.14675,3,0,0,0,3,6,0,0,0,6
3239,apps.bazaarvoice.com,legit,3.52193,8,10,20,0,0.8,0.1761,5,2,0,0,7,3,0,0,0,3
6492,jumpsure.net,dga,3.25163,4,7,12,1,0.57143,0.27097,1,0,0,0,1,2,0,0,0,2
414,launchdarkly.com,legit,3.625,4,11,16,0,0.36364,0.22656,0,0,0,0,0,2,0,0,0,2
4130,w.inmobi.com,legit,2.9183,4,6,12,0,0.66667,0.24319,1,0,0,0,1,1,0,0,0,1
4066,treasuredata.com,legit,3.32782,7,8,16,0,0.875,0.20799,5,0,0,0,5,7,0,0,0,7
1328,www.spotify.com,legit,3.32323,3,10,15,0,0.3,0.22155,1,0,0,0,1,1,0,0,0,1
6404,stagebuildsetsmellexistrelax.com,dga,3.73861,11,20,32,1,0.55,0.11683,7,1,0,0,8,10,1,0,0,11
8589,yywxtqkqtltsimlv.eu,dga,3.68188,3,15,19,1,0.2,0.19378,0,0,0,0,0,1,0,0,0,1
5275,niyxkdevsirbjhiuj.tw,dga,3.98418,5,14,20,1,0.35714,0.19921,0,0,0,0,0,3,0,0,0,3
2112,paypalobjects.com,legit,3.61687,5,11,17,0,0.45455,0.21276,1,0,0,0,1,1,0,0,0,1
1190,resources.office.net,legit,3.32193,8,10,20,0,0.8,0.1661,7,4,4,3,18,4,1,0,0,5
4501,xp.apple.com.edgekey.net,legit,3.56977,7,13,24,0,0.53846,0.14874,11,9,6,4,30,5,2,1,0,8
7122,significancefingering.de,dga,3.20499,9,14,24,1,0.64286,0.13354,5,1,0,0,6,10,4,1,0,15
2068,match.360yield.com,legit,3.83659,4,9,18,0,0.44444,0.21314,2,0,0,0,2,3,0,0,0,3
2327,pubmnet.com,legit,3.27761,3,7,11,0,0.42857,0.29796,0,0,0,0,0,2,0,0,0,2
4289,domain-resources.learnplatform.com,legit,3.90321,12,19,34,0,0.63158,0.1148,11,0,0,0,11,12,1,0,0,13
6599,lprshrs.tv,dga,2.92193,0,9,10,1,0.0,0.29219,1,0,0,0,1,0,0,0,0,0
3206,s-onetag.com,legit,3.4183,4,6,12,0,0.66667,0.28486,2,0,0,0,2,4,1,0,0,5
7547,1tle3ifwevcoq24k1z.com,dga,4.0958,5,11,22,1,0.45455,0.18617,2,0,0,0,2,2,0,0,0,2
800,oribi.io,legit,2.15564,5,2,8,0,2.5,0.26946,0,0,0,0,0,2,0,0,0,2
9432,onobodsdgfo87bava8u0q4w.ddns.net,dga,4.03891,8,17,32,1,0.47059,0.12622,4,1,0,0,5,5,3,3,2,13
6345,hospitalactzonepressureexample.com,dga,3.89249,13,20,34,1,0.65,0.11448,9,1,0,0,10,11,4,0,0,15
1339,a1887.dscq.akamai.net,legit,3.6897,6,8,21,0,0.75,0.1757,5,3,4,3,15,3,0,0,0,3
8408,mjfhtglhqg.com,dga,3.37878,1,12,14,1,0.08333,0.24134,0,0,0,0,0,0,0,0,0,0
9795,ryan-nights.eu,dga,3.6645,4,8,14,1,0.5,0.26175,0,0,0,0,0,2,0,0,0,2
5137,ogkqkycsqckosqck.org,dga,3.00869,3,16,20,1,0.1875,0.15043,0,0,0,0,0,0,0,0,0,0
7620,referraljapanese.vn,dga,3.2211,7,11,19,1,0.63636,0.16953,6,0,0,0,6,7,0,0,0,7
4620,p4.webrootcloudav.com,legit,3.82089,7,11,21,0,0.63636,0.18195,4,3,2,1,10,0,0,0,0,0
1550,fullstory.com,legit,3.39275,3,9,13,0,0.33333,0.26098,1,0,0,0,1,2,0,0,0,2
904,s.moatpixel.com,legit,3.50689,5,8,15,0,0.625,0.23379,4,0,0,0,4,2,0,0,0,2
2699,eqads.com,legit,3.16993,3,5,9,0,0.6,0.35221,2,0,0,0,2,0,0,0,0,0
9804,stodvwmb.com,dga,3.25163,2,9,12,1,0.22222,0.27097,1,0,0,0,1,1,0,0,0,1
5834,nqm29gznvi25hwewk27c49lqg43h44m19d30grdt.info,dga,4.58031,4,24,45,1,0.16667,0.10178,0,0,0,0,0,0,0,0,0,0
3642,api.espn.com,legit,3.25163,4,6,12,0,0.66667,0.27097,3,1,1,0,5,1,0,0,0,1
8121,gahyfow.com,dga,3.27761,3,7,11,1,0.42857,0.29796,0,0,0,0,0,0,0,0,0,0
9299,uoemsyswiqmukyie.org,dga,3.62193,8,11,20,1,0.72727,0.1811,0,0,0,0,0,1,0,0,0,1
3825,events.mobile.crashtracking.prod.ring.com,legit,4.0555,11,25,41,0,0.44,0.09891,13,5,3,2,23,8,5,0,0,13
4362,nt.meraki.com,legit,3.39275,4,7,13,0,0.57143,0.26098,4,0,0,0,4,2,0,0,0,2
2561,vid.vidoomy.com,legit,2.92323,5,8,15,0,0.625,0.19488,2,0,0,0,2,1,0,0,0,1
864,femetrics.grammarly.io,legit,3.66353,7,13,22,0,0.53846,0.16652,5,0,0,0,5,8,0,0,0,8
35,outlook.office365.com,legit,3.55376,8,8,21,0,1.0,0.16923,6,4,4,3,17,2,0,0,0,2
2835,pay.google.com,legit,3.18201,5,7,14,0,0.71429,0.22729,2,5,4,3,14,1,0,0,0,1
7536,yaiuiplimlxxoneu.eu,dga,3.43162,10,8,19,1,1.25,0.18061,3,0,0,0,3,2,1,0,0,3
2684,cl3.g.aaplimg.com,legit,3.21953,4,9,17,0,0.44444,0.18938,4,0,0,0,4,0,0,0,0,0
720,simpli.fi,legit,2.6416,3,5,9,0,0.6,0.29351,2,0,0,0,2,1,0,0,0,1
8691,ryhuheva.info,dga,3.54659,5,7,13,1,0.71429,0.27281,0,0,0,0,0,0,0,0,0,0
2066,qsearch-a.akamaihd.net,legit,3.65899,8,11,22,0,0.72727,0.16632,5,3,4,3,15,5,0,0,0,5
9216,fsxsskmykapjeaupk.cc,dga,3.54644,4,15,20,1,0.26667,0.17732,2,0,0,0,2,1,0,0,0,1
3697,homedepot.com,legit,3.02699,5,7,13,0,0.71429,0.23285,1,0,0,0,1,3,0,0,0,3
3734,splunkcloud.com,legit,3.37356,4,10,15,0,0.4,0.2249,3,3,2,1,9,0,0,0,0,0
1746,array806.prod.do.dsp.mp.microsoft.com,legit,3.71259,8,20,37,0,0.4,0.10034,12,12,10,9,43,5,2,0,0,7
1821,smadex.com,legit,3.12193,3,6,10,0,0.5,0.31219,2,0,0,0,2,2,0,0,0,2
2077,printercloud.com,legit,3.625,5,10,16,0,0.5,0.22656,7,3,2,1,13,4,2,1,0,7
4581,zillow.com,legit,2.92193,3,6,10,0,0.5,0.29219,1,0,0,0,1,0,0,0,0,0
7809,vihgqrolpdnn.com,dga,3.75,3,12,16,1,0.25,0.23438,2,0,0,0,2,1,0,0,0,1
2832,balrog.prod.cloudops.mozgcp.net,legit,3.84566,8,19,31,0,0.42105,0.12405,8,7,6,4,25,0,1,0,0,1
5124,qptlcfcbioocvrqdr.pw,dga,3.68418,3,16,20,1,0.1875,0.18421,1,0,0,0,1,0,0,0,0,0
3499,fcdn.us.tiktokv.com.c.bytefcdn-oversea.com,legit,3.99638,10,25,42,0,0.4,0.09515,12,10,7,4,33,9,5,1,0,15
3831,yengo.com,legit,2.9477,3,5,9,0,0.6,0.32752,1,0,0,0,1,1,0,0,0,1
7414,lxoleqyyrkkn.in,dga,3.37356,3,11,15,1,0.27273,0.2249,1,0,0,0,1,1,0,0,0,1
3804,perimeterx.net,legit,2.95021,5,8,14,0,0.625,0.21073,2,0,0,0,2,4,2,0,0,6
3109,reddit.map.fastly.net,legit,3.65376,5,13,21,0,0.38462,0.17399,7,1,0,0,8,7,0,0,0,7
3084,t.adx.opera.com,legit,3.32323,5,7,15,0,0.71429,0.22155,4,0,0,0,4,2,0,0,0,2
8997,lrkhjwiuogru.co.uk,dga,3.46132,6,10,18,1,0.6,0.1923,2,1,0,0,3,1,1,0,0,2
7707,tjklrihkpcyy.cc,dga,3.32323,1,13,15,1,0.07692,0.22155,0,0,0,0,0,1,0,0,0,1
6953,obhvnfuwujel.com,dga,3.75,5,10,16,1,0.5,0.23438,0,0,0,0,0,1,0,0,0,1
7869,safegwoh.com,dga,3.4183,4,7,12,1,0.57143,0.28486,0,0,0,0,0,0,0,0,0,0
4112,seedtag.com,legit,3.27761,4,6,11,0,0.66667,0.29796,3,0,0,0,3,3,0,0,0,3
3085,samba.tv,legit,2.75,2,5,8,0,0.4,0.34375,1,0,0,0,1,1,0,0,0,1
8137,qnyholaa.com,dga,3.25163,4,7,12,1,0.57143,0.27097,0,0,0,0,0,1,0,1,0,2
5565,jilxcxkppdqkg.com,dga,3.61687,2,14,17,1,0.14286,0.21276,1,0,0,0,1,0,0,0,0,0
7965,pihqzamqx.org,dga,3.54659,3,9,13,1,0.33333,0.27281,2,0,0,0,2,1,0,0,0,1
462,crwdcntrl.net,legit,3.08506,1,11,13,0,0.09091,0.23731,2,0,0,0,2,0,0,0,0,0
3391,p.alcmpn.com,legit,2.9183,2,8,12,0,0.25,0.24319,2,0,0,0,2,0,0,0,0,0
9230,emmiiyuuwayiiuuo.org,dga,3.22193,12,7,20,1,1.71429,0.1611,1,0,0,0,1,2,0,0,0,2
7619,i25bzo41esmvcub58lxkyark37gydwjuh24jz.ru,dga,4.75306,7,22,40,1,0.31818,0.11883,1,0,0,0,1,2,0,0,0,2
5405,ax7ju4k4gjwdulmrq4w.ddns.net,dga,4.11058,4,18,28,1,0.22222,0.14681,2,1,0,0,3,4,3,3,2,12
9444,jpfpjolna.com,dga,3.2389,3,9,13,1,0.33333,0.24915,0,0,0,0,0,0,0,0,0,0
6210,xubovad.info,dga,3.4183,5,6,12,1,0.83333,0.28486,1,0,0,0,1,0,0,0,0,0
4639,firehose.us-east-1.amazonaws.com,legit,3.92923,12,14,32,0,0.85714,0.12279,10,2,3,3,18,8,0,0,0,8
4555,hispace.dbankcloud.cn,legit,3.78494,6,13,21,0,0.46154,0.18024,5,3,2,1,11,5,1,0,0,6
3929,userreport.com,legit,3.18201,5,8,14,0,0.625,0.22729,4,1,0,0,5,4,1,0,0,5
8719,qkjbqxiuvg.com,dga,3.6645,3,10,14,1,0.3,0.26175,0,0,0,0,0,0,0,0,0,0
5939,odmoeykwlujqxtor.info,dga,4.01137,7,13,21,1,0.53846,0.19102,0,0,0,0,0,1,0,0,0,1
5843,ufvoninof.ddns.net,dga,3.28104,5,11,18,1,0.45455,0.18228,5,1,0,0,6,7,3,2,1,13
3133,us-east-eb2.3lift.com,legit,3.91613,6,9,21,0,0.66667,0.18648,4,1,0,0,5,3,0,0,0,3
1987,sascdn.com,legit,2.92193,2,7,10,0,0.28571,0.29219,2,1,0,0,3,2,0,0,0,2
6342,eh5fc23pu2irm4mbi0a.ddns.net,dga,4.30735,6,14,28,1,0.42857,0.15383,2,1,0,0,3,4,4,3,2,13
2267,32-courier.push.apple.com,legit,3.86347,8,11,25,0,0.72727,0.15454,9,4,3,2,18,4,0,0,0,4
1091,api.segment.io,legit,3.37878,6,6,14,0,1.0,0.24134,5,2,1,0,8,2,1,0,0,3
3627,ebaystatic.com,legit,3.37878,5,8,14,0,0.625,0.24134,5,0,0,0,5,5,1,0,0,6
1657,api16-core.tiktokv.com,legit,3.78875,7,10,22,0,0.7,0.17222,7,6,4,3,20,4,0,0,0,4
8934,fcknbcenbfcamnnn.eu,dga,3.07085,4,14,19,1,0.28571,0.16162,3,0,0,0,3,4,0,0,0,4
8504,hooogxruejct.info,dga,3.61687,7,9,17,1,0.77778,0.21276,1,1,0,0,2,0,1,0,0,1
2147,edge.gycpi.b.yahoodns.net,legit,3.73366,7,14,25,0,0.5,0.14935,6,3,1,1,11,4,1,0,0,5
6416,guoth34p52d50l18cukxg43hzktiqnrnug23iv.biz,dga,4.55852,7,22,42,1,0.31818,0.10854,1,0,0,0,1,1,0,0,0,1
1066,b.akamaiedge.net,legit,3.28064,7,7,16,0,1.0,0.20504,5,5,5,3,18,4,0,0,0,4
2468,a-mx.com,legit,2.75,2,4,8,0,0.5,0.34375,0,0,0,0,0,0,0,0,0,0
333,init.ess.apple.com,legit,3.46132,6,9,18,0,0.66667,0.1923,8,4,3,2,17,5,1,0,0,6
2769,jwpcdn.com,legit,3.12193,1,8,10,0,0.125,0.31219,2,1,0,0,3,1,0,0,0,1
9700,quqearex.ru,dga,2.73216,5,5,11,1,1.0,0.24838,2,0,0,0,2,3,0,0,0,3
3694,config.mobile.yahoo.com,legit,3.55119,9,11,23,0,0.81818,0.1544,6,1,0,1,8,3,1,0,0,4
6521,xerbtwawlvqv.com,dga,3.75,3,12,16,1,0.25,0.23438,1,0,0,0,1,1,0,0,0,1
8838,essechristiusquephonevi.com,dga,3.68989,11,15,27,1,0.73333,0.13666,6,0,0,0,6,9,4,0,2,15
341,jsdelivr.net,legit,3.4183,3,8,12,0,0.375,0.28486,1,0,0,0,1,2,0,0,0,2
6585,suppliers-formerly.ch,dga,3.78494,5,14,21,1,0.35714,0.18024,4,1,0,0,5,3,1,0,0,4
767,e6858.dscx.akamaiedge.net,legit,3.78347,8,10,25,0,0.8,0.15134,7,5,5,3,20,5,0,0,0,5
9074,onmwvmwohyri.net,dga,3.5,4,11,16,1,0.36364,0.21875,1,0,0,0,1,2,0,0,0,2
2329,eu-teams.events.data.microsoft.com,legit,3.76336,12,17,34,0,0.70588,0.11069,15,9,7,6,37,10,1,0,0,11
4932,enterprise-activity-geo.trafficmanager.net,legit,3.82388,15,23,42,0,0.65217,0.09104,12,4,1,3,20,14,4,0,0,18
4427,imgur.com,legit,2.9477,3,5,9,0,0.6,0.32752,0,0,0,0,0,0,0,0,0,0
1846,apex.go.sonobi.com,legit,3.46132,7,8,18,0,0.875,0.1923,2,1,0,0,3,1,0,0,0,1
634,yieldmo.com,legit,3.0958,4,6,11,0,0.66667,0.28144,0,0,0,0,0,1,0,0,0,1
4586,akamaicdn.webex.com,legit,3.57662,7,10,19,0,0.7,0.18824,5,4,4,2,15,5,1,0,0,6
8816,yxjklypgar.com,dga,3.6645,2,11,14,1,0.18182,0.26175,0,0,0,0,0,1,0,0,0,1
162,officeclient.microsoft.com,legit,3.4116,9,15,26,0,0.6,0.13122,10,13,10,8,41,5,1,0,0,6
7219,towngroundshootstaffinsist.com,dga,3.69474,9,20,30,1,0.45,0.12316,7,1,0,0,8,7,1,1,0,9
7542,s14orb4271n2zk8c1b.com,dga,3.78875,2,10,22,1,0.2,0.17222,0,0,0,0,0,1,0,0,0,1
4096,steamstatic.com,legit,3.05656,5,9,15,0,0.55556,0.20377,8,0,0,0,8,8,1,0,0,9
6384,eqqugsuiwcymao.biz,dga,3.83659,7,10,18,1,0.7,0.21314,1,0,0,0,1,2,0,5,4,11
6664,weighthabitperfectappear.com,dga,3.72647,10,17,28,1,0.58824,0.13309,5,1,0,0,6,6,0,0,0,6
7098,alirwif.com,dga,3.27761,4,6,11,1,0.66667,0.29796,1,0,0,0,1,0,0,0,0,0
9793,higafluh.com,dga,3.4183,4,7,12,1,0.57143,0.28486,0,0,0,0,0,0,0,0,0,0
4089,gem.gbc.criteo.com,legit,3.19716,5,10,18,0,0.5,0.17762,4,0,0,0,4,5,0,0,0,5
6463,qwsoacwqxhmoeqjay.cc,dga,3.54644,5,14,20,1,0.35714,0.17732,0,0,0,0,0,1,0,0,0,1
9242,ncuzpjtjcv.com,dga,3.32486,2,11,14,1,0.18182,0.23749,0,0,0,0,0,0,0,0,0,0
6403,ideateachmeetsiteshineessay.com,dga,3.40851,14,16,31,1,0.875,0.10995,5,0,0,0,5,11,3,0,0,14
6713,tasuhgimsah.com,dga,3.37356,5,9,15,1,0.55556,0.2249,1,0,0,0,1,3,0,0,0,3
9087,xfwz.com.ua,dga,3.27761,3,6,11,1,0.5,0.29796,2,2,1,0,5,2,2,1,0,5
3182,kochava.com,legit,2.91398,4,6,11,0,0.66667,0.26491,0,0,0,0,0,0,1,0,0,1
385,ha.office365.com,legit,3.5,5,6,16,0,0.83333,0.21875,3,4,4,3,14,2,0,0,0,2
4451,gcs.sc-cdn.net,legit,3.03915,1,10,14,0,0.1,0.21708,3,1,0,0,4,1,0,0,0,1
4068,statuspage.io,legit,3.2389,6,6,13,0,1.0,0.24915,5,1,0,0,6,4,0,0,0,4
8740,gjvsggfcugcfg.com,dga,3.0072,2,14,17,1,0.14286,0.17689,0,0,0,0,0,0,0,0,0,0
7789,zpxkvojhsn.com,dga,3.6645,2,11,14,1,0.18182,0.26175,0,0,0,0,0,0,0,0,0,0
4585,news-edge.fe.apple-dns.net,legit,3.43046,7,14,26,0,0.5,0.13194,9,7,4,2,22,6,1,0,0,7
1050,pull-hls-f77-gcp01.tiktokcdn.com,legit,4.17923,4,19,32,0,0.21053,0.1306,4,6,9,9,28,2,0,0,0,2
1340,translate.google.com,legit,3.48418,7,11,20,0,0.63636,0.17421,6,5,4,3,18,7,3,0,0,10
337,mzstatic.com,legit,3.08496,3,8,12,0,0.375,0.25708,5,0,0,0,5,5,1,0,0,6
952,a-msedge.net,legit,3.18872,4,6,12,0,0.66667,0.26573,3,2,1,0,6,3,0,0,0,3
6147,omhhisuiwcymao.net,dga,3.72548,7,10,18,1,0.7,0.20697,1,0,0,0,1,4,0,5,4,13
9722,wwcsssolotsl.com,dga,2.82782,3,12,16,1,0.25,0.17674,1,0,0,0,1,0,0,0,0,0
3924,mobile.adsafeprotected.com,legit,3.74833,10,14,26,0,0.71429,0.14417,9,1,0,0,10,4,1,0,0,5
2739,1.pool.ntp.org,legit,2.98523,3,7,14,0,0.42857,0.21323,2,0,0,0,2,0,0,0,0,0
3036,cdn.solvvy.com,legit,3.23593,2,10,14,0,0.2,0.23114,2,2,1,0,5,1,0,0,0,1
1,www.google.com,legit,2.84237,4,8,14,0,0.5,0.20303,2,5,4,3,14,1,0,0,0,1
5667,kufxbgfqbex.org,dga,3.37356,3,11,15,1,0.27273,0.2249,0,0,0,0,0,1,3,2,1,7
5363,cznerufqbex.cc,dga,3.32486,3,10,14,1,0.3,0.23749,1,0,0,0,1,3,3,2,2,10
1954,gi3.akamai.net,legit,3.18201,6,5,14,0,1.2,0.22729,3,3,4,3,13,2,0,0,0,2
2816,radar.cedexis.com,legit,3.38158,6,9,17,0,0.66667,0.19892,5,0,0,0,5,6,0,0,0,6
8034,aqqbmdafyn.jp,dga,3.39275,2,10,13,1,0.2,0.26098,0,0,0,0,0,0,0,0,0,0
5989,historystudysucceedmeetgrass.com,dga,3.71502,10,21,32,1,0.47619,0.11609,4,0,0,0,4,9,2,0,0,11
7448,xubvnkiychfw.tv,dga,3.77356,2,12,15,1,0.16667,0.25157,0,0,0,0,0,0,0,0,0,0
2334,hola.org,legit,2.75,3,4,8,0,0.75,0.34375,0,0,0,0,0,1,0,1,0,2
6293,pxvgoycdut.com,dga,3.52164,3,10,14,1,0.3,0.25155,1,0,0,0,1,0,0,0,0,0
8344,zqoumjlncu.com,dga,3.23593,4,9,14,1,0.44444,0.23114,1,0,0,0,1,0,0,0,0,0
2540,ads.servenobid.com,legit,3.61437,6,10,18,0,0.6,0.2008,6,1,1,0,8,4,2,1,0,7
5516,06c2ou8ao68e.org,dga,3.45282,6,3,16,1,2.0,0.2158,1,0,0,0,1,0,0,0,0,0
5064,gpctgftmd.com,dga,3.08506,1,11,13,1,0.09091,0.23731,0,0,0,0,0,0,0,0,0,0
1591,dc-api.adobe.io,legit,3.24022,7,5,15,0,1.4,0.21601,4,1,1,0,6,1,0,0,0,1
4360,bsync-va.tiktokv.com,legit,3.72193,4,13,20,0,0.30769,0.1861,2,5,4,3,14,1,0,0,0,1
6433,ivitheaclixa.ddns.net,dga,3.59447,7,12,21,1,0.58333,0.17117,4,1,0,0,5,7,4,3,2,16
4069,sync-jp.im-apps.net,legit,3.57662,3,12,19,0,0.25,0.18824,3,1,0,0,4,0,0,0,0,0
8382,vofoji.info,dga,2.66353,5,5,11,1,1.0,0.24214,1,0,0,0,1,0,0,0,0,0
5290,mvkxgdehmrerkjef7456ofw.ddns.net,dga,4.22641,5,21,32,1,0.2381,0.13208,5,1,0,0,6,7,3,3,2,15
672,dc.services.visualstudio.com,legit,3.65505,10,15,28,0,0.66667,0.13054,7,2,1,1,11,8,2,1,0,11
3656,mc.yandex.ru,legit,3.4183,3,7,12,0,0.42857,0.28486,0,0,0,0,0,3,1,0,0,4
6028,yubsvqrgojjl.com,dga,3.75,3,12,16,1,0.25,0.23438,0,0,0,0,0,0,0,0,0,0
3638,duplex.sc-gw.com,legit,3.75,3,10,16,0,0.3,0.23438,2,1,0,0,3,1,0,0,0,1
4308,adobe.demdex.net,legit,3.07782,6,8,16,0,0.75,0.19236,3,0,0,0,3,4,1,0,0,5
8513,ejakkwck.com.mt,dga,3.1899,3,10,15,1,0.3,0.21266,2,2,1,0,5,2,2,1,0,5
5598,qqlsxeigvubqqjcd.eu,dga,3.61635,5,13,19,1,0.38462,0.19033,1,0,0,0,1,0,0,0,0,0
2930,oec16-normal-useast5.us.tiktokv.com,legit,4.09315,11,16,35,0,0.6875,0.11695,8,6,4,3,21,8,0,0,0,8
8387,yonahsqvnlvud.com,dga,3.73452,4,12,17,1,0.33333,0.21968,1,0,0,0,1,1,0,0,0,1
4948,skyoverride.webrootcloudav.com,legit,3.93624,11,17,30,0,0.64706,0.13121,6,3,2,1,12,4,2,0,0,6
5420,showerremoveegggroundobject.com,dga,3.76939,11,19,31,1,0.57895,0.12159,4,0,0,0,4,6,1,0,0,7
7549,sirmodelresulttrychipstomach.com,dga,3.85846,9,22,32,1,0.40909,0.12058,4,0,0,0,4,10,1,0,0,11
9937,ogcmjqcjtvpfnqqne.com,dga,3.55852,3,17,21,1,0.17647,0.16945,0,0,0,0,0,1,0,0,0,1
6471,ewuvtwphyh.com,dga,3.52164,3,10,14,1,0.3,0.25155,0,0,0,0,0,0,0,0,0,0
3513,sv.rkdms.com,legit,3.08496,1,9,12,0,0.11111,0.25708,0,0,0,0,0,0,0,0,0,0
8135,ycqw28mkeom0.top,dga,3.75,3,9,16,1,0.33333,0.23438,0,0,0,0,0,1,0,0,0,1
184,lh5.googleusercontent.com,legit,3.65366,8,14,25,0,0.57143,0.14615,10,8,4,3,25,7,3,0,0,10
9233,ysfaok.info,dga,3.0958,4,6,11,1,0.66667,0.28144,0,0,0,0,0,0,0,0,0,0
5145,dhxmjnfyumbi.ru,dga,3.64022,3,11,15,1,0.27273,0.24268,0,0,0,0,0,0,0,0,0,0
9459,dutylistexchangeswimprogram.com,dga,4.22017,9,21,31,1,0.42857,0.13613,9,1,0,0,10,8,3,0,0,11
9278,uayuzlrmtn.com,dga,3.52164,4,9,14,1,0.44444,0.25155,0,0,0,0,0,0,0,0,0,0
3856,pi.pardot.com,legit,3.2389,4,7,13,0,0.57143,0.24915,1,0,0,0,1,1,0,0,0,1
5314,7qmffjkmxtcv26rp8p.biz,dga,4.1867,1,16,22,1,0.0625,0.1903,0,0,0,0,0,0,0,0,0,0
2274,box.com,legit,2.52164,2,4,7,0,0.5,0.36023,0,0,0,0,0,0,0,0,0,0
5796,sentencehowto.az,dga,3.32782,6,9,16,1,0.66667,0.20799,5,1,0,0,6,4,2,1,0,7
3897,w182.akamai.net,legit,3.45656,5,5,15,0,1.0,0.23044,3,3,4,3,13,2,0,0,0,2
1992,partiality.itunes.apple.com,legit,3.7262,10,14,27,0,0.71429,0.13801,9,4,3,2,18,6,0,0,0,6
4364,prod.aadmsa.trafficmanager.net,legit,3.67291,10,17,30,0,0.58824,0.12243,11,6,3,4,24,6,2,0,0,8
852,fw.adsafeprotected.com,legit,3.60694,7,13,22,0,0.53846,0.16395,7,1,0,0,8,3,1,0,0,4
3490,uts-api.itunes.apple.com,legit,3.68872,9,11,24,0,0.81818,0.1537,8,5,4,2,19,4,0,0,0,4
8346,gratiassuelocutus.com,dga,3.55852,9,11,21,1,0.81818,0.16945,5,0,0,0,5,6,2,0,0,8
6346,dnncnbffmfaocffo.net,dga,3.14145,4,15,20,1,0.26667,0.15707,1,0,0,0,1,1,0,0,0,1
2032,us001-prod.arcticwolf.net,legit,4.16386,6,13,25,0,0.46154,0.16655,7,3,2,1,13,3,1,0,0,4
3424,netdna.bootstrapcdn.com,legit,3.55553,6,15,23,0,0.4,0.15459,6,1,0,0,7,5,1,0,0,6
1294,thrtle.com,legit,3.12193,2,7,10,0,0.28571,0.31219,1,0,0,0,1,1,0,0,0,1
5537,oewtxhummyweyerw.eu,dga,3.26083,7,11,19,1,0.63636,0.17162,1,0,0,0,1,1,0,0,0,1
5864,lyrimyd.info,dga,3.25163,3,8,12,1,0.375,0.27097,0,0,0,0,0,1,0,0,0,1
6681,jezodaj.info,dga,3.25163,5,6,12,1,0.83333,0.27097,0,0,0,0,0,0,0,0,0,0
3622,qg2.apps.qualys.com,legit,3.57662,4,11,19,0,0.36364,0.18824,4,2,1,0,7,0,0,0,0,0
7725,ruidvosainqebu.ddns.net,dga,3.67531,8,13,23,1,0.61538,0.1598,3,1,0,0,4,5,3,3,2,13
5725,kb78ql3dk6ubk4w.ddns.net,dga,3.93872,2,15,24,1,0.13333,0.16411,2,1,0,0,3,4,3,3,2,12
3595,www.gravatar.com,legit,3.15564,4,10,16,0,0.4,0.19723,3,0,0,0,3,4,0,0,0,4
8746,cpypydjioqqjibwpksj.ug,dga,3.75444,4,17,22,1,0.23529,0.17066,0,0,0,0,0,0,0,0,0,0
305,us-mobile.events.data.microsoft.com,legit,3.9573,12,18,35,0,0.66667,0.11307,15,9,7,6,37,8,1,0,0,9
2008,prod.content-signature-chains.prod.webservices.mozgcp.net,legit,4.14449,16,34,57,0,0.47059,0.07271,19,9,4,3,35,14,8,1,0,23
6098,wsescsucaioqckwa.org,dga,3.54644,7,12,20,1,0.58333,0.17732,2,0,0,0,2,4,0,0,0,4
2282,adsby.bidtheatre.com,legit,3.72193,6,12,20,0,0.5,0.1861,5,0,0,0,5,3,0,0,0,3
4391,dsa.moatads.com,legit,2.92323,5,8,15,0,0.625,0.19488,5,0,0,0,5,2,0,0,0,2
9740,baxijifo.ru,dga,3.27761,5,5,11,1,1.0,0.29796,0,0,0,0,0,0,0,0,0,0
7937,todocwetd.com,dga,2.87314,4,8,13,1,0.5,0.22101,0,0,0,0,0,1,0,0,0,1
7349,gczzjjpfi.dyndns.org,dga,3.72193,2,16,20,1,0.125,0.1861,2,1,0,0,3,4,4,4,3,15
8930,caseoctover.net,dga,3.1899,6,8,15,1,0.75,0.21266,2,0,0,0,2,5,2,0,0,7
7527,capitalcloudbuddyreadgrade.com,dga,3.76141,11,18,30,1,0.61111,0.12538,9,4,2,1,16,8,1,0,0,9
3097,office.trafficmanager.net,legit,3.46347,9,14,25,0,0.64286,0.13854,9,5,3,5,22,7,1,0,0,8
5094,e0ao6smwugik.top,dga,3.875,6,7,16,1,0.85714,0.24219,0,0,0,0,0,0,0,0,0,0
4783,e4.akamaiedge.net,legit,3.21953,8,6,17,0,1.33333,0.18938,5,5,5,3,18,4,0,0,0,4
8952,gmkqiwywkogeukem.org,dga,3.44644,6,13,20,1,0.46154,0.17232,1,0,0,0,1,2,0,0,0,2
6958,xjygpifycoardupqh.tw,dga,4.12193,4,15,20,1,0.26667,0.2061,2,0,0,0,2,2,0,0,0,2
3896,public.wamsm-a-6.prod.infra.webex.com,legit,4.15217,10,19,37,0,0.52632,0.11222,8,4,3,2,17,5,2,0,0,7
7463,adehwamduh.com,dga,3.23593,5,8,14,1,0.625,0.23114,2,0,0,0,2,2,0,0,0,2
3803,sf16-static.i18n-pglstatp.com,legit,3.9354,5,16,29,0,0.3125,0.1357,5,0,0,0,5,5,1,0,0,6
7110,eblkfeedofabnldm.com,dga,3.48418,6,13,20,1,0.46154,0.17421,2,0,0,0,2,1,0,0,0,1
1112,pti.store.microsoft.com,legit,3.32748,7,13,23,0,0.53846,0.14467,10,8,7,6,31,6,0,0,0,6
4204,wlhrm-a-10.prod.infra.webex.com,legit,4.15565,7,16,31,0,0.4375,0.13405,5,4,3,2,14,3,2,0,0,5
3360,catalog.gamepass.com,legit,3.32193,7,11,20,0,0.63636,0.1661,4,0,0,0,4,5,1,0,0,6
1276,weather.com,legit,3.27761,4,6,11,0,0.66667,0.29796,3,0,0,0,3,3,1,1,1,6
4838,updates.g.aaplimg.com,legit,3.65376,7,11,21,0,0.63636,0.17399,8,0,0,0,8,3,1,0,0,4
8051,juxujtrqufep.org,dga,3.45282,5,10,16,1,0.5,0.2158,0,0,0,0,0,0,0,0,0,0
8845,xutohin.info,dga,3.08496,5,6,12,1,0.83333,0.25708,1,0,0,0,1,1,0,0,0,1
2609,a1051.dscw154.akamai.net,legit,3.77206,6,8,24,0,0.75,0.15717,5,3,4,3,15,3,0,0,0,3
8167,oofvkldeemup.ru,dga,3.50689,6,8,15,1,0.75,0.23379,2,0,0,0,2,2,0,0,0,2
765,us-east-1.cxm-bcn.publisher-services.amazon.dev,legit,4.21993,13,25,47,0,0.52,0.08979,15,4,4,4,27,12,3,1,0,16
8065,fueritmachinanturopn.com,dga,3.72018,9,14,24,1,0.64286,0.15501,5,0,0,0,5,7,3,0,0,10
1921,tracker.samplicio.us,legit,3.72193,7,11,20,0,0.63636,0.1861,6,0,0,0,6,5,1,0,0,6
1315,loadus.exelator.com,legit,3.57662,8,9,19,0,0.88889,0.18824,5,0,0,0,5,4,0,0,0,4
5972,mokaaldobcfkafbf.com,dga,3.20869,6,13,20,1,0.46154,0.16043,0,0,0,0,0,0,0,0,0,0
6754,nqoqqwfox.com,dga,2.96892,3,9,13,1,0.33333,0.22838,0,0,0,0,0,0,0,0,0,0
271,guzzoni.apple.com,legit,3.61687,6,9,17,0,0.66667,0.21276,6,4,3,2,15,3,0,0,0,3
722,flashtalking.com,legit,3.75,4,11,16,0,0.36364,0.23438,2,0,0,0,2,4,1,0,0,5
3492,sandbox.google.com,legit,3.50326,6,10,18,0,0.6,0.19463,2,5,4,3,14,3,1,0,0,4
221,us-v20.events.data.microsoft.com,legit,3.99173,9,16,32,0,0.5625,0.12474,13,9,7,6,35,7,1,0,0,8
2509,adx.g.doubleclick.net,legit,3.78494,6,12,21,0,0.5,0.18024,6,0,0,0,6,4,0,0,0,4
8115,sowgjprqsnvtorlmvmrtpifvc.com,dga,3.92627,4,24,29,1,0.16667,0.13539,2,0,0,0,2,1,0,0,0,1
3868,scontent-ord5-1.xx.fbcdn.net,legit,3.75343,4,17,28,0,0.23529,0.13405,7,3,0,0,10,6,2,0,0,8
7589,siclafitimpenditur.com,dga,3.82307,8,13,22,1,0.61538,0.17378,3,0,0,0,3,7,1,0,0,8
373,g.whatsapp.net,legit,3.23593,3,9,14,0,0.33333,0.23114,3,1,0,0,4,1,0,0,0,1
3482,streamtheworld.com,legit,3.61437,5,12,18,0,0.41667,0.2008,4,0,0,0,4,5,0,0,0,5
6801,reviewrubinvitegaragerealize.com,dga,3.74173,15,16,32,1,0.9375,0.11693,8,1,0,0,9,9,1,0,0,10
1580,ocsp.globalsign.com,legit,3.47135,5,12,19,0,0.41667,0.1827,2,0,0,0,2,1,0,0,0,1
3110,crs.cr.adobe.com,legit,3.15564,4,9,16,0,0.44444,0.19723,5,0,0,0,5,1,0,0,0,1
4222,chromesyncpasswords-pa.googleapis.com,legit,3.9261,11,23,37,0,0.47826,0.10611,8,6,4,4,22,7,1,0,0,8
1032,ris.api.iris.microsoft.com,legit,3.24374,9,13,26,0,0.69231,0.12476,10,10,8,6,34,4,1,0,0,5
4687,g-msn-com-nsatc.trafficmanager.net,legit,3.70453,8,21,34,0,0.38095,0.10896,8,4,1,3,16,10,2,0,0,12
8280,liargooq.ddns.net,dga,3.61687,5,10,17,1,0.5,0.21276,4,2,0,0,6,5,3,3,2,13
2644,identity.mparticle.com,legit,3.66353,7,13,22,0,0.53846,0.16652,6,1,0,0,7,7,1,0,0,8
9349,bkhsfexmgdqhlao.info,dga,4.02193,5,14,20,1,0.35714,0.2011,0,0,0,0,0,1,0,0,0,1
1855,c-test.sc-cdn.net,legit,2.93983,2,11,17,0,0.18182,0.17293,5,1,0,0,6,4,1,0,0,5
3409,aol.com,legit,2.52164,3,3,7,0,1.0,0.36023,0,0,0,0,0,0,0,0,0,0
1008,pull-f5-vr-sg01.tiktokcdn.com,legit,4.28023,4,17,29,0,0.23529,0.14759,4,6,9,9,28,2,0,0,0,2
1757,cds.taboola.com,legit,3.1899,5,8,15,0,0.625,0.21266,6,0,0,0,6,2,0,0,0,2
92,g.aaplimg.com,legit,3.08506,4,7,13,0,0.57143,0.23731,4,0,0,0,4,0,0,0,0,0
7440,utcdtiismdln.pw,dga,3.50689,3,11,15,1,0.27273,0.23379,2,0,0,0,2,2,0,0,0,2
3061,s.update.sharethru.com,legit,3.60694,7,12,22,0,0.58333,0.16395,5,0,0,0,5,5,1,0,0,6
6424,qrutbwksdt.com,dga,3.6645,2,11,14,1,0.18182,0.26175,0,0,0,0,0,0,0,0,0,0
3898,usersync-prod-sas.akadns.net,legit,3.69595,7,17,28,0,0.41176,0.132,9,6,5,3,23,5,4,0,0,9
4136,in.treasuredata.com,legit,3.57662,8,9,19,0,0.88889,0.18824,7,0,0,0,7,8,0,0,0,8
1068,rtb.mfadsrvr.com,legit,3.45282,2,12,16,0,0.16667,0.2158,3,0,0,0,3,0,0,0,0,0
4417,windowsazure.com,legit,3.75,6,9,16,0,0.66667,0.23438,2,0,0,1,3,3,0,0,0,3
6239,gwwlund.com,dga,3.27761,2,8,11,1,0.25,0.29796,0,0,0,0,0,1,0,0,0,1
9481,b28jqcwi15a57nzjzbtbuhqg43breyc19euev.biz,dga,4.50098,8,22,41,1,0.36364,0.10978,1,0,0,0,1,1,0,0,0,1
6981,boniwyk.info,dga,3.08496,4,7,12,1,0.57143,0.25708,1,0,0,0,1,2,0,0,0,2
7713,jeupfbbkkeqqwbdw.eu,dga,3.32636,5,13,19,1,0.38462,0.17507,0,0,0,0,0,0,0,0,0,0
6892,tsndyknw.mooo.com,dga,3.26393,4,11,17,1,0.36364,0.192,2,0,0,0,2,1,1,2,1,5
2760,lh2.l.google.com,legit,2.98346,4,8,16,0,0.5,0.18647,2,5,4,3,14,1,0,0,0,1
